Date,Shift,LM#,RANGE,PPM,MPX,WEFT,WARP,OTHER,Combined Stops
07/01/15,1,1,738,305,116,11,28,3,42
07/01/15,1,2,726,315,116,20,31,0,51
07/01/15,1,3,996,220,70,20,6,0,26
07/01/15,1,5,641,370,157,31,4,1,36
07/01/15,1,6,542,370,137,51,11,5,67
07/01/15,1,7,8032,345,120,10,31,1,42
07/01/15,1,8,7652,350,81,12,14,9,35
07/01/15,1,10,542,370,143,20,11,1,32
07/01/15,1,13,3062,350,138,22,15,0,37
07/01/15,1,15,542,350,25,4,0,0,4
07/01/15,1,16,7652,350,112,14,9,2,25
07/01/15,1,17,641,370,123,17,10,0,27
07/01/15,1,18,542,350,75,125,12,3,140
07/01/15,1,19,542,360,101,47,7,0,54
07/01/15,1,20,774,350,25,10,17,1,28
07/01/15,1,21,717,350,152,7,2,0,9
07/01/15,1,22,542,350,2,4,0,0,4
07/01/15,1,23,542,350,17,6,1,0,7
07/01/15,1,24,8032,360,104,6,29,1,36
07/01/15,1,26,542,360,73,24,12,0,36
07/01/15,1,27,542,360,61,40,4,0,44
07/01/15,1,28,8032,375,55,12,41,0,53
07/01/15,1,29,7675,270,78,19,6,0,25
07/01/15,1,30,7675,270,82,14,5,0,19
07/01/15,2,1,738,305,92,14,33,6,53
07/01/15,2,2,726,315,108,7,37,2,46
07/01/15,2,3,996,220,64,24,5,0,29
07/01/15,2,4,737,220,24,14,2,0,16
07/01/15,2,5,641,370,125,5,15,2,22
07/01/15,2,6,542,370,86,45,7,4,56
07/01/15,2,7,8032,345,1,1,0,1,2
07/01/15,2,8,7652,350,90,22,8,1,31
07/01/15,2,9,759,350,31,6,13,3,22
07/01/15,2,10,542,370,92,18,11,1,30
07/01/15,2,13,3062,350,120,9,12,0,21
07/01/15,2,15,542,350,109,11,4,0,15
07/01/15,2,17,641,370,80,16,17,0,33
07/01/15,2,18,542,350,36,86,4,4,94
07/01/15,2,19,542,360,58,33,7,0,40
07/01/15,2,20,774,350,54,13,27,0,40
07/01/15,2,21,717,350,135,3,3,0,6
07/01/15,2,22,542,350,71,46,5,0,51
07/01/15,2,24,8032,360,92,9,16,4,29
07/01/15,2,26,542,360,81,39,5,0,44
07/01/15,2,27,542,360,68,42,12,0,54
07/01/15,2,28,8032,375,61,27,30,1,58
07/01/15,2,29,7675,270,61,21,7,0,28
07/01/15,2,30,7675,270,71,15,6,0,21
07/01/15,3,1,738,305,81,10,25,8,43
07/01/15,3,2,726,315,48,43,10,0,53
07/01/15,3,3,996,220,55,21,5,0,26
07/01/15,3,4,737,220,49,25,8,0,33
07/01/15,3,5,641,370,162,3,14,0,17
07/01/15,3,6,542,370,119,47,14,3,64
07/01/15,3,8,7652,350,123,19,10,1,30
07/01/15,3,9,759,350,121,31,12,3,46
07/01/15,3,10,542,370,144,20,8,0,28
07/01/15,3,13,3062,350,94,8,13,3,24
07/01/15,3,14,7724,360,62,1,0,7,8
07/01/15,3,15,542,350,143,20,2,0,22
07/01/15,3,18,542,350,40,83,0,2,85
07/01/15,3,19,542,360,46,36,9,0,45
07/01/15,3,20,774,350,57,18,28,0,46
07/01/15,3,22,542,350,60,30,3,0,33
07/01/15,3,24,8032,360,60,0,0,0,0
07/01/15,3,26,542,360,62,31,2,0,33
07/01/15,3,27,542,360,43,26,43,26,95
07/01/15,3,28,8032,375,50,19,30,1,50
07/01/15,3,29,7675,270,68,23,6,0,29
07/01/15,3,30,7675,270,73,13,4,1,18
07/02/15,1,1,738,305,107,20,27,9,56
07/02/15,1,2,726,315,113,23,7,2,32
07/02/15,1,3,996,220,5,1,0,0,1
07/02/15,1,4,737,220,56,24,4,0,28
07/02/15,1,5,996,370,166,3,13,0,16
07/02/15,1,6,542,370,128,48,12,4,64
07/02/15,1,7,8032,345,39,7,4,4,15
07/02/15,1,8,7652,350,123,28,11,4,43
07/02/15,1,9,8030,350,118,7,16,2,25
07/02/15,1,10,775,370,150,21,7,0,28
07/02/15,1,12,7393,350,29,8,7,3,18
07/02/15,1,13,3062,350,130,10,19,2,31
07/02/15,1,14,747,360,164,3,1,0,4
07/02/15,1,15,542,350,145,11,4,0,15
07/02/15,1,16,7652,350,79,29,6,2,37
07/02/15,1,18,542,350,41,107,7,0,114
07/02/15,1,19,542,360,47,54,4,0,58
07/02/15,1,20,774,350,77,32,24,0,56
07/02/15,1,22,542,350,75,44,5,0,49
07/02/15,1,24,8032,360,95,7,23,1,31
07/02/15,1,26,542,360,89,24,8,0,32
07/02/15,1,27,7377,360,58,31,21,0,52
07/02/15,1,28,8032,375,66,28,31,0,59
07/02/15,1,29,7675,270,81,12,2,0,14
07/02/15,1,30,7675,270,71,18,3,0,21
07/02/15,2,1,738,305,94,9,28,10,47
07/02/15,2,2,726,315,92,20,5,2,27
07/02/15,2,3,996,220,65,17,4,0,21
07/02/15,2,4,737,220,50,26,3,0,29
07/02/15,2,5,996,370,132,9,10,0,19
07/02/15,2,6,542,370,10,2,2,1,5
07/02/15,2,7,8032,345,111,11,16,2,29
07/02/15,2,8,7652,350,96,21,13,6,40
07/02/15,2,9,759,350,132,7,7,0,14
07/02/15,2,10,775,370,133,16,5,0,21
07/02/15,2,12,7393,350,108,17,11,1,29
07/02/15,2,13,3062,350,116,7,13,2,22
07/02/15,2,14,747,360,151,2,3,2,7
07/02/15,2,15,542,350,135,14,4,0,18
07/02/15,2,16,7652,350,100,18,9,0,27
07/02/15,2,17,641,370,46,24,8,8,40
07/02/15,2,18,542,350,38,97,10,7,114
07/02/15,2,19,542,360,54,50,3,0,53
07/02/15,2,20,774,350,64,29,24,0,53
07/02/15,2,22,542,350,67,41,1,0,42
07/02/15,2,24,8032,360,51,7,12,4,23
07/02/15,2,25,542,375,22,7,4,0,11
07/02/15,2,26,542,360,96,46,2,0,48
07/02/15,2,27,7377,360,114,25,25,0,50
07/02/15,2,28,8032,375,24,12,22,3,37
07/02/15,2,29,7675,270,86,11,4,0,15
07/02/15,2,30,7675,270,55,22,1,0,23
07/02/15,3,1,738,305,86,21,16,5,42
07/02/15,3,2,726,315,76,12,20,3,35
07/02/15,3,3,996,220,56,21,3,0,24
07/02/15,3,4,737,220,35,27,5,0,32
07/02/15,3,5,996,370,59,4,16,0,20
07/02/15,3,7,8032,345,121,9,13,0,22
07/02/15,3,8,7652,350,97,24,10,1,35
07/02/15,3,9,759,350,137,9,10,1,20
07/02/15,3,10,775,370,38,1,5,3,9
07/02/15,3,12,7393,350,110,8,6,1,15
07/02/15,3,13,3062,350,15,0,4,1,5
07/02/15,3,14,747,360,169,0,0,0,0
07/02/15,3,15,542,350,92,11,3,0,14
07/02/15,3,16,7652,350,114,16,8,0,24
07/02/15,3,17,641,370,58,34,5,1,40
07/02/15,3,18,542,350,43,108,2,13,123
07/02/15,3,19,542,360,46,31,2,0,33
07/02/15,3,20,774,350,50,12,26,1,39
07/02/15,3,22,542,350,43,36,2,0,38
07/02/15,3,25,542,375,75,13,5,0,18
07/02/15,3,26,542,360,63,30,7,0,37
07/02/15,3,27,7377,360,72,24,6,0,30
07/02/15,3,29,7675,270,75,13,3,1,17
07/02/15,3,30,7675,270,29,25,4,1,30
07/03/15,1,1,738,305,92,24,25,5,54
07/03/15,1,2,726,315,107,19,28,2,49
07/03/15,1,3,996,220,71,17,4,0,21
07/03/15,1,4,996,220,57,23,2,0,25
07/03/15,1,6,542,370,32,0,1,5,6
07/03/15,1,7,8032,345,137,16,12,1,29
07/03/15,1,8,7652,350,128,21,14,0,35
07/03/15,1,9,759,350,143,9,8,1,18
07/03/15,1,12,285,350,104,22,11,8,41
07/03/15,1,13,3062,350,10,1,4,2,7
07/03/15,1,14,747,360,157,8,0,0,8
07/03/15,1,15,542,350,119,12,9,0,21
07/03/15,1,16,7652,350,115,37,8,0,45
07/03/15,1,17,641,370,101,30,10,0,40
07/03/15,1,18,542,350,47,18,1,0,19
07/03/15,1,19,542,360,85,45,7,0,52
07/03/15,1,20,774,350,81,23,21,1,45
07/03/15,1,21,717,350,20,0,5,0,5
07/03/15,1,22,542,350,82,57,6,0,63
07/03/15,1,23,542,350,38,12,12,0,24
07/03/15,1,25,542,375,113,18,14,0,32
07/03/15,1,26,542,360,95,38,7,0,45
07/03/15,1,27,7377,360,110,23,12,0,35
07/03/15,1,29,7675,270,80,14,6,0,20
07/03/15,1,30,7675,270,76,20,4,0,24
07/03/15,2,1,738,305,89,10,30,12,52
07/03/15,2,2,726,315,90,4,23,5,32
07/03/15,2,3,996,220,71,16,5,1,22
07/03/15,2,4,996,220,35,25,2,0,27
07/03/15,2,5,996,370,33,17,10,8,35
07/03/15,2,6,542,370,116,12,12,3,27
07/03/15,2,7,8032,345,134,19,9,0,28
07/03/15,2,8,7652,350,114,17,15,1,33
07/03/15,2,9,759,350,122,4,14,1,19
07/03/15,2,12,285,350,120,18,8,3,29
07/03/15,2,13,3062,350,122,7,16,0,23
07/03/15,2,14,747,360,145,1,0,4,5
07/03/15,2,15,542,350,131,8,9,0,17
07/03/15,2,16,7652,350,119,18,11,3,32
07/03/15,2,17,641,370,116,30,11,2,43
07/03/15,2,18,542,350,113,49,8,1,58
07/03/15,2,19,542,360,30,34,1,0,35
07/03/15,2,20,774,350,74,40,33,2,75
07/03/15,2,21,717,350,143,5,10,0,15
07/03/15,2,22,542,350,85,50,5,0,55
07/03/15,2,23,542,350,28,24,0,0,24
07/03/15,2,25,542,375,103,33,9,0,42
07/03/15,2,26,542,360,104,48,6,0,54
07/03/15,2,27,7377,360,101,18,16,0,34
07/03/15,2,29,7675,270,43,19,3,0,22
07/03/15,3,1,738,305,99,11,14,4,29
07/03/15,3,2,726,315,84,10,30,1,41
07/03/15,3,3,996,220,70,15,2,0,17
07/03/15,3,5,996,370,93,2,10,0,12
07/03/15,3,6,542,370,114,10,6,6,22
07/03/15,3,7,8032,345,121,20,10,0,30
07/03/15,3,8,7652,350,80,15,14,2,31
07/03/15,3,9,759,350,130,2,8,3,13
07/03/15,3,12,285,350,122,6,15,2,23
07/03/15,3,13,3062,350,95,9,15,1,25
07/03/15,3,14,747,360,157,0,0,4,4
07/03/15,3,16,7652,350,94,17,14,0,31
07/06/15,1,1,738,305,101,22,22,4,48
07/06/15,1,2,726,315,106,10,27,4,41
07/06/15,1,3,996,220,88,0,0,0,0
07/06/15,1,4,996,220,49,0,0,0,0
07/06/15,1,5,641,370,152,4,7,3,14
07/06/15,1,6,542,370,139,20,11,6,37
07/06/15,1,7,8032,345,129,17,16,3,36
07/06/15,1,8,7652,350,140,18,20,1,39
07/06/15,1,9,759,350,141,1,13,0,14
07/06/15,1,12,285,350,132,30,13,5,48
07/06/15,1,13,3062,350,149,14,18,0,32
07/06/15,1,14,747,360,165,1,3,0,4
07/06/15,1,15,542,350,160,6,8,0,14
07/06/15,1,16,7652,350,104,14,20,8,42
07/06/15,1,17,641,370,141,27,8,0,35
07/06/15,1,18,542,350,118,62,11,5,78
07/06/15,1,19,542,360,71,33,10,0,43
07/06/15,1,20,774,350,96,34,35,2,71
07/06/15,1,21,717,350,178,5,3,0,8
07/06/15,1,22,542,350,91,52,3,0,55
07/06/15,1,23,641,350,100,2,11,0,13
07/06/15,1,25,542,375,137,34,7,0,41
07/06/15,1,26,542,360,62,45,2,0,47
07/06/15,1,27,7737,360,105,14,31,0,45
07/06/15,1,29,7675,270,40,0,0,0,0
07/06/15,1,30,7675,270,48,0,0,0,0
07/06/15,2,1,738,305,100,5,28,12,45
07/06/15,2,2,726,315,97,13,26,4,43
07/06/15,2,3,996,220,39,0,0,0,0
07/06/15,2,4,996,220,53,0,0,0,0
07/06/15,2,5,641,370,141,7,8,0,15
07/06/15,2,6,542,370,117,19,4,12,35
07/06/15,2,7,8032,345,113,18,13,0,31
07/06/15,2,8,7652,350,116,16,19,0,35
07/06/15,2,9,759,350,149,3,7,0,10
07/06/15,2,12,285,350,117,22,15,6,43
07/06/15,2,13,3062,350,112,7,14,0,21
07/06/15,2,14,747,360,171,0,3,2,5
07/06/15,2,15,542,350,102,3,7,0,10
07/06/15,2,16,7652,350,116,19,7,0,26
07/06/15,2,17,641,370,118,17,3,1,21
07/06/15,2,18,542,350,81,66,7,2,75
07/06/15,2,19,542,360,81,31,9,0,40
07/06/15,2,20,774,350,72,36,13,1,50
07/06/15,2,21,717,350,151,8,6,0,14
07/06/15,2,22,542,350,94,39,8,0,47
07/06/15,2,23,641,350,158,3,4,0,7
07/06/15,2,24,7601,360,46,9,3,3,15
07/06/15,2,25,542,375,134,18,6,0,24
07/06/15,2,26,542,360,91,50,2,0,52
07/06/15,2,27,7737,360,112,13,11,0,24
07/06/15,2,29,7675,270,84,0,0,0,0
07/06/15,2,30,7675,270,67,0,0,0,0
07/06/15,3,2,726,315,99,16,4,1,21
07/06/15,3,4,996,220,59,10,4,0,14
07/06/15,3,5,641,370,161,4,11,1,16
07/06/15,3,6,542,370,122,35,8,13,56
07/06/15,3,7,8032,345,139,13,9,2,24
07/06/15,3,8,7652,350,81,10,14,3,27
07/06/15,3,9,759,350,144,5,11,3,19
07/06/15,3,12,285,350,121,26,11,11,48
07/06/15,3,13,3062,350,103,2,21,1,24
07/06/15,3,14,747,360,169,6,1,0,7
07/06/15,3,16,7652,350,115,21,10,2,33
07/06/15,3,17,641,370,58,30,6,1,37
07/06/15,3,18,542,350,67,44,6,1,51
07/06/15,3,19,542,360,60,22,8,0,30
07/06/15,3,20,774,350,49,41,12,0,53
07/06/15,3,21,717,350,165,0,1,0,1
07/06/15,3,22,542,350,28,40,2,0,42
07/06/15,3,24,7601,360,75,21,4,3,28
07/06/15,3,25,542,375,86,24,3,0,27
07/06/15,3,26,542,360,66,35,2,0,37
07/06/15,3,27,7737,360,84,8,13,0,21
07/06/15,3,29,7675,270,62,10,3,0,13
07/06/15,3,30,7675,270,60,7,1,0,8
07/07/15,1,1,738,305,8,4,2,1,7
07/07/15,1,2,726,315,110,14,28,3,45
07/07/15,1,3,999,220,45,21,8,0,29
07/07/15,1,4,996,220,9,3,1,0,4
07/07/15,1,5,641,370,161,5,8,5,18
07/07/15,1,6,542,370,142,26,4,3,33
07/07/15,1,7,8032,345,144,5,11,0,16
07/07/15,1,8,774,350,130,16,25,3,44
07/07/15,1,9,759,350,18,5,4,2,11
07/07/15,1,11,1000,355,27,2,5,4,11
07/07/15,1,13,3062,350,144,7,13,2,22
07/07/15,1,14,747,360,171,5,1,0,6
07/07/15,1,15,542,350,26,4,2,0,6
07/07/15,1,16,7652,350,107,15,12,0,27
07/07/15,1,17,641,370,47,6,5,1,12
07/07/15,1,18,542,350,110,43,10,0,53
07/07/15,1,19,542,360,41,15,10,0,25
07/07/15,1,20,774,350,50,79,18,1,98
07/07/15,1,21,717,350,133,4,2,0,6
07/07/15,1,22,542,350,66,36,6,0,42
07/07/15,1,24,7601,360,117,12,8,1,21
07/07/15,1,25,542,375,97,18,5,0,23
07/07/15,1,26,542,360,64,42,5,0,47
07/07/15,1,27,7737,360,106,10,16,0,26
07/07/15,1,29,7675,270,59,0,0,0,0
07/07/15,1,30,7675,270,39,0,0,0,0
07/07/15,2,1,738,305,84,11,28,10,49
07/07/15,2,2,726,315,82,17,28,4,49
07/07/15,2,3,999,220,56,26,10,0,36
07/07/15,2,4,996,220,43,25,12,0,37
07/07/15,2,5,641,370,160,2,7,2,11
07/07/15,2,6,542,370,131,16,3,9,28
07/07/15,2,7,8032,345,117,16,17,0,33
07/07/15,2,8,774,350,117,12,12,0,24
07/07/15,2,11,1000,355,77,7,22,2,31
07/07/15,2,13,3062,350,125,7,12,0,19
07/07/15,2,14,747,360,179,3,0,2,5
07/07/15,2,15,542,350,121,11,9,0,20
07/07/15,2,16,7652,350,86,23,8,0,31
07/07/15,2,17,641,370,130,28,7,2,37
07/07/15,2,18,542,350,111,35,10,1,46
07/07/15,2,20,774,350,76,23,28,3,54
07/07/15,2,21,717,350,170,1,1,0,2
07/07/15,2,22,542,350,60,34,13,0,47
07/07/15,2,24,7601,360,121,12,5,0,17
07/07/15,2,25,542,375,117,25,5,0,30
07/07/15,2,26,542,360,80,42,7,0,49
07/07/15,2,27,7737,360,128,7,19,0,26
07/07/15,2,29,7675,270,61,0,0,0,0
07/07/15,2,30,7675,270,50,0,0,0,0
07/07/15,3,1,738,305,92,20,23,13,56
07/07/15,3,2,726,315,95,19,26,2,47
07/07/15,3,3,999,220,70,10,14,0,24
07/07/15,3,4,996,220,51,21,21,0,42
07/07/15,3,5,641,370,169,5,10,3,18
07/07/15,3,6,542,370,133,22,9,6,37
07/07/15,3,7,8032,345,97,5,18,2,25
07/07/15,3,8,774,350,107,27,12,3,42
07/07/15,3,13,3062,350,109,5,11,0,16
07/07/15,3,14,747,360,181,4,1,0,5
07/07/15,3,15,542,350,109,16,16,0,32
07/07/15,3,16,7652,350,120,23,5,1,29
07/07/15,3,17,641,370,67,28,8,0,36
07/07/15,3,18,542,350,38,20,2,8,30
07/07/15,3,20,774,350,44,16,20,2,38
07/07/15,3,21,717,350,167,0,1,0,1
07/07/15,3,22,542,350,40,24,8,0,32
07/07/15,3,24,7601,360,58,7,2,1,10
07/07/15,3,25,542,375,75,12,4,1,17
07/07/15,3,26,542,360,71,36,3,0,39
07/07/15,3,27,7737,360,94,15,8,0,23
07/07/15,3,29,7675,270,50,13,2,0,15
07/07/15,3,30,7675,270,75,2,11,0,13
07/08/15,1,1,738,305,98,28,15,3,46
07/08/15,1,2,726,315,102,18,35,1,54
07/08/15,1,3,999,220,70,0,0,0,0
07/08/15,1,4,996,220,57,0,0,0,0
07/08/15,1,5,641,370,150,2,10,4,16
07/08/15,1,6,542,370,136,27,7,4,38
07/08/15,1,8,7652,350,89,19,17,6,42
07/08/15,1,11,1000,355,3,1,1,0,2
07/08/15,1,12,8032,350,8,7,5,7,19
07/08/15,1,13,3062,350,144,11,12,2,25
07/08/15,1,14,747,360,166,8,3,0,11
07/08/15,1,15,542,350,81,20,13,0,33
07/08/15,1,16,7652,350,129,30,13,5,48
07/08/15,1,17,641,370,151,6,3,0,9
07/08/15,1,18,542,350,27,20,3,1,24
07/08/15,1,19,542,360,39,4,2,0,6
07/08/15,1,20,774,350,72,37,30,1,68
07/08/15,1,21,717,350,154,2,5,0,7
07/08/15,1,22,542,350,78,44,7,0,51
07/08/15,1,24,7601,360,121,21,5,2,28
07/08/15,1,25,542,375,121,18,5,0,23
07/08/15,1,26,542,360,68,53,4,0,57
07/08/15,1,27,7737,360,79,32,12,0,44
07/08/15,1,29,7675,270,80,0,0,0,0
07/08/15,1,30,7675,270,70,0,0,0,0
07/08/15,2,1,738,305,100,12,19,5,36
07/08/15,2,2,726,315,86,25,31,3,59
07/08/15,2,3,999,220,64,0,0,0,0
07/08/15,2,4,996,220,58,0,0,0,0
07/08/15,2,5,641,370,147,3,14,0,17
07/08/15,2,6,542,370,131,19,6,6,31
07/08/15,2,8,7652,350,47,9,10,1,20
07/08/15,2,11,1000,355,96,7,24,11,42
07/08/15,2,12,8032,350,68,20,42,1,63
07/08/15,2,13,3062,350,113,8,15,1,24
07/08/15,2,14,747,360,165,3,8,1,12
07/08/15,2,15,542,350,105,20,13,0,33
07/08/15,2,16,7652,350,153,8,4,1,13
07/08/15,2,17,641,370,140,6,12,3,21
07/08/15,2,18,542,350,39,21,8,13,42
07/08/15,2,19,542,360,112,30,8,0,38
07/08/15,2,20,774,350,79,22,36,0,58
07/08/15,2,21,717,350,156,4,2,0,6
07/08/15,2,22,542,350,75,37,6,0,43
07/08/15,2,24,7601,360,125,12,8,0,20
07/08/15,2,25,542,375,121,27,6,0,33
07/08/15,2,26,542,360,113,36,4,0,40
07/08/15,2,27,7737,360,97,38,14,0,52
07/08/15,2,29,7675,270,53,0,0,0,0
07/08/15,2,30,7675,270,63,0,0,0,0
07/08/15,3,1,738,305,83,30,20,16,66
07/08/15,3,2,726,315,94,31,25,1,57
07/08/15,3,3,999,220,55,0,0,0,0
07/08/15,3,4,996,220,60,0,0,0,0
07/08/15,3,5,641,370,156,6,10,1,17
07/08/15,3,6,542,370,130,32,7,6,45
07/08/15,3,12,8032,350,87,16,43,1,60
07/08/15,3,13,3062,350,118,9,18,5,32
07/08/15,3,14,747,360,162,10,10,1,21
07/08/15,3,15,542,350,126,18,7,0,25
07/08/15,3,16,7652,350,22,3,1,1,5
07/08/15,3,17,641,370,135,8,9,0,17
07/08/15,3,18,542,350,43,39,9,0,48
07/08/15,3,19,542,360,90,14,8,0,22
07/08/15,3,20,774,350,45,8,30,2,40
07/08/15,3,22,542,350,50,29,1,0,30
07/08/15,3,24,7601,360,98,10,6,3,19
07/08/15,3,25,542,375,89,18,4,0,22
07/08/15,3,26,542,360,71,28,3,0,31
07/08/15,3,27,7737,360,63,18,9,0,27
07/08/15,3,29,7675,270,41,0,0,0,0
07/08/15,3,30,7675,270,40,0,0,0,0
07/09/15,1,1,738,305,103,20,24,5,49
07/09/15,1,2,726,315,104,20,30,1,51
07/09/15,1,3,996,220,51,23,13,0,36
07/09/15,1,4,996,220,70,18,10,0,28
07/09/15,1,5,996,370,153,0,11,7,18
07/09/15,1,6,542,370,126,33,10,7,50
07/09/15,1,8,7652,350,34,6,6,3,15
07/09/15,1,12,8032,350,92,20,49,5,74
07/09/15,1,13,3062,350,137,12,16,6,34
07/09/15,1,14,747,360,177,5,4,5,14
07/09/15,1,15,542,350,132,9,12,0,21
07/09/15,1,17,641,370,138,7,13,1,21
07/09/15,1,18,542,350,96,62,11,2,75
07/09/15,1,19,542,360,102,21,7,0,28
07/09/15,1,20,774,350,77,25,38,2,65
07/09/15,1,22,542,350,102,47,6,0,53
07/09/15,1,23,641,350,31,0,7,0,7
07/09/15,1,24,7601,360,134,15,12,3,30
07/09/15,1,25,542,375,125,23,10,0,33
07/09/15,1,27,7737,360,97,29,20,0,49
07/09/15,1,29,7675,270,40,25,11,0,36
07/09/15,1,30,7675,270,65,16,5,0,21
07/09/15,2,1,738,305,77,19,34,12,65
07/09/15,2,2,726,315,87,16,25,7,48
07/09/15,2,3,996,220,68,20,15,0,35
07/09/15,2,4,996,220,55,25,9,0,34
07/09/15,2,5,996,370,152,5,7,1,13
07/09/15,2,6,542,370,88,27,9,3,39
07/09/15,2,8,7652,350,89,12,17,0,29
07/09/15,2,9,759,350,83,8,27,6,41
07/09/15,2,10,775,370,52,6,10,9,25
07/09/15,2,12,8032,350,73,10,39,2,51
07/09/15,2,13,3062,350,125,7,9,1,17
07/09/15,2,14,747,360,168,4,5,1,10
07/09/15,2,15,542,350,143,10,6,0,16
07/09/15,2,17,641,370,158,5,11,1,17
07/09/15,2,18,542,350,82,67,7,1,75
07/09/15,2,19,542,360,129,13,7,0,20
07/09/15,2,20,774,350,75,12,33,1,46
07/09/15,2,22,542,350,89,36,8,0,44
07/09/15,2,23,641,350,116,8,10,0,18
07/09/15,2,24,7601,360,136,9,6,1,16
07/09/15,2,25,542,375,115,35,6,0,41
07/09/15,2,27,7737,360,107,10,17,0,27
07/09/15,2,29,7675,270,28,29,12,0,41
07/09/15,2,30,7675,270,53,21,6,0,27
07/09/15,3,1,738,305,91,23,16,5,44
07/09/15,3,3,996,220,65,21,10,0,31
07/09/15,3,4,996,220,71,11,12,0,23
07/09/15,3,5,996,370,150,14,9,4,27
07/09/15,3,8,7652,350,131,9,21,0,30
07/09/15,3,9,759,350,101,5,35,2,42
07/09/15,3,10,775,370,120,10,18,2,30
07/09/15,3,12,8032,350,92,10,55,1,66
07/09/15,3,13,3062,350,118,9,18,5,32
07/09/15,3,14,747,360,182,8,1,0,9
07/09/15,3,15,542,350,56,7,2,1,10
07/09/15,3,17,641,370,64,3,3,1,7
07/09/15,3,18,542,350,39,20,4,2,26
07/09/15,3,20,774,350,37,6,15,1,22
07/09/15,3,22,542,350,35,23,3,0,26
07/09/15,3,23,641,350,89,3,0,0,3
07/09/15,3,24,7601,360,42,3,5,3,11
07/09/15,3,25,542,375,46,11,2,0,13
07/09/15,3,27,7737,360,46,4,8,0,12
07/09/15,3,29,7675,270,45,24,11,0,35
07/10/15,1,1,738,305,57,17,13,9,39
07/10/15,1,2,726,315,43,15,12,0,27
07/10/15,1,3,999,220,52,28,12,0,40
07/10/15,1,4,996,220,22,5,3,0,8
07/10/15,1,5,996,370,159,11,5,0,16
07/10/15,1,7,8032,345,12,12,2,7,21
07/10/15,1,8,7652,350,128,9,21,0,30
07/10/15,1,9,759,350,148,3,15,1,19
07/10/15,1,10,775,370,108,26,14,6,46
07/10/15,1,12,8032,350,104,22,45,0,67
07/10/15,1,13,3062,350,131,6,14,1,21
07/10/15,1,14,747,360,189,1,0,0,1
07/10/15,1,15,542,350,122,21,7,0,28
07/10/15,1,16,7652,350,96,17,8,3,28
07/10/15,1,17,641,370,144,6,12,1,19
07/10/15,1,18,542,350,120,29,10,1,40
07/10/15,1,19,542,360,46,26,1,0,27
07/10/15,1,20,774,350,56,14,38,0,52
07/10/15,1,22,542,350,83,41,8,0,49
07/10/15,1,23,641,350,138,8,4,0,12
07/10/15,1,24,7601,360,129,13,8,0,21
07/10/15,1,25,542,375,99,25,7,0,32
07/10/15,1,26,542,360,81,31,11,0,42
07/10/15,1,27,7737,360,122,9,21,0,30
07/10/15,1,29,7675,270,18,4,2,0,6
07/10/15,1,30,7675,270,27,6,2,0,8
07/10/15,2,1,738,305,47,7,26,0,33
07/10/15,2,2,726,315,64,16,20,3,39
07/10/15,2,3,999,220,6,2,1,0,3
07/10/15,2,5,996,370,107,7,2,3,12
07/10/15,2,6,542,370,24,18,5,10,33
07/10/15,2,7,8032,345,66,30,1,0,31
07/10/15,2,8,7652,350,66,6,11,2,19
07/10/15,2,9,759,350,95,10,11,0,21
07/10/15,2,10,775,370,164,10,10,6,26
07/10/15,2,12,8032,350,53,8,33,0,41
07/10/15,2,13,3062,350,95,7,13,0,20
07/10/15,2,14,747,360,167,9,0,2,11
07/10/15,2,15,542,350,117,16,11,0,27
07/10/15,2,16,7652,350,89,10,3,0,13
07/10/15,2,17,641,370,149,5,10,3,18
07/10/15,2,18,542,350,104,30,14,2,46
07/10/15,2,19,542,360,121,26,2,0,28
07/10/15,2,20,774,350,83,20,38,1,59
07/10/15,2,22,542,350,88,55,11,0,66
07/10/15,2,23,641,350,44,5,1,0,6
07/10/15,2,24,7601,360,125,8,12,0,20
07/10/15,2,26,542,360,5,2,4,0,6
07/10/15,2,27,7737,360,96,9,26,0,35
07/10/15,2,29,7675,270,47,23,9,0,32
07/10/15,2,30,7675,270,56,20,11,0,31
07/10/15,3,1,738,305,82,11,28,6,45
07/10/15,3,2,726,315,94,29,21,1,51
07/10/15,3,4,996,220,48,0,0,0,0
07/10/15,3,5,996,370,165,14,3,1,18
07/10/15,3,6,542,370,104,78,3,8,89
07/10/15,3,7,8032,345,55,5,5,0,10
07/10/15,3,8,7652,350,83,14,16,7,37
07/10/15,3,9,759,350,130,2,20,1,23
07/10/15,3,10,775,370,126,21,15,3,39
07/10/15,3,12,8032,350,96,14,38,1,53
07/10/15,3,13,3062,350,52,2,10,2,14
07/10/15,3,14,747,360,167,10,0,1,11
07/10/15,3,15,542,350,106,9,8,1,18
07/13/15,1,1,738,305,72,6,37,6,49
07/13/15,1,2,726,315,88,16,29,1,46
07/13/15,1,3,999,220,2,1,0,0,1
07/13/15,1,4,996,220,70,24,5,0,29
07/13/15,1,5,641,370,152,3,2,0,5
07/13/15,1,6,542,370,106,35,3,0,38
07/13/15,1,7,7734,345,73,22,9,2,33
07/13/15,1,8,7652,350,94,6,23,2,31
07/13/15,1,9,759,350,111,9,12,6,27
07/13/15,1,10,775,370,123,14,15,0,29
07/13/15,1,12,774,350,104,8,37,2,47
07/13/15,1,14,747,360,188,2,0,0,2
07/13/15,1,15,542,350,108,12,21,0,33
07/13/15,1,17,641,370,144,6,20,0,26
07/13/15,1,18,542,350,91,41,17,1,59
07/13/15,1,19,542,360,144,21,6,0,27
07/13/15,1,20,774,350,77,12,42,6,60
07/13/15,1,21,717,350,47,9,32,0,41
07/13/15,1,22,542,350,125,46,6,0,52
07/13/15,1,23,641,350,73,5,9,0,14
07/13/15,1,24,7601,360,50,6,4,0,10
07/13/15,1,27,7737,360,15,1,5,0,6
07/13/15,1,29,7675,270,88,17,8,0,25
07/13/15,1,30,7675,270,58,12,4,1,17
07/13/15,2,1,738,305,81,7,39,12,58
07/13/15,2,2,726,315,99,9,37,2,48
07/13/15,2,3,999,220,31,8,5,1,14
07/13/15,2,4,996,220,66,22,4,1,27
07/13/15,2,5,641,370,182,6,1,0,7
07/13/15,2,6,542,370,98,56,2,5,63
07/13/15,2,7,7734,345,110,47,4,1,52
07/13/15,2,8,7652,350,106,12,19,0,31
07/13/15,2,9,759,350,130,6,19,0,25
07/13/15,2,10,775,370,122,24,12,0,36
07/13/15,2,12,774,350,78,6,34,1,41
07/13/15,2,13,3062,350,18,1,2,0,3
07/13/15,2,14,747,360,177,3,1,0,4
07/13/15,2,15,542,350,109,16,8,0,24
07/13/15,2,17,641,370,170,5,3,2,10
07/13/15,2,18,542,350,116,27,6,1,34
07/13/15,2,19,542,360,131,21,6,0,27
07/13/15,2,20,774,350,75,12,49,3,64
07/13/15,2,21,717,350,77,5,39,0,44
07/13/15,2,22,542,350,88,45,9,0,54
07/13/15,2,23,641,350,142,9,10,0,19
07/13/15,2,24,7601,360,140,15,7,0,22
07/13/15,2,29,7675,270,93,20,2,0,22
07/13/15,2,30,7675,270,44,10,3,1,14
07/13/15,3,1,738,305,102,47,30,6,83
07/13/15,3,2,726,315,92,12,34,1,47
07/13/15,3,3,999,220,79,20,7,0,27
07/13/15,3,4,996,220,67,19,6,3,28
07/13/15,3,5,641,370,77,5,5,1,11
07/13/15,3,6,542,370,119,32,6,5,43
07/13/15,3,8,7652,350,117,12,25,0,37
07/13/15,3,9,759,350,145,8,17,1,26
07/13/15,3,10,775,370,116,41,15,2,58
07/13/15,3,12,774,350,123,5,37,0,42
07/13/15,3,13,3062,350,127,11,4,0,15
07/13/15,3,14,747,360,183,6,3,0,9
07/13/15,3,15,542,350,121,25,7,0,32
07/13/15,3,16,7652,350,68,16,22,6,44
07/13/15,3,17,641,370,55,12,2,2,16
07/13/15,3,18,542,350,47,12,3,2,17
07/13/15,3,19,542,360,46,9,2,0,11
07/13/15,3,20,774,350,55,8,28,2,38
07/13/15,3,21,717,350,37,5,17,0,22
07/13/15,3,23,641,350,51,2,4,0,6
07/13/15,3,24,7601,360,50,10,2,1,13
07/13/15,3,29,7675,270,30,5,3,1,9
07/13/15,3,30,7675,270,26,7,5,0,12
07/14/15,1,1,738,305,93,9,33,6,48
07/14/15,1,2,726,315,98,15,27,2,44
07/14/15,1,3,999,220,79,19,3,0,22
07/14/15,1,4,996,220,71,23,10,0,33
07/14/15,1,6,542,370,106,35,2,3,40
07/14/15,1,7,7734,345,13,2,6,6,14
07/14/15,1,8,7652,350,133,11,18,6,35
07/14/15,1,9,759,350,116,18,23,5,46
07/14/15,1,10,542,370,129,31,15,1,47
07/14/15,1,12,774,350,110,10,36,1,47
07/14/15,1,13,3062,350,159,9,10,2,21
07/14/15,1,14,747,360,181,2,7,2,11
07/14/15,1,15,542,350,67,9,6,0,15
07/14/15,1,16,7652,350,123,26,13,2,41
07/14/15,1,17,641,370,109,7,16,2,25
07/14/15,1,18,542,350,121,23,19,3,45
07/14/15,1,19,542,360,154,11,5,0,16
07/14/15,1,20,774,350,81,10,38,6,54
07/14/15,1,21,774,350,93,8,38,0,46
07/14/15,1,23,641,350,152,6,12,0,18
07/14/15,1,24,7601,360,141,13,6,3,22
07/14/15,1,29,7675,270,91,0,0,0,0
07/14/15,1,30,7675,270,61,0,0,0,0
07/14/15,2,1,738,305,61,5,15,8,28
07/14/15,2,2,726,315,93,8,33,2,43
07/14/15,2,3,999,220,69,21,5,0,26
07/14/15,2,4,996,220,59,25,9,0,34
07/14/15,2,5,641,370,61,12,3,6,21
07/14/15,2,6,542,370,98,56,2,5,63
07/14/15,2,7,7734,345,118,17,14,3,34
07/14/15,2,8,7652,350,90,12,15,0,27
07/14/15,2,9,759,350,123,6,15,2,23
07/14/15,2,10,542,370,103,19,14,4,37
07/14/15,2,12,774,350,81,10,33,7,50
07/14/15,2,13,3062,350,124,7,10,0,17
07/14/15,2,14,747,360,173,3,0,0,3
07/14/15,2,16,7652,350,116,16,5,0,21
07/14/15,2,17,641,370,148,7,10,1,18
07/14/15,2,18,542,350,134,21,0,12,33
07/14/15,2,19,542,360,147,17,3,0,20
07/14/15,2,20,774,350,72,11,34,0,45
07/14/15,2,21,774,350,85,3,39,0,42
07/14/15,2,23,641,350,118,4,17,0,21
07/14/15,2,24,7601,360,135,9,6,1,16
07/14/15,2,25,775,375,34,12,3,0,15
07/14/15,2,26,542,360,74,37,7,0,44
07/14/15,2,29,7675,270,83,0,0,0,0
07/14/15,2,30,7675,270,62,0,0,0,0
07/14/15,3,1,738,305,99,13,29,5,47
07/14/15,3,2,726,315,107,16,29,1,46
07/14/15,3,3,999,220,76,18,3,1,22
07/14/15,3,4,996,220,68,22,7,0,29
07/14/15,3,5,641,370,147,40,0,2,42
07/14/15,3,6,542,370,121,36,7,10,53
07/14/15,3,7,7734,345,113,20,19,2,41
07/14/15,3,8,7652,350,114,5,24,1,30
07/14/15,3,9,759,350,128,1,30,2,33
07/14/15,3,10,542,370,132,21,21,1,43
07/14/15,3,12,774,350,103,13,49,0,62
07/14/15,3,13,3062,350,53,3,2,1,6
07/14/15,3,14,747,360,182,1,4,0,5
07/14/15,3,16,7652,350,136,19,5,1,25
07/14/15,3,17,641,370,58,4,2,1,7
07/14/15,3,18,542,350,48,13,3,1,17
07/14/15,3,19,542,360,49,8,4,0,12
07/14/15,3,20,774,350,37,9,11,0,20
07/14/15,3,21,774,350,40,2,15,0,17
07/14/15,3,23,641,350,51,0,11,0,11
07/14/15,3,24,7601,360,48,5,2,1,8
07/14/15,3,25,775,375,33,10,4,0,14
07/14/15,3,26,542,360,25,19,8,0,27
07/14/15,3,29,7675,270,30,10,3,0,13
07/14/15,3,30,7675,270,23,10,2,0,12
07/15/15,1,1,738,305,97,7,32,1,40
07/15/15,1,2,726,315,109,19,22,2,43
07/15/15,1,3,999,220,79,17,4,0,21
07/15/15,1,4,996,220,28,8,2,0,10
07/15/15,1,5,641,370,148,34,2,2,38
07/15/15,1,6,542,370,110,44,7,4,55
07/15/15,1,7,7734,345,93,39,14,2,55
07/15/15,1,8,7652,350,102,14,16,0,30
07/15/15,1,9,8030,350,129,3,19,2,24
07/15/15,1,10,775,370,130,24,9,0,33
07/15/15,1,11,8040,355,15,2,8,3,13
07/15/15,1,12,774,350,96,13,17,2,32
07/15/15,1,13,3062,350,153,12,8,0,20
07/15/15,1,14,747,360,191,2,0,0,2
07/15/15,1,16,7652,350,134,20,6,2,28
07/15/15,1,17,641,370,128,2,10,1,13
07/15/15,1,18,542,350,117,6,27,1,34
07/15/15,1,19,542,360,112,14,4,0,18
07/15/15,1,20,774,350,94,15,38,2,55
07/15/15,1,21,774,350,86,10,43,0,53
07/15/15,1,23,641,350,120,7,14,0,21
07/15/15,1,24,7601,360,55,4,5,0,9
07/15/15,1,25,775,375,95,45,10,0,55
07/15/15,1,26,542,360,85,47,7,0,54
07/15/15,1,29,7675,270,100,7,3,0,10
07/15/15,1,30,7675,270,64,18,6,0,24
07/15/15,2,1,738,305,82,16,21,2,39
07/15/15,2,2,726,315,103,8,29,0,37
07/15/15,2,3,999,220,68,20,5,0,25
07/15/15,2,4,996,220,4,1,0,0,1
07/15/15,2,5,641,370,134,15,2,0,17
07/15/15,2,6,542,370,106,25,4,5,34
07/15/15,2,7,7734,345,84,31,3,2,36
07/15/15,2,8,7652,350,101,12,22,3,37
07/15/15,2,9,8030,350,145,3,1,3,7
07/15/15,2,10,775,370,108,9,14,2,25
07/15/15,2,11,8040,355,38,9,25,5,39
07/15/15,2,12,774,350,96,14,27,0,41
07/15/15,2,13,3062,350,118,9,7,2,18
07/15/15,2,14,747,360,178,4,6,0,10
07/15/15,2,16,7652,350,105,29,9,1,39
07/15/15,2,18,542,350,85,11,13,1,25
07/15/15,2,19,542,360,99,13,12,0,25
07/15/15,2,20,774,350,68,8,40,2,50
07/15/15,2,21,774,350,70,6,27,0,33
07/15/15,2,23,641,350,94,5,14,0,19
07/15/15,2,25,775,375,44,25,3,0,28
07/15/15,2,26,542,360,59,45,8,0,53
07/15/15,2,29,7675,270,75,12,5,0,17
07/15/15,2,30,7675,270,55,19,5,1,25
07/15/15,3,1,738,305,102,7,30,6,43
07/15/15,3,2,726,315,102,10,32,2,44
07/15/15,3,4,996,220,68,0,0,0,0
07/15/15,3,5,641,370,162,28,7,3,38
07/15/15,3,6,542,370,138,36,3,4,43
07/15/15,3,7,7734,345,84,11,4,0,15
07/15/15,3,8,7652,350,97,7,15,2,24
07/15/15,3,9,8030,350,154,4,5,2,11
07/15/15,3,10,775,370,107,16,23,3,42
07/15/15,3,11,8040,355,77,11,59,6,76
07/15/15,3,12,774,350,107,17,40,2,59
07/15/15,3,13,3062,350,52,3,2,1,6
07/15/15,3,14,747,360,137,5,1,1,7
07/15/15,3,15,542,350,24,0,3,0,3
07/15/15,3,16,7652,350,120,23,9,1,33
07/15/15,3,18,542,350,40,20,2,1,23
07/15/15,3,19,542,360,51,7,1,0,8
07/15/15,3,20,774,350,38,7,11,1,19
07/15/15,3,21,774,350,41,4,10,0,14
07/15/15,3,23,641,350,55,1,6,0,7
07/15/15,3,25,775,375,33,15,3,0,18
07/15/15,3,26,542,360,30,21,4,0,25
07/15/15,3,29,7675,270,30,0,0,0,0
07/15/15,3,30,7675,270,23,0,0,0,0
07/16/15,1,1,738,305,92,8,29,8,45
07/16/15,1,2,726,315,113,8,23,3,34
07/16/15,1,4,996,220,68,18,5,0,23
07/16/15,1,5,641,370,152,16,3,2,21
07/16/15,1,6,542,370,142,20,2,6,28
07/16/15,1,7,7734,345,127,14,8,1,23
07/16/15,1,8,7652,350,54,6,12,2,20
07/16/15,1,9,8030,350,132,8,12,3,23
07/16/15,1,10,775,370,114,14,17,2,33
07/16/15,1,11,8040,355,56,19,35,3,57
07/16/15,1,12,774,350,101,20,41,0,61
07/16/15,1,13,3062,350,141,7,12,0,19
07/16/15,1,14,747,360,190,3,4,0,7
07/16/15,1,15,542,350,124,9,7,0,16
07/16/15,1,16,7652,350,115,25,14,5,44
07/16/15,1,17,641,370,148,18,19,2,39
07/16/15,1,18,542,350,128,40,11,0,51
07/16/15,1,19,542,360,68,2,6,0,8
07/16/15,1,20,774,350,84,11,43,5,59
07/16/15,1,21,774,350,97,16,39,0,55
07/16/15,1,23,641,350,108,9,20,0,29
07/16/15,1,25,775,375,111,44,10,0,54
07/16/15,1,26,542,360,70,51,9,0,60
07/16/15,1,29,7675,270,10,1,1,0,2
07/16/15,1,30,7675,270,35,5,2,0,7
07/16/15,2,1,738,305,65,7,26,15,48
07/16/15,2,2,726,315,111,3,26,1,30
07/16/15,2,3,999,220,13,1,0,0,1
07/16/15,2,4,996,220,58,20,4,1,25
07/16/15,2,5,641,370,152,17,3,0,20
07/16/15,2,6,542,370,128,9,3,5,17
07/16/15,2,7,7734,345,58,13,19,4,36
07/16/15,2,8,7652,350,105,16,10,1,27
07/16/15,2,9,8030,350,114,2,15,1,18
07/16/15,2,10,775,370,89,31,9,0,40
07/16/15,2,11,8040,355,60,11,36,0,47
07/16/15,2,12,774,350,97,11,33,0,44
07/16/15,2,13,3062,350,117,12,5,1,18
07/16/15,2,14,747,360,166,6,7,0,13
07/16/15,2,15,542,350,86,10,9,0,19
07/16/15,2,16,7652,350,117,11,19,1,31
07/16/15,2,17,641,370,111,11,11,1,23
07/16/15,2,18,542,350,73,25,8,0,33
07/16/15,2,20,774,350,76,8,38,1,47
07/16/15,2,21,774,350,78,16,23,0,39
07/16/15,2,22,542,350,52,37,9,0,46
07/16/15,2,23,641,350,95,14,12,0,26
07/16/15,2,25,775,375,80,27,5,0,32
07/16/15,2,26,542,360,80,28,10,0,38
07/16/15,2,29,7675,270,83,9,3,1,13
07/16/15,2,30,7675,270,52,22,5,0,27
07/16/15,3,1,738,305,92,22,19,6,47
07/16/15,3,2,726,315,81,17,25,2,44
07/16/15,3,3,999,220,70,10,4,0,14
07/16/15,3,4,996,220,57,19,4,0,23
07/16/15,3,5,641,370,155,16,1,1,18
07/16/15,3,6,542,370,123,8,4,6,18
07/16/15,3,8,7652,350,96,9,18,3,30
07/16/15,3,9,8030,350,127,8,9,5,22
07/16/15,3,10,775,370,90,61,13,3,77
07/16/15,3,11,8040,355,64,10,43,11,64
07/16/15,3,12,774,350,102,19,28,1,48
07/16/15,3,13,3062,350,94,6,3,0,9
07/16/15,3,14,747,360,187,1,4,0,5
07/16/15,3,15,542,350,120,13,11,0,24
07/16/15,3,16,7652,350,123,17,8,3,28
07/16/15,3,17,641,370,134,9,8,0,17
07/16/15,3,18,542,350,96,21,9,1,31
07/16/15,3,20,774,350,50,5,26,2,33
07/16/15,3,21,774,350,74,19,8,0,27
07/16/15,3,22,542,350,52,41,8,0,49
07/16/15,3,23,641,350,85,7,14,0,21
07/16/15,3,25,775,375,69,23,11,0,34
07/16/15,3,26,542,360,59,27,8,0,35
07/16/15,3,29,7675,270,69,15,6,0,21
07/16/15,3,30,7675,270,43,20,3,0,23
07/17/15,1,1,738,305,85,10,24,7,41
07/17/15,1,2,726,315,98,15,21,2,38
07/17/15,1,3,999,220,70,23,3,0,26
07/17/15,1,4,996,220,61,23,6,0,29
07/17/15,1,5,641,370,162,9,3,1,13
07/17/15,1,6,542,370,89,11,5,4,20
07/17/15,1,7,7734,345,6,3,1,2,6
07/17/15,1,8,7652,350,74,3,21,0,24
07/17/15,1,9,759,350,147,9,1,1,11
07/17/15,1,10,775,370,58,3,24,3,30
07/17/15,1,11,8040,355,85,16,33,2,51
07/17/15,1,12,774,350,93,16,35,5,56
07/17/15,1,13,3062,350,144,21,4,2,27
07/17/15,1,14,747,360,163,4,5,1,10
07/17/15,1,15,542,350,118,19,8,0,27
07/17/15,1,16,7652,350,149,11,8,0,19
07/17/15,1,17,641,370,153,14,11,2,27
07/17/15,1,18,542,350,49,4,13,2,19
07/17/15,1,19,542,360,124,15,3,0,18
07/17/15,1,20,774,350,56,6,28,2,36
07/17/15,1,21,774,350,96,10,29,0,39
07/17/15,1,22,542,350,86,52,6,0,58
07/17/15,1,23,641,350,96,6,29,0,35
07/17/15,1,25,775,375,98,34,11,0,45
07/17/15,1,26,542,360,107,46,8,0,54
07/17/15,1,29,7675,270,91,12,6,0,18
07/17/15,1,30,7675,270,57,19,7,0,26
07/17/15,2,1,738,305,96,1,30,4,35
07/17/15,2,2,726,315,93,13,29,2,44
07/17/15,2,3,999,220,69,20,2,0,22
07/17/15,2,4,996,220,64,22,7,1,30
07/17/15,2,5,641,370,169,8,2,2,12
07/17/15,2,7,7734,345,126,4,6,1,11
07/17/15,2,9,759,350,142,19,1,1,21
07/17/15,2,11,8040,355,70,11,32,2,45
07/17/15,2,12,774,350,81,17,34,0,51
07/17/15,2,13,3062,350,123,14,3,2,19
07/17/15,2,14,747,360,163,9,6,3,18
07/17/15,2,15,542,350,73,26,3,0,29
07/17/15,2,16,7652,350,136,4,13,3,20
07/17/15,2,17,641,370,141,12,12,0,24
07/17/15,2,19,542,360,100,19,10,0,29
07/17/15,2,20,774,350,40,3,28,2,33
07/17/15,2,21,774,350,79,15,17,0,32
07/17/15,2,22,542,350,55,37,7,0,44
07/17/15,2,23,641,350,79,3,28,0,31
07/17/15,2,24,7601,360,55,13,4,6,23
07/17/15,2,25,775,375,88,24,7,0,31
07/17/15,2,26,542,360,85,44,3,0,47
07/17/15,2,29,7675,270,79,18,8,0,26
07/17/15,2,30,7675,270,61,21,8,0,29
07/17/15,3,1,738,305,66,32,28,3,63
07/17/15,3,2,726,315,98,15,28,0,43
07/17/15,3,3,999,220,76,19,3,0,22
07/17/15,3,4,996,220,73,19,5,0,24
07/17/15,3,5,641,370,159,14,8,0,22
07/17/15,3,7,7734,345,117,21,9,3,33
07/17/15,3,8,7652,350,108,7,16,10,33
07/17/15,3,9,759,350,145,15,3,7,25
07/17/15,3,11,8040,355,79,22,40,1,63
07/17/15,3,12,774,350,91,12,42,0,54
07/17/15,3,14,747,360,161,26,4,0,30
07/17/15,3,15,542,350,124,10,12,0,22
07/17/15,3,16,7652,350,89,14,37,2,53
07/20/15,1,1,738,305,87,23,23,8,54
07/20/15,1,2,726,315,102,13,32,2,47
07/20/15,1,3,999,220,79,15,6,0,21
07/20/15,1,4,996,220,23,12,4,0,16
07/20/15,1,5,641,370,152,14,4,0,18
07/20/15,1,7,7734,345,83,11,0,3,14
07/20/15,1,8,7652,350,106,2,20,3,25
07/20/15,1,9,759,350,94,14,3,2,19
07/20/15,1,11,8040,355,50,44,35,3,82
07/20/15,1,13,3062,350,155,11,8,0,19
07/20/15,1,14,747,360,176,7,2,0,9
07/20/15,1,15,542,350,119,15,18,0,33
07/20/15,1,16,7652,350,132,9,11,1,21
07/20/15,1,17,641,370,100,14,10,3,27
07/20/15,1,18,542,350,75,3,16,3,22
07/20/15,1,19,542,360,113,16,16,0,32
07/20/15,1,20,774,350,65,6,50,0,56
07/20/15,1,21,717,350,81,24,28,0,52
07/20/15,1,22,542,350,105,15,11,0,26
07/20/15,1,23,641,350,76,1,27,0,28
07/20/15,1,24,774,360,110,16,0,0,16
07/20/15,1,25,542,375,102,38,9,0,47
07/20/15,1,26,542,360,108,38,10,0,48
07/20/15,1,27,7737,360,17,1,6,0,7
07/20/15,1,29,7675,270,86,10,2,0,12
07/20/15,1,30,7675,270,66,21,7,0,28
07/20/15,2,1,738,305,69,21,34,10,65
07/20/15,2,2,726,315,101,8,22,1,31
07/20/15,2,3,999,220,70,17,7,1,25
07/20/15,2,4,996,220,58,20,6,0,26
07/20/15,2,5,641,370,149,13,4,0,17
07/20/15,2,7,7734,345,127,7,4,1,12
07/20/15,2,8,7652,350,93,4,19,6,29
07/20/15,2,9,759,350,169,6,2,1,9
07/20/15,2,11,8040,355,52,49,30,0,79
07/20/15,2,12,774,350,20,1,9,9,19
07/20/15,2,13,3062,350,134,16,7,0,23
07/20/15,2,14,747,360,174,3,7,1,11
07/20/15,2,15,542,350,74,19,5,0,24
07/20/15,2,16,7652,350,105,9,19,0,28
07/20/15,2,17,641,370,100,16,11,5,32
07/20/15,2,18,542,350,127,3,16,0,19
07/20/15,2,19,542,360,85,18,13,0,31
07/20/15,2,20,774,350,67,8,33,0,41
07/20/15,2,21,717,350,60,17,14,0,31
07/20/15,2,22,542,350,102,18,10,0,28
07/20/15,2,23,641,350,87,9,17,0,26
07/20/15,2,24,774,360,138,18,1,0,19
07/20/15,2,25,542,375,45,22,9,0,31
07/20/15,2,26,542,360,92,39,8,0,47
07/20/15,2,27,7737,360,132,11,14,0,25
07/20/15,2,29,7675,270,79,13,1,0,14
07/20/15,2,30,7675,270,50,24,9,0,33
07/20/15,3,1,738,305,90,31,23,9,63
07/20/15,3,2,726,315,100,24,17,0,41
07/20/15,3,3,999,220,40,9,4,1,14
07/20/15,3,4,996,220,66,18,6,1,25
07/20/15,3,5,641,370,153,19,10,2,31
07/20/15,3,7,7734,345,141,16,4,1,21
07/20/15,3,8,7652,350,120,8,19,2,29
07/20/15,3,9,759,350,130,17,9,3,29
07/20/15,3,11,8040,355,62,34,51,1,86
07/20/15,3,12,774,350,120,6,25,0,31
07/20/15,3,13,3062,350,140,12,6,0,18
07/20/15,3,14,747,360,188,3,3,0,6
07/20/15,3,15,542,350,119,15,11,0,26
07/20/15,3,16,7652,350,14,0,2,0,2
07/20/15,3,17,641,370,30,5,2,2,9
07/20/15,3,18,542,350,40,0,2,1,3
07/20/15,3,19,542,360,34,5,3,0,8
07/20/15,3,20,774,350,24,2,11,1,14
07/20/15,3,21,717,350,18,2,8,0,10
07/20/15,3,22,542,350,28,12,2,0,14
07/20/15,3,23,641,350,41,0,5,0,5
07/20/15,3,25,542,375,22,12,1,0,13
07/20/15,3,26,542,360,25,13,0,0,13
07/20/15,3,27,7737,360,35,4,4,0,8
07/20/15,3,29,7675,270,23,6,2,0,8
07/20/15,3,30,7675,270,15,5,2,0,7
07/21/15,1,1,738,305,102,19,30,3,52
07/21/15,1,2,726,315,110,12,5,1,18
07/21/15,1,3,999,220,49,20,4,1,25
07/21/15,1,4,996,220,62,12,5,1,18
07/21/15,1,5,641,370,174,13,2,3,18
07/21/15,1,7,7734,345,69,9,3,1,13
07/21/15,1,8,7652,350,154,9,11,1,21
07/21/15,1,9,8030,350,163,12,0,0,12
07/21/15,1,11,8040,355,63,46,45,0,91
07/21/15,1,12,774,350,145,2,28,0,30
07/21/15,1,13,3062,350,141,10,5,2,17
07/21/15,1,14,747,360,107,1,4,1,6
07/21/15,1,15,542,350,122,20,11,0,31
07/21/15,1,17,641,370,134,8,8,1,17
07/21/15,1,18,3062,350,142,7,4,1,12
07/21/15,1,19,542,360,100,36,13,0,49
07/21/15,1,20,774,350,81,11,40,2,53
07/21/15,1,21,776,350,74,21,28,0,49
07/21/15,1,22,542,350,95,42,9,0,51
07/21/15,1,23,641,350,140,9,17,0,26
07/21/15,1,24,776,360,131,12,2,12,26
07/21/15,1,25,775,375,92,44,6,0,50
07/21/15,1,26,542,360,116,41,5,0,46
07/21/15,1,27,7737,360,92,32,13,0,45
07/21/15,1,29,7675,270,86,17,8,1,26
07/21/15,1,30,7675,270,82,20,10,1,31
07/21/15,2,1,738,305,96,16,25,8,49
07/21/15,2,2,726,315,102,16,3,0,19
07/21/15,2,3,999,220,55,22,9,0,31
07/21/15,2,4,996,220,63,17,8,0,25
07/21/15,2,5,641,370,167,13,2,0,15
07/21/15,2,8,7652,350,115,8,19,0,27
07/21/15,2,9,8030,350,126,2,12,2,16
07/21/15,2,10,765,370,73,5,4,6,15
07/21/15,2,11,8040,355,39,37,25,2,64
07/21/15,2,12,774,350,131,4,20,1,25
07/21/15,2,13,3062,350,32,7,2,11,20
07/21/15,2,15,542,350,100,13,4,0,17
07/21/15,2,17,641,370,151,10,8,1,19
07/21/15,2,18,3062,350,157,6,3,0,9
07/21/15,2,19,542,360,90,15,16,0,31
07/21/15,2,20,774,350,63,11,39,0,50
07/21/15,2,21,776,350,36,18,15,0,33
07/21/15,2,22,542,350,100.5,40,14,0,54
07/21/15,2,23,641,350,96,7,10,0,17
07/21/15,2,24,776,360,140,9,5,3,17
07/21/15,2,25,775,375,59,27,5,0,32
07/21/15,2,26,542,360,80,32,8,0,40
07/21/15,2,27,7737,360,66,22,9,0,31
07/21/15,2,29,7675,270,65,22,10,0,32
07/21/15,2,30,7675,270,64,25,11,0,36
07/21/15,3,1,738,305,83,30,19,7,56
07/21/15,3,2,726,315,114,10,27,1,38
07/21/15,3,3,999,220,63,17,5,1,23
07/21/15,3,4,996,220,68,15,9,0,24
07/21/15,3,5,641,370,163,12,9,0,21
07/21/15,3,8,7652,350,125,12,11,1,24
07/21/15,3,10,765,370,154,10,4,0,14
07/21/15,3,11,8040,355,66,56,47,2,105
07/21/15,3,12,774,350,140,17,23,0,40
07/21/15,3,13,3062,350,82,8,3,1,12
07/21/15,3,14,8035,360,45,20,10,5,35
07/21/15,3,15,542,350,134,12,11,0,23
07/21/15,3,17,641,370,73,3,1,1,5
07/21/15,3,18,3062,350,62,1,3,2,6
07/21/15,3,19,542,360,28,13,9,0,22
07/21/15,3,20,774,350,36,6,15,2,23
07/21/15,3,21,776,350,33,5,11,0,16
07/21/15,3,22,542,350,106,37,18,0,55
07/21/15,3,23,641,350,65,3,5,0,8
07/21/15,3,24,776,360,63,6,3,2,11
07/21/15,3,25,775,375,21,14,2,0,16
07/21/15,3,26,542,360,40,8,5,0,13
07/21/15,3,27,7737,360,105,33,12,0,45
07/21/15,3,30,7675,270,33,12,6,0,18
07/22/15,1,1,738,305,90,18,31,6,55
07/22/15,1,2,726,315,119,12,28,2,42
07/22/15,1,3,999,220,70,15,6,0,21
07/22/15,1,4,996,220,68,22,8,0,30
07/22/15,1,5,641,370,175,14,3,3,20
07/22/15,1,8,7652,350,129,11,13,4,28
07/22/15,1,9,8030,350,67,1,1,1,3
07/22/15,1,10,765,370,152,7,8,1,16
07/22/15,1,11,8040,355,68,27,46,3,76
07/22/15,1,12,774,350,143,5,22,2,29
07/22/15,1,13,3062,350,138,9,9,0,18
07/22/15,1,14,8035,360,173,7,5,0,12
07/22/15,1,15,542,350,127,12,16,0,28
07/22/15,1,17,641,370,146,9,11,1,21
07/22/15,1,18,3062,350,155,6,5,2,13
07/22/15,1,19,542,360,85,22,17,0,39
07/22/15,1,20,774,350,75,19,31,0,50
07/22/15,1,21,776,350,75,22,25,0,47
07/22/15,1,22,542,350,83,30,16,0,46
07/22/15,1,23,641,350,123,10,12,0,22
07/22/15,1,24,776,360,139,6,4,0,10
07/22/15,1,25,775,375,79,35,10,0,45
07/22/15,1,26,542,360,112,27,9,0,36
07/22/15,1,27,7737,360,139,10,12,0,22
07/22/15,1,29,7705,270,10,2,1,0,3
07/22/15,1,30,7675,270,80,17,7,0,24
07/22/15,2,1,738,305,67,19,21,9,49
07/22/15,2,2,726,315,82,7,21,2,30
07/22/15,2,3,999,220,66,19,7,1,27
07/22/15,2,4,996,220,66,20,6,0,26
07/22/15,2,5,641,370,74,8,1,1,10
07/22/15,2,8,7652,350,127,9,4,4,17
07/22/15,2,9,8030,350,176,0,4,0,4
07/22/15,2,10,765,370,154,5,9,0,14
07/22/15,2,11,8040,355,10,4,13,0,17
07/22/15,2,12,774,350,128,3,29,2,34
07/22/15,2,13,3062,350,152,4,10,0,14
07/22/15,2,14,8035,360,124,31,5,1,37
07/22/15,2,15,542,350,110,20,9,0,29
07/22/15,2,17,641,370,99,8,19,4,31
07/22/15,2,18,3062,350,149,6,4,1,11
07/22/15,2,19,542,360,96,16,23,0,39
07/22/15,2,20,774,350,62,8,38,1,47
07/22/15,2,21,776,350,68,18,13,0,31
07/22/15,2,22,542,350,94,27,10,0,37
07/22/15,2,23,641,350,97,11,16,0,27
07/22/15,2,24,776,360,137,11,8,1,20
07/22/15,2,25,775,375,43,21,7,0,28
07/22/15,2,26,542,360,100,31,4,0,35
07/22/15,2,27,7737,360,115,11,13,0,24
07/22/15,2,28,308,375,29,0,0,0,0
07/22/15,2,30,7675,270,72,20,9,0,29
07/22/15,3,1,738,305,87,29,21,2,52
07/22/15,3,2,726,315,102,28,21,2,51
07/22/15,3,3,999,220,59,23,7,0,30
07/22/15,3,4,996,220,27,8,4,0,12
07/22/15,3,8,7652,350,128,13,10,12,35
07/22/15,3,9,8030,350,138,0,1,3,4
07/22/15,3,10,765,370,126,21,12,4,37
07/22/15,3,12,774,350,119,22,10,1,33
07/22/15,3,13,3062,350,149,6,11,0,17
07/22/15,3,14,8035,360,127,29,21,21,71
07/22/15,3,17,641,370,73,3,1,1,5
07/23/15,1,1,738,305,94,22,23,6,51
07/23/15,1,2,726,315,111,15,28,3,46
07/23/15,1,3,999,220,71,17,2,0,19
07/23/15,1,4,996,220,34,6,3,0,9
07/23/15,1,7,7734,345,9,13,2,6,21
07/23/15,1,8,7652,350,141,14,10,5,29
07/23/15,1,9,8030,350,163,3,1,0,4
07/23/15,1,10,765,370,153,18,3,1,22
07/23/15,1,11,8040,355,60,51,42,4,97
07/23/15,1,12,774,350,154,4,14,0,18
07/23/15,1,13,7738,350,139,9,9,0,18
07/23/15,1,14,8035,360,136,30,16,0,46
07/23/15,1,16,7738,350,94,8,6,2,16
07/23/15,1,17,641,370,146,11,9,2,22
07/23/15,1,18,3062,350,138,20,1,0,21
07/23/15,1,19,542,360,100,16,16,0,32
07/23/15,1,20,774,350,75,19,31,0,50
07/23/15,1,21,776,350,58,32,22,0,54
07/23/15,1,22,542,350,95,31,15,0,46
07/23/15,1,23,641,350,65,3,5,0,8
07/23/15,1,24,776,360,138,6,4,0,10
07/23/15,1,25,775,375,77,19,17,0,36
07/23/15,1,26,542,360,99,33,8,0,41
07/23/15,1,27,7737,360,113,11,17,0,28
07/23/15,1,29,7705,270,23,10,2,0,12
07/23/15,1,30,7675,270,44,15,5,0,20
07/23/15,2,1,738,305,90,13,25,10,48
07/23/15,2,2,726,315,92,19,16,0,35
07/23/15,2,3,999,220,49,19,4,0,23
07/23/15,2,4,996,220,62,20,3,0,23
07/23/15,2,7,7734,345,119,10,5,0,15
07/23/15,2,8,7652,350,137,5,14,2,21
07/23/15,2,9,8030,350,159,3,7,1,11
07/23/15,2,10,765,370,124,20,13,0,33
07/23/15,2,11,8040,355,41,18,33,1,52
07/23/15,2,12,774,350,110,9,21,1,31
07/23/15,2,13,7738,350,117,11,7,0,18
07/23/15,2,14,8035,360,117,11,7,0,18
07/23/15,2,15,542,350,89,12,4,0,16
07/23/15,2,16,7738,350,117,6,13,2,21
07/23/15,2,17,641,370,150,10,10,1,21
07/23/15,2,18,3062,350,149,8,5,1,14
07/23/15,2,19,542,360,103,33,11,0,44
07/23/15,2,20,774,350,75,20,30,0,50
07/23/15,2,21,776,350,6,1,3,0,4
07/23/15,2,22,542,350,115,21,13,0,34
07/23/15,2,24,776,360,140,4,6,0,10
07/23/15,2,25,775,375,43,33,4,0,37
07/23/15,2,26,542,360,120,35,3,0,38
07/23/15,2,27,7737,360,127,12,19,0,31
07/23/15,2,28,308,375,30,15,10,8,33
07/23/15,2,29,7705,270,21,8,3,0,11
07/23/15,2,30,7675,270,105,24,8,0,32
07/23/15,3,1,738,305,90,23,25,8,56
07/23/15,3,2,726,315,92,19,34,3,56
07/23/15,3,4,996,220,69,22,6,0,28
07/23/15,3,7,7734,345,116,18,8,4,30
07/23/15,3,8,7652,350,75,8,0,2,10
07/23/15,3,9,8030,350,167,2,7,1,10
07/23/15,3,10,765,370,117,37,4,1,42
07/23/15,3,11,8040,355,54,22,41,1,64
07/23/15,3,12,774,350,113,11,18,1,30
07/23/15,3,13,7738,350,140,13,8,1,22
07/23/15,3,14,8035,360,140,13,8,1,22
07/23/15,3,15,542,350,129,14,9,0,23
07/23/15,3,16,7738,350,96,8,13,0,21
07/24/15,1,1,738,305,103,16,34,2,52
07/24/15,1,2,726,315,109,11,27,0,38
07/24/15,1,3,999,220,41,0,0,0,0
07/24/15,1,4,996,220,67,22,6,0,28
07/24/15,1,5,8038,370,118,2,4,11,17
07/24/15,1,6,485,370,52,7,14,2,23
07/24/15,1,7,7734,345,140,18,2,4,24
07/24/15,1,9,8030,350,167,1,5,3,9
07/24/15,1,10,765,370,144,20,5,2,27
07/24/15,1,11,8040,355,64,45,38,3,86
07/24/15,1,12,774,350,149,10,11,0,21
07/24/15,1,13,3062,350,139,9,9,0,18
07/24/15,1,14,8035,360,174,8,1,3,12
07/24/15,1,15,542,350,132,16,14,0,30
07/24/15,1,16,7738,350,118,7,16,3,26
07/24/15,1,17,641,370,146,9,11,1,21
07/24/15,1,18,3062,350,138,20,1,0,21
07/24/15,1,19,542,360,88,25,10,0,35
07/24/15,1,20,774,350,75,19,31,0,50
07/24/15,1,21,774,350,98,5,15,0,20
07/24/15,1,22,542,350,88,16,12,0,28
07/24/15,1,24,776,360,139,6,4,0,10
07/24/15,1,26,542,360,47,36,2,0,38
07/24/15,1,27,7737,360,100,13,10,0,23
07/24/15,1,30,1001,270,32,0,0,0,0
07/24/15,2,1,738,305,55,10,20,16,46
07/24/15,2,2,726,315,102,12,24,3,39
07/24/15,2,3,999,220,72,0,0,0,0
07/24/15,2,4,996,220,72,20,3,0,23
07/24/15,2,5,8038,370,182,3,0,0,3
07/24/15,2,6,485,370,127,18,8,1,27
07/24/15,2,7,7734,345,118,14,6,4,24
07/24/15,2,9,8030,350,171,2,3,0,5
07/24/15,2,10,765,370,137,25,11,1,37
07/24/15,2,11,8040,355,68,22,39,0,61
07/24/15,2,12,774,350,58,2,9,2,13
07/24/15,2,13,3062,350,151,5,8,1,14
07/24/15,2,14,8035,360,135,13,5,1,19
07/24/15,2,15,542,350,103,5,10,0,15
07/24/15,2,16,7738,350,135,5,13,2,20
07/24/15,2,17,641,370,127,8,17,1,26
07/24/15,2,18,3062,350,146,10,3,2,15
07/24/15,2,19,542,360,102,33,9,0,42
07/24/15,2,20,774,350,65,9,45,3,57
07/24/15,2,21,774,350,124,7,18,0,25
07/24/15,2,22,542,350,88,40,14,0,54
07/24/15,2,23,782,350,57,0,12,0,12
07/24/15,2,24,776,360,147,13,1,0,14
07/24/15,2,25,775,375,89,36,5,0,41
07/24/15,2,26,542,360,80,44,10,0,54
07/24/15,2,27,7737,360,107,12,11,0,23
07/24/15,2,30,1001,270,81,0,0,0,0
07/24/15,3,1,738,305,102,11,37,13,61
07/24/15,3,2,726,315,94,23,35,3,61
07/24/15,3,3,999,220,71,0,0,0,0
07/24/15,3,4,996,220,53,22,6,0,28
07/24/15,3,5,8038,370,191,1,0,1,2
07/24/15,3,6,485,370,142,3,12,4,19
07/24/15,3,7,7734,345,131,26,5,2,33
07/24/15,3,9,8030,350,166,6,0,3,9
07/24/15,3,10,765,370,142,19,7,3,29
07/24/15,3,11,8040,355,47,7,28,0,35
07/24/15,3,13,3062,350,169,7,10,0,17
07/24/15,3,14,8035,360,133,19,19,3,41
07/24/15,3,15,542,350,122,9,12,0,21
07/24/15,3,16,7738,350,117,16,6,1,23
07/27/15,1,1,738,305,110,11,34,3,48
07/27/15,1,2,726,315,123,28,21,3,52
07/27/15,1,3,999,220,88,15,6,0,21
07/27/15,1,4,996,220,21,4,2,0,6
07/27/15,1,5,8038,370,170,4,5,3,12
07/27/15,1,6,485,370,144,1,19,1,21
07/27/15,1,7,7734,345,41,5,3,3,11
07/27/15,1,9,8030,350,170,1,6,0,7
07/27/15,1,10,485,370,156,15,10,0,25
07/27/15,1,12,774,350,69,11,16,6,33
07/27/15,1,13,3062,350,131,19,13,2,34
07/27/15,1,14,8035,360,158,3,11,2,16
07/27/15,1,15,542,350,168,9,7,0,16
07/27/15,1,16,7738,350,173,4,9,1,14
07/27/15,1,17,641,370,145,9,11,1,21
07/27/15,1,18,3062,350,169,6,5,1,12
07/27/15,1,19,542,360,120,37,15,0,52
07/27/15,1,20,774,350,67,17,53,0,70
07/27/15,1,21,774,350,157,11,113,0,124
07/27/15,1,22,542,350,105,34,15,0,49
07/27/15,1,23,782,350,98,7,25,0,32
07/27/15,1,24,776,360,151,20,4,1,25
07/27/15,1,25,775,375,87,37,10,0,47
07/27/15,1,26,542,360,27,12,1,0,13
07/27/15,1,27,7737,360,91,5,16,0,21
07/27/15,1,30,1001,270,80,10,5,2,17
07/27/15,2,1,738,305,92,8,43,11,62
07/27/15,2,2,726,315,107,25,25,2,52
07/27/15,2,3,999,220,68,21,8,0,29
07/27/15,2,4,996,220,65,22,9,0,31
07/27/15,2,5,8038,370,169,5,3,2,10
07/27/15,2,6,485,370,148,3,6,3,12
07/27/15,2,9,8030,350,176,1,1,1,3
07/27/15,2,10,485,370,4,0,1,1,2
07/27/15,2,12,774,350,132,8,16,2,26
07/27/15,2,13,3062,350,145,14,5,0,19
07/27/15,2,14,8035,360,130,24,5,6,35
07/27/15,2,15,542,350,125,15,6,0,21
07/27/15,2,16,7738,350,145,6,4,2,12
07/27/15,2,17,641,370,170,11,9,1,21
07/27/15,2,18,3062,350,158,4,7,1,12
07/27/15,2,19,542,360,100,32,12,0,44
07/27/15,2,20,774,350,64,6,43,6,55
07/27/15,2,21,774,350,134,10,11,0,21
07/27/15,2,22,542,350,75,45,7,0,52
07/27/15,2,23,782,350,106,5,9,0,14
07/27/15,2,24,776,360,143,8,3,0,11
07/27/15,2,25,775,375,59,24,4,0,28
07/27/15,2,26,542,360,9,5,8,0,13
07/27/15,2,27,7737,360,111,10,13,0,23
07/27/15,2,30,1001,270,79,13,5,0,18
07/27/15,3,1,738,305,101,9,31,9,49
07/27/15,3,2,726,315,100,21,29,1,51
07/27/15,3,3,999,220,69,17,8,0,25
07/27/15,3,4,996,220,73,15,7,0,22
07/27/15,3,5,8038,370,164,7,0,2,9
07/27/15,3,6,485,370,157,3,4,0,7
07/27/15,3,9,8030,350,161,3,2,1,6
07/27/15,3,12,774,350,124,6,24,0,30
07/27/15,3,13,3062,350,144,13,8,2,23
07/27/15,3,14,8035,360,170,4,10,0,14
07/27/15,3,15,542,350,127,17,10,0,27
07/27/15,3,16,7738,350,146,7,3,1,11
07/27/15,3,17,641,370,73,3,1,1,5
07/27/15,3,18,3062,350,44,0,1,0,1
07/27/15,3,19,542,360,33,10,3,0,13
07/27/15,3,20,774,350,36,6,15,2,23
07/27/15,3,21,774,350,41,2,4,0,6
07/27/15,3,22,542,350,37,5,2,0,7
07/27/15,3,23,782,350,47,0,5,0,5
07/27/15,3,24,776,360,28,2,0,0,2
07/27/15,3,25,775,375,19,7,4,0,11
07/27/15,3,26,542,360,26,7,8,0,15
07/27/15,3,27,7737,360,35,5,2,0,7
07/27/15,3,30,1001,270,34,6,2,0,8
07/28/15,1,1,738,305,103,7,37,6,50
07/28/15,1,2,726,315,110,25,25,4,54
07/28/15,1,3,999,220,62,19,6,1,26
07/28/15,1,4,996,220,61,21,8,0,29
07/28/15,1,5,8038,370,166,9,8,0,17
07/28/15,1,6,485,370,151,5,6,6,17
07/28/15,1,8,7652,350,15,1,2,2,5
07/28/15,1,9,8030,350,175,0,4,0,4
07/28/15,1,10,642,370,46,2,2,9,13
07/28/15,1,12,774,350,123,15,32,1,48
07/28/15,1,14,747,360,50,5,10,1,16
07/28/15,1,15,542,350,131,9,14,0,23
07/28/15,1,16,7738,350,147,4,8,2,14
07/28/15,1,17,641,370,139,6,13,0,19
07/28/15,1,18,3062,350,136,6,3,1,10
07/28/15,1,19,542,360,108,34,10,0,44
07/28/15,1,20,774,350,73,28,34,1,63
07/28/15,1,21,776,350,109,24,17,0,41
07/28/15,1,22,542,350,116,20,11,0,31
07/28/15,1,23,782,350,125,7,7,0,14
07/28/15,1,24,776,360,145,12,2,1,15
07/28/15,1,25,775,375,91,37,8,0,45
07/28/15,1,26,542,360,65,35,18,0,53
07/28/15,1,27,7737,360,134,9,16,0,25
07/28/15,1,29,7675,270,67,16,12,3,31
07/28/15,1,30,7675,270,83,14,5,0,19
07/28/15,2,1,738,305,99,5,48,6,59
07/28/15,2,2,726,315,107,19,20,3,42
07/28/15,2,3,999,220,10,2,1,0,3
07/28/15,2,4,996,220,55,19,6,0,25
07/28/15,2,5,8038,370,182,4,1,1,6
07/28/15,2,6,485,370,158,12,3,0,15
07/28/15,2,9,8030,350,174,1,2,1,4
07/28/15,2,10,642,370,156,4,8,0,12
07/28/15,2,11,8040,355,48,21,31,8,60
07/28/15,2,12,774,350,127,15,27,1,43
07/28/15,2,13,3062,350,64,3,4,2,9
07/28/15,2,15,542,350,104,12,9,0,21
07/28/15,2,16,7738,350,151,9,6,1,16
07/28/15,2,17,641,370,111,8,12,2,22
07/28/15,2,18,3062,350,63,15,5,5,25
07/28/15,2,19,542,360,71,34,10,0,44
07/28/15,2,20,774,350,45,32,32,1,65
07/28/15,2,21,776,350,105,18,11,0,29
07/28/15,2,22,542,350,105,18,11,0,29
07/28/15,2,23,782,350,136,2,13,0,15
07/28/15,2,24,776,360,82,2,1,1,4
07/28/15,2,25,775,375,54,23,3,0,26
07/28/15,2,26,542,360,69,31,16,0,47
07/28/15,2,27,7737,360,98,8,10,0,18
07/28/15,2,29,7675,270,68,17,8,1,26
07/28/15,2,30,7675,270,61,20,5,0,25
07/28/15,3,1,738,305,3,0,9,0,9
07/28/15,3,2,726,315,96,29,29,0,58
07/28/15,3,4,996,220,61,22,5,0,27
07/28/15,3,5,8038,370,154,28,5,4,37
07/28/15,3,6,485,370,134,5,8,2,15
07/28/15,3,9,8030,350,174,0,4,0,4
07/28/15,3,10,642,370,162,1,2,0,3
07/28/15,3,11,8040,355,111,15,32,7,54
07/28/15,3,12,774,350,122,21,23,0,44
07/28/15,3,15,542,350,115,16,8,0,24
07/28/15,3,16,7738,350,130,14,4,2,20
07/28/15,3,17,641,370,73,3,1,1,5
07/28/15,3,18,3062,350,32,18,1,2,21
07/28/15,3,19,542,360,30,12,6,0,18
07/28/15,3,20,774,350,36,6,15,2,23
07/28/15,3,21,776,350,35,2,4,0,6
07/28/15,3,22,542,350,35,2,4,0,6
07/28/15,3,23,782,350,34,1,1,0,2
07/28/15,3,25,775,375,17,8,2,0,10
07/28/15,3,26,542,360,13,11,6,0,17
07/28/15,3,27,7737,360,35,5,2,0,7
07/28/15,3,29,7675,270,17,2,1,0,3
07/28/15,3,30,7675,270,17,3,2,0,5
07/29/15,1,1,738,305,46,5,35,10,50
07/29/15,1,2,726,315,98,23,27,3,53
07/29/15,1,3,999,220,41,18,8,2,28
07/29/15,1,4,996,220,55,20,6,0,26
07/29/15,1,6,485,370,159,4,5,1,10
07/29/15,1,9,8030,350,175,3,0,2,5
07/29/15,1,10,642,370,161,5,5,0,10
07/29/15,1,11,8040,355,137,19,21,1,41
07/29/15,1,12,774,350,134,12,30,2,44
07/29/15,1,15,542,350,121,19,14,0,33
07/29/15,1,16,7738,350,143,8,14,1,23
07/29/15,1,17,641,370,172,5,7,0,12
07/29/15,1,18,3062,350,129,33,13,0,46
07/29/15,1,19,542,360,65,28,14,0,42
07/29/15,1,20,774,350,77,31,38,7,76
07/29/15,1,21,774,350,148,16,12,0,28
07/29/15,1,22,542,350,97,20,18,0,38
07/29/15,1,23,782,350,155,4,12,0,16
07/29/15,1,24,285,360,32,6,3,6,15
07/29/15,1,25,775,375,82,45,3,0,48
07/29/15,1,26,542,360,59,45,8,0,53
07/29/15,1,27,7737,360,167,15,12,0,27
07/29/15,1,29,7705,270,78,12,4,1,17
07/29/15,1,30,1001,270,57,17,8,2,27
07/29/15,2,1,738,305,71,12,63,5,80
07/29/15,2,2,726,315,10,2,4,0,6
07/29/15,2,3,999,220,60,19,9,0,28
07/29/15,2,4,996,220,68,22,8,0,30
07/29/15,2,6,485,370,142,11,7,4,22
07/29/15,2,9,8030,350,176,0,2,1,3
07/29/15,2,10,642,370,159,3,3,0,6
07/29/15,2,11,8040,355,104,23,24,1,48
07/29/15,2,12,774,350,113,7,31,0,38
07/29/15,2,15,542,350,82,17,10,0,27
07/29/15,2,16,7738,350,50,2,3,1,6
07/29/15,2,17,641,370,102,7,20,0,27
07/29/15,2,18,3062,350,134,10,5,0,15
07/29/15,2,20,774,350,50,22,28,1,51
07/29/15,2,21,774,350,119,11,8,0,19
07/29/15,2,22,542,350,95,13,12,0,25
07/29/15,2,23,782,350,111,2,14,0,16
07/29/15,2,24,285,360,109,16,5,3,24
07/29/15,2,25,775,375,36,29,1,0,30
07/29/15,2,26,542,360,57,37,11,0,48
07/29/15,2,27,7737,360,101,8,16,0,24
07/29/15,2,29,7705,270,57,20,5,0,25
07/29/15,2,30,1001,270,38,15,3,0,18
07/29/15,3,1,738,305,72,44,45,25,114
07/29/15,3,2,726,315,102,25,13,6,44
07/29/15,3,3,999,220,54,21,2,1,24
07/29/15,3,4,996,220,23,6,4,0,10
07/29/15,3,6,485,370,158,10,1,3,14
07/29/15,3,9,8030,350,179,0,1,1,2
07/29/15,3,10,642,370,158,3,3,2,8
07/29/15,3,11,8040,355,139,11,19,1,31
07/29/15,3,12,774,350,129,18,24,1,43
07/29/15,3,18,3062,350,133,3,11,1,15
07/29/15,3,20,774,350,36,6,15,2,23
07/29/15,3,21,774,350,35,2,4,0,6
07/29/15,3,22,542,350,29,4,7,0,11
07/29/15,3,23,782,350,34,1,1,0,2
07/29/15,3,25,775,375,17,8,2,0,10
07/29/15,3,26,542,360,13,11,6,0,17
07/30/15,1,1,738,305,83,26,59,10,95
07/30/15,1,2,726,315,114,32,16,1,49
07/30/15,1,3,999,220,45,11,4,0,15
07/30/15,1,6,485,370,157,6,6,1,13
07/30/15,1,8,7652,350,68,6,8,2,16
07/30/15,1,10,642,370,146,4,5,1,10
07/30/15,1,11,8040,355,135,13,13,3,29
07/30/15,1,12,774,350,121,5,31,5,41
07/30/15,1,18,3062,350,136,10,9,0,19
07/30/15,1,20,774,350,67,26,46,3,75
07/30/15,1,21,774,350,112,40,4,0,44
07/30/15,1,22,542,350,106,11,19,0,30
07/30/15,1,23,782,350,118,2,20,0,22
07/30/15,1,24,285,360,103,17,13,1,31
07/30/15,1,25,775,375,68,30,5,0,35
07/30/15,1,26,542,360,52,35,5,0,40
07/30/15,1,28,308,375,16,6,6,4,16
07/30/15,1,29,7705,270,79,21,6,1,28
07/30/15,1,30,1001,270,65,18,5,0,23
07/30/15,2,1,738,305,49,25,44,9,78
07/30/15,2,2,726,315,102,25,11,5,41
07/30/15,2,3,999,220,67,15,6,0,21
07/30/15,2,4,996,220,69,0,0,0,0
07/30/15,2,6,485,370,144,14,4,2,20
07/30/15,2,8,7652,350,14,1,3,1,5
07/30/15,2,10,642,370,161,4,5,0,9
07/30/15,2,11,8040,355,100,12,16,2,30
07/30/15,2,12,774,350,118,9,27,2,38
07/30/15,2,14,8035,360,26,4,2,4,10
07/30/15,2,18,3062,350,122,3,4,4,11
07/30/15,2,19,542,360,75,43,9,0,52
07/30/15,2,20,774,350,56,28,27,1,56
07/30/15,2,21,774,350,92,23,6,0,29
07/30/15,2,22,542,350,108,9,10,0,19
07/30/15,2,23,782,350,126,8,7,0,15
07/30/15,2,24,285,360,108,18,12,7,37
07/30/15,2,26,542,360,68,27,7,0,34
07/30/15,2,28,308,375,36,12,9,3,24
07/30/15,2,29,7705,270,74,20,7,0,27
07/30/15,2,30,1001,270,60,19,4,1,24
07/30/15,3,1,738,305,64,24,50,7,81
07/30/15,3,2,726,315,119,32,10,2,44
07/30/15,3,3,999,220,69,16,2,1,19
07/30/15,3,4,996,220,73,21,4,1,26
07/30/15,3,6,485,370,154,6,1,1,8
07/30/15,3,10,642,370,138,7,10,0,17
07/30/15,3,11,8040,355,135,18,10,1,29
07/30/15,3,12,774,350,106,9,34,2,45
07/30/15,3,14,8035,360,145,20,16,3,39
07/30/15,3,18,3062,350,138,11,36,1,48
07/30/15,3,27,7737,360,10,3,1,0,4
07/31/15,1,1,738,305,65,19,51,15,85
07/31/15,1,2,726,315,114,28,9,2,39
07/31/15,1,3,999,220,64,17,6,1,24
07/31/15,1,4,996,220,72,20,4,0,24
07/31/15,1,6,485,370,153,6,2,1,9
07/31/15,1,10,642,370,158,6,3,1,10
07/31/15,1,11,8040,355,111,12,22,3,37
07/31/15,1,12,774,350,118,2,26,2,30
07/31/15,1,14,8035,360,102,22,27,4,53
07/31/15,1,15,542,350,33,5,3,0,8
07/31/15,1,18,3062,350,150,8,14,1,23
07/31/15,1,19,542,360,92,47,12,0,59
07/31/15,1,20,774,350,72,20,54,2,76
07/31/15,1,21,774,350,133,16,9,0,25
07/31/15,1,22,542,350,102,14,24,0,38
07/31/15,1,23,782,350,127,6,14,0,20
07/31/15,1,24,285,360,122,23,12,4,39
07/31/15,1,26,542,360,59,39,13,0,52
07/31/15,1,27,7737,360,110,2,18,0,20
07/31/15,1,28,8032,375,14,2,6,7,15
07/31/15,1,29,7705,270,60,14,5,0,19
07/31/15,1,30,1001,270,55,17,7,0,24
07/31/15,2,1,738,305,72,18,48,17,83
07/31/15,2,2,726,315,121,20,12,1,33
07/31/15,2,3,999,220,51,18,8,0,26
07/31/15,2,4,996,220,69,21,5,0,26
07/31/15,2,6,485,370,160,7,0,5,12
07/31/15,2,8,7652,350,41,7,9,8,24
07/31/15,2,10,642,370,163,2,3,1,6
07/31/15,2,11,8040,355,110,25,18,0,43
07/31/15,2,12,774,350,118,5,32,0,37
07/31/15,2,14,8035,360,129,23,4,3,30
07/31/15,2,15,542,350,85,31,2,0,33
07/31/15,2,18,3062,350,136,11,6,1,18
07/31/15,2,19,542,360,55,37,12,0,49
07/31/15,2,20,774,350,67,6,36,1,43
07/31/15,2,21,774,350,118,4,12,0,16
07/31/15,2,22,542,350,88,9,14,0,23
07/31/15,2,23,782,350,97,4,14,0,18
07/31/15,2,24,285,360,114,17,9,2,28
07/31/15,2,26,542,360,57,33,17,0,50
07/31/15,2,27,7737,360,159,5,5,0,10
07/31/15,2,28,8032,375,55,10,33,1,44
07/31/15,2,29,7705,270,45,21,7,0,28
07/31/15,2,30,1001,270,59,18,6,1,25
07/31/15,3,1,738,305,46,32,33,10,75
07/31/15,3,2,726,315,123,37,11,0,48
07/31/15,3,4,996,220,75,15,4,0,19
07/31/15,3,6,485,370,159,5,4,2,11
07/31/15,3,10,642,370,25,0,4,0,4
07/31/15,3,11,8040,355,121,35,15,2,52
07/31/15,3,12,774,350,140,8,22,0,30
07/31/15,3,14,8035,360,117,46,3,3,52
07/31/15,3,15,542,350,124,18,13,0,31
07/31/15,3,18,3062,350,141,10,6,1,17
08/03/15,1,1,738,305,63,60,38,10,108
08/03/15,1,2,726,315,113,38,5,6,49
08/03/15,1,4,996,220,81,17,6,2,25
08/03/15,1,6,485,370,154,9,2,2,13
08/03/15,1,7,7743,345,22,12,4,5,21
08/03/15,1,12,774,350,145,10,26,1,37
08/03/15,1,14,8035,360,157,17,2,6,25
08/03/15,1,15,542,350,148,18,12,0,30
08/03/15,1,18,3062,350,160,4,6,2,12
08/03/15,1,19,542,360,88,51,20,0,71
08/03/15,1,20,774,350,84,5,53,4,62
08/03/15,1,21,774,350,133,3,17,0,20
08/03/15,1,22,542,350,87,12,27,0,39
08/03/15,1,23,782,350,143,9,11,0,20
08/03/15,1,24,285,360,123,10,9,4,23
08/03/15,1,26,542,360,87,34,16,0,50
08/03/15,1,27,435,360,158,3,18,0,21
08/03/15,1,28,8032,375,60,8,48,0,56
08/03/15,1,29,7705,270,17,4,1,0,5
08/03/15,1,30,1001,270,74,19,6,0,25
08/03/15,2,1,738,305,62,25,44,22,91
08/03/15,2,2,726,315,113,15,9,1,25
08/03/15,2,4,996,220,46,21,8,1,30
08/03/15,2,6,485,370,143,12,9,1,22
08/03/15,2,7,7743,345,82,45,11,6,62
08/03/15,2,9,542,350,31,4,22,5,31
08/03/15,2,12,774,350,124,10,22,2,34
08/03/15,2,14,8035,360,169,3,5,1,9
08/03/15,2,15,542,350,119,18,6,0,24
08/03/15,2,17,747,370,2,2,6,2,10
08/03/15,2,18,3062,350,80,2,3,1,6
08/03/15,2,19,542,360,77,45,4,0,49
08/03/15,2,20,774,350,64,8,35,2,45
08/03/15,2,21,774,350,104,8,10,0,18
08/03/15,2,22,542,350,93,6,15,0,21
08/03/15,2,23,782,350,121,3,14,0,17
08/03/15,2,24,285,360,133,13,14,1,28
08/03/15,2,26,542,360,52,27,11,0,38
08/03/15,2,27,435,360,131,2,10,0,12
08/03/15,2,28,8032,375,49,4,27,0,31
08/03/15,2,29,7705,270,72,19,5,0,24
08/03/15,2,30,1001,270,72,21,7,0,28
08/03/15,3,1,738,305,68,14,43,8,65
08/03/15,3,2,726,315,114,28,15,1,44
08/03/15,3,6,485,370,152,1,9,1,11
08/03/15,3,7,7743,345,97,61,6,4,71
08/03/15,3,9,542,350,115,17,25,2,44
08/03/15,3,12,774,350,127,19,24,0,43
08/03/15,3,14,8035,360,156,10,8,5,23
08/03/15,3,15,542,350,128,14,8,0,22
08/03/15,3,17,747,370,42,16,10,3,29
08/03/15,3,19,542,360,21,11,1,0,12
08/03/15,3,20,774,350,15,5,2,0,7
08/03/15,3,21,774,350,34,1,2,0,3
08/03/15,3,22,542,350,27,6,3,0,9
08/03/15,3,23,782,350,33,0,6,0,6
08/03/15,3,26,542,360,24,5,5,0,10
08/03/15,3,27,435,360,43,0,1,0,1
08/03/15,3,28,8032,375,22,1,14,1,16
08/03/15,3,29,7705,270,21,6,1,0,7
08/03/15,3,30,1001,270,22,4,0,0,4
08/04/15,1,1,738,305,98,14,40,3,57
08/04/15,1,2,726,315,136,17,10,0,27
08/04/15,1,3,5302,220,13,4,1,0,5
08/04/15,1,6,485,370,155,7,3,1,11
08/04/15,1,7,7743,345,103,39,13,0,52
08/04/15,1,9,542,350,106,14,29,5,48
08/04/15,1,12,774,350,127,9,42,1,52
08/04/15,1,14,8035,360,166,6,4,5,15
08/04/15,1,15,542,350,141,14,6,0,20
08/04/15,1,17,747,370,89,19,13,1,33
08/04/15,1,19,542,360,76,50,9,0,59
08/04/15,1,20,774,350,81,4,45,2,51
08/04/15,1,21,774,350,108,2,15,0,17
08/04/15,1,22,542,350,86,77,20,0,97
08/04/15,1,23,782,350,132,4,12,0,16
08/04/15,1,24,285,360,141,16,3,1,20
08/04/15,1,26,542,360,59,31,12,0,43
08/04/15,1,27,435,360,130,2,12,0,14
08/04/15,1,28,8032,375,72,15,35,0,50
08/04/15,1,29,7705,270,85,16,4,1,21
08/04/15,1,30,1001,270,68,20,6,0,26
08/04/15,2,1,738,305,72,9,65,3,77
08/04/15,2,2,726,315,102,22,9,5,36
08/04/15,2,3,5302,220,64,18,6,0,24
08/04/15,2,4,996,220,18,2,1,0,3
08/04/15,2,6,485,370,155,8,5,1,14
08/04/15,2,7,7743,345,73,34,6,4,44
08/04/15,2,9,542,350,135,16,21,0,37
08/04/15,2,12,774,350,135,10,22,0,32
08/04/15,2,14,8035,360,165,9,2,1,12
08/04/15,2,15,542,350,97,15,2,0,17
08/04/15,2,17,747,370,109,15,9,2,26
08/04/15,2,19,542,360,68,33,9,0,42
08/04/15,2,20,774,350,50,3,36,0,39
08/04/15,2,21,774,350,110,4,10,0,14
08/04/15,2,23,782,350,123,4,10,0,14
08/04/15,2,24,285,360,25,1,3,1,5
08/04/15,2,26,542,360,64,23,10,0,33
08/04/15,2,27,435,360,113,2,12,0,14
08/04/15,2,28,8032,375,40,9,28,0,37
08/04/15,2,29,7705,270,66,21,7,0,28
08/04/15,3,1,738,305,94,6,45,3,54
08/04/15,3,2,726,315,117,17,12,6,35
08/04/15,3,3,5302,220,81,20,5,1,26
08/04/15,3,4,996,220,62,21,7,1,29
08/04/15,3,5,435,370,92,28,10,6,44
08/04/15,3,6,485,370,156,9,6,2,17
08/04/15,3,7,7743,345,59,3,7,4,14
08/04/15,3,9,542,350,120,18,26,1,45
08/04/15,3,12,774,350,137,5,25,1,31
08/04/15,3,14,8035,360,120,23,7,5,35
08/04/15,3,15,542,350,122,14,13,0,27
08/04/15,3,19,542,360,30,25,1,0,26
08/04/15,3,20,774,350,28,2,21,0,23
08/04/15,3,21,774,350,45,1,4,0,5
08/04/15,3,22,542,350,33,9,5,0,14
08/04/15,3,23,782,350,39,11,3,0,14
08/04/15,3,26,542,360,26,15,4,0,19
08/04/15,3,27,435,360,44,0,8,0,8
08/04/15,3,28,8032,375,22,1,14,1,16
08/04/15,3,29,7705,270,13,1,1,0,2
08/04/15,3,30,1001,270,14,2,1,0,3
08/05/15,1,1,738,305,89,6,49,1,56
08/05/15,1,2,726,315,89,9,5,3,17
08/05/15,1,3,5302,220,84,21,2,0,23
08/05/15,1,4,996,220,51,28,21,0,49
08/05/15,1,5,435,370,162,1,69,1,71
08/05/15,1,6,485,370,151,12,1,3,16
08/05/15,1,7,7743,345,90,38,5,7,50
08/05/15,1,9,542,350,154,6,17,0,23
08/05/15,1,12,774,350,129,5,27,2,34
08/05/15,1,14,8035,360,175,8,0,0,8
08/05/15,1,15,542,350,129,17,10,0,27
08/05/15,1,17,747,370,84,11,31,0,42
08/05/15,1,19,542,360,68,63,4,0,67
08/05/15,1,20,774,350,72,4,59,0,63
08/05/15,1,21,774,350,129,7,12,0,19
08/05/15,1,22,542,350,67,6,22,0,28
08/05/15,1,23,782,350,137,6,16,0,22
08/05/15,1,25,497,375,31,0,3,0,3
08/05/15,1,26,542,360,58,36,14,0,50
08/05/15,1,27,435,360,143,3,14,0,17
08/05/15,1,28,8032,375,81,10,49,2,61
08/05/15,1,29,7705,270,80,9,5,0,14
08/05/15,1,30,1001,270,72,12,6,0,18
08/05/15,2,1,738,305,84,11,44,6,61
08/05/15,2,2,726,315,108,28,5,0,33
08/05/15,2,3,5302,220,70,23,6,0,29
08/05/15,2,4,996,220,47,19,2,0,21
08/05/15,2,5,435,370,142,6,9,3,18
08/05/15,2,6,485,370,130,11,5,5,21
08/05/15,2,7,7743,345,89,30,6,2,38
08/05/15,2,9,542,350,134,12,19,1,32
08/05/15,2,12,774,350,130,9,16,0,25
08/05/15,2,14,8035,360,167,3,5,1,9
08/05/15,2,15,542,350,100,10,2,6,18
08/05/15,2,17,747,370,109,24,9,2,35
08/05/15,2,19,542,360,47,55,4,0,59
08/05/15,2,22,542,350,70,10,16,0,26
08/05/15,2,23,782,350,118,5,13,0,18
08/05/15,2,25,497,375,124,4,8,0,12
08/05/15,2,26,542,360,49,33,8,0,41
08/05/15,2,27,435,360,105,0,17,0,17
08/05/15,2,28,8032,375,59,5,32,3,40
08/05/15,2,29,7705,270,79,12,4,1,17
08/05/15,2,30,1001,270,51,10,5,0,15
08/05/15,3,1,738,305,85,17,47,5,69
08/05/15,3,2,726,315,110,16,11,3,30
08/05/15,3,3,5302,220,76,21,5,0,26
08/05/15,3,4,996,220,58,20,4,0,24
08/05/15,3,5,435,370,145,3,14,4,21
08/05/15,3,6,485,370,163,6,1,0,7
08/05/15,3,7,7743,345,103,36,9,1,46
08/05/15,3,9,542,350,148,12,10,1,23
08/05/15,3,10,513,370,126,39,3,6,48
08/05/15,3,12,774,350,128,8,18,0,26
08/05/15,3,14,8035,360,90,6,11,2,19
08/05/15,3,15,542,350,118,18,12,0,30
08/05/15,3,17,747,370,38,2,30,0,32
08/05/15,3,19,542,360,23,10,5,0,15
08/05/15,3,20,774,350,29,2,11,0,13
08/05/15,3,22,542,350,26,3,6,0,9
08/05/15,3,23,782,350,48,0,5,0,5
08/05/15,3,25,497,375,56,0,3,0,3
08/05/15,3,26,542,360,19,13,3,0,16
08/05/15,3,27,435,360,57,1,5,0,6
08/05/15,3,28,8032,375,22,0,14,0,14
08/05/15,3,29,7705,270,32,5,6,1,12
08/05/15,3,30,1001,270,23,4,2,1,7
08/06/15,1,1,738,305,83,11,52,3,66
08/06/15,1,2,726,315,123,17,11,2,30
08/06/15,1,3,5302,220,83,14,2,0,16
08/06/15,1,4,996,220,50,23,18,0,41
08/06/15,1,5,435,370,169,1,0,1,2
08/06/15,1,6,485,370,158,5,6,5,16
08/06/15,1,7,7743,345,108,30,9,6,45
08/06/15,1,9,542,350,120,10,20,5,35
08/06/15,1,10,513,370,132,18,9,2,29
08/06/15,1,12,774,350,83,4,12,1,17
08/06/15,1,15,542,350,79,22,8,0,30
08/06/15,1,17,747,370,151,11,10,1,22
08/06/15,1,19,542,360,81,52,10,0,62
08/06/15,1,20,774,350,114,7,34,0,41
08/06/15,1,21,774,350,16,0,3,0,3
08/06/15,1,22,542,350,93,11,27,0,38
08/06/15,1,23,782,350,141,1,14,0,15
08/06/15,1,25,497,375,156,3,7,0,10
08/06/15,1,26,542,360,57,53,6,0,59
08/06/15,1,27,435,360,123,1,8,0,9
08/06/15,1,28,8032,375,68,5,50,0,55
08/06/15,1,29,7705,270,63,21,2,0,23
08/06/15,1,30,1001,270,75,15,8,0,23
08/06/15,2,1,738,305,29,70,30,7,107
08/06/15,2,2,726,315,125,13,14,1,28
08/06/15,2,3,5302,220,75,17,9,0,26
08/06/15,2,4,996,220,52,25,6,1,32
08/06/15,2,5,435,370,167,0,1,1,2
08/06/15,2,6,485,370,139,11,15,1,27
08/06/15,2,8,7652,350,57,13,7,1,21
08/06/15,2,9,542,350,147,7,18,0,25
08/06/15,2,10,513,370,131,15,11,4,30
08/06/15,2,13,542,350,152,61,13,1,75
08/06/15,2,15,542,350,75,33,4,0,37
08/06/15,2,17,747,370,115,12,22,2,36
08/06/15,2,19,542,360,94,36,9,0,45
08/06/15,2,20,774,350,112,19,35,1,55
08/06/15,2,21,774,350,120,7,8,0,15
08/06/15,2,22,542,350,101,13,18,0,31
08/06/15,2,25,497,375,160,7,3,0,10
08/06/15,2,26,542,360,52,39,8,0,47
08/06/15,2,27,435,360,135,3,10,0,13
08/06/15,2,28,8032,375,2,1,57,1,59
08/06/15,2,30,1001,270,18,17,9,0,26
08/06/15,3,1,738,305,74,24,33,7,64
08/06/15,3,2,726,315,101,13,11,2,26
08/06/15,3,3,5302,220,70,18,5,1,24
08/06/15,3,4,996,220,17,3,1,0,4
08/06/15,3,5,435,370,140,1,14,2,17
08/06/15,3,6,485,370,145,15,0,0,15
08/06/15,3,9,542,350,128,12,17,5,34
08/06/15,3,10,513,370,138,1,0,3,4
08/06/15,3,13,542,350,29,30,5,2,37
08/06/15,3,14,542,360,21,22,6,9,37
08/06/15,3,15,542,350,72,44,0,0,44
08/06/15,3,17,747,370,55,1,5,0,6
08/06/15,3,19,542,360,26,0,20,0,20
08/06/15,3,20,774,350,29,2,11,0,13
08/06/15,3,21,774,350,52,2,4,0,6
08/06/15,3,22,542,350,44,4,9,0,13
08/06/15,3,25,497,375,63,1,0,1,2
08/06/15,3,26,542,360,27,18,5,0,23
08/06/15,3,27,435,360,55,1,4,0,5
08/06/15,3,28,8032,375,22,3,14,0,17
08/06/15,3,30,1001,270,15,2,1,0,3
08/07/15,1,1,738,305,82,20,37,3,60
08/07/15,1,2,726,315,123,22,11,2,35
08/07/15,1,3,5302,220,71,21,2,0,23
08/07/15,1,5,435,370,160,1,7,0,8
08/07/15,1,6,485,370,155,13,3,1,17
08/07/15,1,9,542,350,144,5,19,0,24
08/07/15,1,10,513,370,142,14,13,0,27
08/07/15,1,13,542,350,57,64,10,7,81
08/07/15,1,14,542,360,85,72,13,0,85
08/07/15,1,15,542,350,82,22,12,0,34
08/07/15,1,16,7743,350,49,40,33,14,87
08/07/15,1,17,747,370,108,5,29,1,35
08/07/15,1,18,3062,350,88,10,4,0,14
08/07/15,1,19,542,360,77,32,8,0,40
08/07/15,1,20,774,350,98,13,29,2,44
08/07/15,1,21,774,350,132,4,14,0,18
08/07/15,1,22,542,350,99,14,15,0,29
08/07/15,1,23,782,350,26,4,1,0,5
08/07/15,1,25,497,375,166,3,1,0,4
08/07/15,1,26,542,360,51,35,15,0,50
08/07/15,1,27,435,360,162,2,9,0,11
08/07/15,1,28,8032,375,50,4,38,0,42
08/07/15,1,30,1001,270,57,23,18,0,41
08/07/15,2,1,738,305,67,15,33,10,58
08/07/15,2,2,726,315,102,9,18,1,28
08/07/15,2,3,5302,220,62,23,4,0,27
08/07/15,2,4,996,220,78,21,3,0,24
08/07/15,2,5,435,370,165,1,3,0,4
08/07/15,2,6,485,370,148,6,3,4,13
08/07/15,2,8,7652,350,23,0,1,9,10
08/07/15,2,9,542,350,143,7,16,0,23
08/07/15,2,10,513,370,134,15,9,2,26
08/07/15,2,13,542,350,54,33,2,0,35
08/07/15,2,14,542,360,71,45,8,0,53
08/07/15,2,16,7743,350,43,14,26,0,40
08/07/15,2,17,747,370,146,4,7,2,13
08/07/15,2,18,3062,350,133,15,10,0,25
08/07/15,2,19,542,360,57,49,7,0,56
08/07/15,2,20,774,350,70,40,16,3,59
08/07/15,2,21,774,350,130,7,14,0,21
08/07/15,2,22,542,350,79,7,17,0,24
08/07/15,2,23,782,350,131,2,17,0,19
08/07/15,2,25,497,375,157,9,1,0,10
08/07/15,2,26,542,360,43,38,11,0,49
08/07/15,2,27,435,360,133,1,14,0,15
08/07/15,2,28,8032,375,57,6,33,3,42
08/07/15,2,30,1001,270,41,19,16,0,35
08/07/15,3,1,738,305,80,26,37,8,71
08/07/15,3,2,726,315,104,37,16,3,56
08/07/15,3,3,5302,220,76,19,3,1,23
08/07/15,3,4,996,220,78,20,4,0,24
08/07/15,3,5,435,370,150,2,5,2,9
08/07/15,3,6,485,370,147,7,10,4,21
08/07/15,3,9,542,350,117,11,25,2,38
08/07/15,3,10,513,370,130,20,4,1,25
08/07/15,3,13,542,350,75,30,5,1,36
08/07/15,3,16,7743,350,47,14,26,0,40
08/17/15,1,1,738,305,63,18,44,10,72
08/17/15,1,2,726,315,108,17,9,0,26
08/17/15,1,3,5302,220,29,18,2,0,20
08/17/15,1,4,996,220,44,22,12,0,34
08/17/15,1,5,435,370,167,3,0,0,3
08/17/15,1,6,485,370,153,10,6,2,18
08/17/15,1,9,542,350,142,17,8,0,25
08/17/15,1,10,513,370,137,27,7,3,37
08/17/15,1,11,8040,355,17,17,10,0,27
08/17/15,1,13,542,350,99,28,8,1,37
08/17/15,1,14,542,360,76,70,5,1,76
08/17/15,1,15,542,350,2,6,1,0,7
08/17/15,1,16,7743,350,45,16,35,2,53
08/17/15,1,17,747,370,202,2,3,2,7
08/17/15,1,18,3062,350,135,17,8,0,25
08/17/15,1,19,542,360,61,40,8,0,48
08/17/15,1,20,774,350,114,14,30,0,44
08/17/15,1,21,774,350,161,4,13,0,17
08/17/15,1,22,542,350,70,11,15,0,26
08/17/15,1,23,782,350,115,5,10,0,15
08/17/15,1,25,497,375,150,7,9,0,16
08/17/15,1,26,542,360,49,36,10,0,46
08/17/15,1,27,435,360,130,2,15,0,17
08/17/15,1,28,8032,375,71,5,35,3,43
08/17/15,1,30,1001,270,57,27,12,0,39
08/17/15,2,1,738,305,52,7,37,12,56
08/17/15,2,2,726,315,97,16,11,1,28
08/17/15,2,3,5302,220,28,18,3,0,21
08/17/15,2,4,996,220,45,23,15,0,38
08/17/15,2,5,435,370,143,1,7,1,9
08/17/15,2,6,485,370,153,5,3,0,8
08/17/15,2,8,7652,350,25,7,8,0,15
08/17/15,2,9,542,350,84,20,14,0,34
08/17/15,2,10,513,370,132,12,7,0,19
08/17/15,2,11,8040,355,44,54,15,0,69
08/17/15,2,13,542,350,88,33,7,1,41
08/17/15,2,14,542,360,98,20,12,0,32
08/17/15,2,15,542,350,45,35,6,0,41
08/17/15,2,16,7743,350,46,7,28,1,36
08/17/15,2,17,747,370,172,11,2,0,13
08/17/15,2,18,3062,350,95,7,3,2,12
08/17/15,2,19,542,360,86,36,8,0,44
08/17/15,2,20,774,350,70,8,31,0,39
08/17/15,2,21,774,350,15,5,15,0,20
08/17/15,2,22,542,350,74,15,15,0,30
08/17/15,2,23,782,350,112,3,13,0,16
08/17/15,2,25,497,375,118,4,9,0,13
08/17/15,2,26,542,360,37,24,11,0,35
08/17/15,2,27,435,360,121,1,15,0,16
08/17/15,2,28,8032,375,38,5,29,1,35
08/17/15,2,30,1001,270,60,29,10,0,39
08/17/15,3,1,738,305,79,12,41,8,61
08/17/15,3,2,726,315,72,7,11,0,18
08/17/15,3,3,5302,220,61,20,5,0,25
08/17/15,3,4,996,220,25,63,25,10,98
08/17/15,3,5,435,370,164,1,3,1,5
08/17/15,3,6,485,370,155,12,3,2,17
08/17/15,3,9,542,350,109,35,14,3,52
08/17/15,3,10,513,370,141,25,7,0,32
08/17/15,3,11,8040,355,88,49,24,3,76
08/17/15,3,13,542,350,89,61,4,3,68
08/17/15,3,14,542,360,116,43,11,3,57
08/17/15,3,15,542,350,16,9,5,0,14
08/17/15,3,16,7743,350,84,12,36,1,49
08/17/15,3,17,747,370,55,1,5,0,6
08/17/15,3,19,542,360,15,5,3,0,8
08/17/15,3,20,774,350,29,2,11,0,13
08/17/15,3,21,774,350,42,0,0,0,0
08/17/15,3,22,542,350,17,8,4,0,12
08/17/15,3,23,782,350,30,1,4,0,5
08/17/15,3,25,497,375,43,1,0,0,1
08/17/15,3,26,542,360,26,8,2,0,10
08/17/15,3,27,435,360,41,0,2,0,2
08/17/15,3,30,1001,270,11,2,1,0,3
08/18/15,1,1,738,305,72,11,36,7,54
08/18/15,1,2,726,315,68,27,6,4,37
08/18/15,1,3,5302,220,63,18,3,0,21
08/18/15,1,4,996,220,57,19,12,0,31
08/18/15,1,5,435,370,171,1,2,0,3
08/18/15,1,6,485,370,154,9,2,2,13
08/18/15,1,8,7742,350,13,3,2,0,5
08/18/15,1,9,542,350,79,40,12,3,55
08/18/15,1,10,513,370,134,21,9,0,30
08/18/15,1,11,8040,355,66,79,13,1,93
08/18/15,1,12,7548,350,42,7,6,6,19
08/18/15,1,13,542,350,108,43,5,0,48
08/18/15,1,14,542,360,122,20,16,0,36
08/18/15,1,15,542,350,102,45,10,0,55
08/18/15,1,16,7743,350,100,16,15,0,31
08/18/15,1,17,747,370,174,4,8,0,12
08/18/15,1,19,542,360,97,42,7,0,49
08/18/15,1,20,774,350,113,8,26,0,34
08/18/15,1,21,774,350,103,8,13,0,21
08/18/15,1,22,542,350,102,22,22,0,44
08/18/15,1,23,782,350,140,3,18,0,21
08/18/15,1,25,497,375,163,12,2,0,14
08/18/15,1,26,542,360,76,31,25,0,56
08/18/15,1,27,435,360,149,1,6,0,7
08/18/15,1,28,8032,375,75,8,41,1,50
08/18/15,1,29,7705,270,2,0,0,0,0
08/18/15,1,30,1001,270,75,16,8,0,24
08/18/15,2,1,738,305,67,14,35,10,59
08/18/15,2,2,726,315,96,19,13,3,35
08/18/15,2,3,5302,220,49,26,2,0,28
08/18/15,2,4,996,220,48,17,16,0,33
08/18/15,2,5,435,370,163,2,3,1,6
08/18/15,2,6,485,370,151,4,7,3,14
08/18/15,2,8,7742,350,17,8,4,2,14
08/18/15,2,9,542,350,90,38,9,0,47
08/18/15,2,10,513,370,123,17,13,2,32
08/18/15,2,11,8040,355,56,28,12,2,42
08/18/15,2,12,7548,350,122,18,8,2,28
08/18/15,2,13,542,350,64,37,7,2,46
08/18/15,2,14,542,360,83,38,7,1,46
08/18/15,2,15,542,350,86,28,3,0,31
08/18/15,2,16,7743,350,52,13,18,1,32
08/18/15,2,17,747,370,161,11,3,1,15
08/18/15,2,19,542,360,90,45,8,0,53
08/18/15,2,20,774,350,85,4,30,5,39
08/18/15,2,21,774,350,132,3,13,0,16
08/18/15,2,22,542,350,103,14,11,0,25
08/18/15,2,23,782,350,124,2,15,0,17
08/18/15,2,25,497,375,169,1,1,0,2
08/18/15,2,26,542,360,42,21,12,0,33
08/18/15,2,27,435,360,146,1,9,0,10
08/18/15,2,28,8032,375,33,2,35,0,37
08/18/15,2,29,7705,270,18,15,1,0,16
08/18/15,2,30,1001,270,33,8,8,0,16
08/18/15,3,1,738,305,84,17,34,10,61
08/18/15,3,2,726,315,115,30,10,1,41
08/18/15,3,3,5302,220,50,21,4,0,25
08/18/15,3,4,996,220,18,6,2,0,8
08/18/15,3,5,435,370,162,1,4,1,6
08/18/15,3,6,485,370,140,6,12,2,20
08/18/15,3,9,542,350,98,55,9,1,65
08/18/15,3,10,513,370,122,32,7,0,39
08/18/15,3,11,8040,355,85,40,19,4,63
08/18/15,3,12,7548,350,130,19,6,1,26
08/18/15,3,13,542,350,89,61,4,3,68
08/18/15,3,14,542,360,87,41,9,0,50
08/18/15,3,15,542,350,124,18,9,0,27
08/18/15,3,16,7743,350,84,12,36,1,49
08/18/15,3,17,747,370,22,2,4,1,7
08/18/15,3,19,542,360,13,2,1,0,3
08/18/15,3,20,774,350,29,2,11,0,13
08/18/15,3,21,774,350,17,1,2,0,3
08/18/15,3,22,542,350,13,5,0,0,5
08/18/15,3,23,782,350,16,1,2,0,3
08/18/15,3,25,497,375,20,0,1,0,1
08/18/15,3,26,542,360,5,0,5,0,5
08/18/15,3,27,435,360,20,0,1,0,1
08/18/15,3,28,8032,375,17,1,4,0,5
08/19/15,1,1,738,305,54,28,35,11,74
08/19/15,1,2,726,315,68,47,11,2,60
08/19/15,1,3,5302,220,59,23,3,0,26
08/19/15,1,4,996,220,14,3,3,0,6
08/19/15,1,5,435,370,162,3,2,1,6
08/19/15,1,6,485,370,151,14,4,2,20
08/19/15,1,9,542,350,77,43,10,0,53
08/19/15,1,10,513,370,103,32,10,1,43
08/19/15,1,11,8040,355,65,7,23,4,34
08/19/15,1,12,774,350,108,22,11,0,33
08/19/15,1,13,542,350,121,30,13,3,46
08/19/15,1,14,8035,360,65,61,10,4,75
08/19/15,1,15,542,350,92,36,0,0,36
08/19/15,1,16,7738,350,94,25,22,2,49
08/19/15,1,17,747,370,157,2,13,1,16
08/19/15,1,19,542,360,83,40,19,0,59
08/19/15,1,20,774,350,113,12,32,0,44
08/19/15,1,21,774,350,131,7,16,0,23
08/19/15,1,22,542,350,107,21,12,0,33
08/19/15,1,23,782,350,100,6,23,0,29
08/19/15,1,25,497,375,178,0,2,0,2
08/19/15,1,26,542,360,66,32,15,0,47
08/19/15,1,27,435,360,50,9,45,0,54
08/19/15,1,28,8032,375,145,0,11,0,11
08/19/15,1,30,7675,270,14,4,2,0,6
08/19/15,2,1,738,305,53,15,29,5,49
08/19/15,2,2,726,315,83,23,10,1,34
08/19/15,2,3,5302,220,68,19,5,0,24
08/19/15,2,4,996,220,37,10,2,0,12
08/19/15,2,5,435,370,159,2,4,0,6
08/19/15,2,6,485,370,161,8,1,0,9
08/19/15,2,9,542,350,97,13,10,1,24
08/19/15,2,10,513,370,109,22,6,0,28
08/19/15,2,11,8040,355,48,36,14,1,51
08/19/15,2,12,774,350,121,19,4,0,23
08/19/15,2,13,542,350,103,28,10,2,40
08/19/15,2,14,8035,360,61,28,10,1,39
08/19/15,2,15,542,350,47,33,1,0,34
08/19/15,2,16,7738,350,60,14,21,2,37
08/19/15,2,17,747,370,197,13,8,1,22
08/19/15,2,19,542,360,69,39,7,0,46
08/19/15,2,20,774,350,117,12,35,2,49
08/19/15,2,21,774,350,131,1,10,0,11
08/19/15,2,22,542,350,58,9,13,0,22
08/19/15,2,25,497,375,184,1,1,0,2
08/19/15,2,26,542,360,26,27,4,0,31
08/19/15,2,27,435,360,135,2,7,0,9
08/19/15,2,28,8032,375,60,10,43,3,56
08/19/15,2,29,737,270,7,2,1,0,3
08/19/15,2,30,7675,270,76,17,5,1,23
08/19/15,3,1,738,305,69,16,37,12,65
08/19/15,3,2,726,315,93,36,10,0,46
08/19/15,3,3,5302,220,73,21,6,0,27
08/19/15,3,4,996,220,53,22,4,0,26
08/19/15,3,5,435,370,74,0,5,0,5
08/19/15,3,6,485,370,137,13,5,2,20
08/19/15,3,8,7742,350,84,4,4,8,16
08/19/15,3,9,542,350,52,9,12,0,21
08/19/15,3,10,513,370,90,26,12,0,38
08/19/15,3,11,8040,355,74,48,20,2,70
08/19/15,3,12,774,350,138,20,7,2,29
08/19/15,3,13,542,350,89,61,4,3,68
08/19/15,3,14,8035,360,65,70,9,0,79
08/19/15,3,15,542,350,64,50,3,0,53
08/19/15,3,16,7738,350,84,12,36,1,49
08/19/15,3,17,747,370,23,2,4,1,7
08/19/15,3,19,542,360,37,11,2,0,13
08/19/15,3,20,774,350,29,2,11,18,31
08/19/15,3,21,774,350,37,2,3,0,5
08/19/15,3,22,542,350,21,4,6,0,10
08/19/15,3,25,497,375,50,1,0,0,1
08/19/15,3,26,542,360,19,11,6,0,17
08/19/15,3,27,435,360,47,0,5,0,5
08/19/15,3,28,8032,375,6,0,7,0,7
08/19/15,3,29,737,270,22,4,2,0,6
08/19/15,3,30,7675,270,37,6,1,0,7
08/20/15,1,1,738,305,63,12,44,7,63
08/20/15,1,2,726,315,99,32,8,3,43
08/20/15,1,3,5302,220,72,18,3,0,21
08/20/15,1,4,996,220,38,10,6,0,16
08/20/15,1,6,485,370,148,15,2,2,19
08/20/15,1,8,7652,350,132,0,6,8,14
08/20/15,1,11,8040,355,64,31,20,2,53
08/20/15,1,12,774,350,126,13,13,2,28
08/20/15,1,13,542,350,116,24,5,0,29
08/20/15,1,14,542,360,19,13,1,0,14
08/20/15,1,15,542,350,48,40,2,0,42
08/20/15,1,16,7738,350,90,15,41,0,56
08/20/15,1,17,747,370,155,11,6,2,19
08/20/15,1,19,542,360,82,33,14,0,47
08/20/15,1,20,774,350,113,9,29,1,39
08/20/15,1,21,774,350,142,6,12,0,18
08/20/15,1,22,542,350,90,17,15,0,32
08/20/15,1,25,497,375,176,6,0,0,6
08/20/15,1,26,542,360,47,26,11,0,37
08/20/15,1,27,435,360,105,5,4,0,9
08/20/15,1,28,8032,375,56,15,49,0,64
08/20/15,1,29,7705,270,76,18,8,0,26
08/20/15,1,30,1001,270,87,12,6,0,18
08/20/15,2,1,738,305,59,9,36,20,65
08/20/15,2,2,726,315,119,8,15,3,26
08/20/15,2,3,5302,220,70,21,4,0,25
08/20/15,2,4,996,220,4,1,1,0,2
08/20/15,2,6,485,370,39,5,4,4,13
08/20/15,2,8,7652,350,174,0,4,0,4
08/20/15,2,9,542,350,17,133,3,8,144
08/20/15,2,11,8040,355,64,18,19,1,38
08/20/15,2,12,774,350,137,19,5,2,26
08/20/15,2,13,542,350,104,19,4,1,24
08/20/15,2,14,542,360,51,45,2,1,48
08/20/15,2,15,542,350,17,27,0,0,27
08/20/15,2,16,7738,350,65,16,17,0,33
08/20/15,2,17,747,370,152,7,5,0,12
08/20/15,2,18,3062,350,16,34,12,1,47
08/20/15,2,19,542,360,2,2,1,0,3
08/20/15,2,20,774,350,69,6,29,2,37
08/20/15,2,21,774,350,127,6,12,0,18
08/20/15,2,22,542,350,58,15,13,0,28
08/20/15,2,25,497,375,173,3,1,0,4
08/20/15,2,26,542,360,53,26,10,0,36
08/20/15,2,28,8032,375,50,17,37,1,55
08/20/15,2,29,7705,270,69,24,5,0,29
08/20/15,2,30,1001,270,57,23,12,0,35
08/20/15,3,1,738,305,63,10,53,24,87
08/20/15,3,2,726,315,102,10,25,2,37
08/20/15,3,3,5302,220,68,17,5,0,22
08/20/15,3,4,996,220,50,16,7,0,23
08/20/15,3,8,7652,350,174,2,0,0,2
08/20/15,3,9,542,350,93,44,18,2,64
08/20/15,3,11,8040,355,81,30,28,2,60
08/20/15,3,12,774,350,136,11,10,1,22
08/20/15,3,13,542,350,125,26,8,1,35
08/20/15,3,14,542,360,90,69,8,1,78
08/20/15,3,15,542,350,64,50,3,0,53
08/20/15,3,16,7738,350,78,30,30,0,60
08/20/15,3,17,747,370,23,2,4,1,7
08/20/15,3,18,3062,350,12,14,6,2,22
08/20/15,3,19,542,360,22,15,7,0,22
08/20/15,3,20,774,350,29,2,11,0,13
08/20/15,3,21,774,350,52,2,3,0,5
08/20/15,3,22,542,350,44,7,3,0,10
08/20/15,3,25,497,375,52,2,1,0,3
08/20/15,3,26,542,360,32,14,5,0,19
08/20/15,3,28,8032,375,18,3,10,0,13
08/20/15,3,29,7705,270,30,12,2,0,14
08/20/15,3,30,1001,270,33,15,6,0,21
08/21/15,1,1,738,305,66,7,36,11,54
08/21/15,1,2,726,315,114,16,10,2,28
08/21/15,1,3,5302,220,59,23,2,0,25
08/21/15,1,4,996,220,41,12,15,0,27
08/21/15,1,8,618,350,177,2,0,1,3
08/21/15,1,9,542,350,67,74,12,0,86
08/21/15,1,11,8040,355,103,16,23,0,39
08/21/15,1,12,774,350,58,6,7,1,14
08/21/15,1,13,542,350,149,28,3,1,32
08/21/15,1,14,542,360,42,65,17,0,82
08/21/15,1,15,542,350,89,27,3,0,30
08/21/15,1,16,7743,350,90,21,32,0,53
08/21/15,1,17,747,370,163,4,7,1,12
08/21/15,1,18,3062,350,51,39,29,0,68
08/21/15,1,19,542,360,57,33,26,0,59
08/21/15,1,20,774,350,68,29,37,0,66
08/21/15,1,21,774,350,155,5,9,0,14
08/21/15,1,22,542,350,98,15,13,0,28
08/21/15,1,25,497,375,185,1,0,0,1
08/21/15,1,28,8032,375,68,10,52,2,64
08/21/15,1,29,7705,270,85,10,3,0,13
08/21/15,1,30,1001,270,79,15,11,0,26
08/21/15,2,1,738,305,88,8,48,3,59
08/21/15,2,2,726,315,124,18,12,1,31
08/21/15,2,3,5302,220,56,27,3,0,30
08/21/15,2,8,618,350,176,3,0,0,3
08/21/15,2,9,542,350,76,53,8,1,62
08/21/15,2,11,8040,355,76,27,24,0,51
08/21/15,2,13,542,350,91,13,8,0,21
08/21/15,2,14,542,360,32,102,4,1,107
08/21/15,2,15,542,350,54,16,6,0,22
08/21/15,2,16,7743,350,65,1,17,0,18
08/21/15,2,17,747,370,130,14,6,1,21
08/21/15,2,18,3062,350,34,68,13,0,81
08/21/15,2,19,542,360,67,33,14,0,47
08/21/15,2,20,774,350,73,21,22,2,45
08/21/15,2,21,774,350,92,6,9,0,15
08/21/15,2,22,542,350,71,7,15,0,22
08/21/15,2,25,497,375,128,3,3,0,6
08/21/15,2,26,542,360,12,7,4,0,11
08/21/15,2,28,8032,375,47,7,23,1,31
08/21/15,2,29,7705,270,74,19,5,0,24
08/21/15,2,30,1001,270,64,21,18,0,39
08/21/15,3,1,738,305,81,14,43,1,58
08/21/15,3,2,726,315,114,16,16,0,32
08/21/15,3,3,5302,220,77,20,4,1,25
08/21/15,3,4,996,220,29,10,1,0,11
08/21/15,3,8,618,350,174,0,2,1,3
08/21/15,3,9,542,350,105,45,14,1,60
08/21/15,3,11,8040,355,100,25,22,3,50
08/21/15,3,12,774,350,49,8,17,2,27
08/21/15,3,13,542,350,51,8,7,4,19
08/21/15,3,14,542,360,48,81,6,2,89
08/21/15,3,15,542,350,91,37,81,0,118
08/24/15,1,1,738,305,77,5,37,13,55
08/24/15,1,2,726,315,120,20,13,3,36
08/24/15,1,3,5302,220,72,15,3,0,18
08/24/15,1,4,996,220,46,23,21,0,44
08/24/15,1,8,7652,350,212,3,0,0,3
08/24/15,1,9,542,350,79,48,17,0,65
08/24/15,1,11,8040,355,88,31,33,0,64
08/24/15,1,12,8032,350,121,16,16,0,32
08/24/15,1,13,542,350,33,7,1,3,11
08/24/15,1,14,542,360,48,33,4,0,37
08/24/15,1,15,542,350,70,37,0,0,37
08/24/15,1,17,747,370,155,5,15,1,21
08/24/15,1,18,542,350,65,76,12,3,91
08/24/15,1,19,542,360,54,26,19,0,45
08/24/15,1,20,774,350,107,14,29,1,44
08/24/15,1,21,774,350,12,4,0,0,4
08/24/15,1,22,542,350,84,15,14,0,29
08/24/15,1,25,497,375,193,4,0,0,4
08/24/15,1,26,542,360,81,26,14,0,40
08/24/15,1,28,8032,375,58,13,54,2,69
08/24/15,1,29,737,270,88,16,2,0,18
08/24/15,1,30,1001,270,62,21,12,0,33
08/24/15,2,1,738,305,69,5,40,6,51
08/24/15,2,2,726,315,87,27,3,6,36
08/24/15,2,3,5302,220,68,14,4,0,18
08/24/15,2,4,996,220,44,25,22,0,47
08/24/15,2,7,7740,345,7,4,16,15,35
08/24/15,2,8,7652,350,77,1,3,1,5
08/24/15,2,9,542,350,86,36,12,0,48
08/24/15,2,11,8040,355,73,25,22,0,47
08/24/15,2,12,8032,350,107,14,24,0,38
08/24/15,2,13,542,350,107,16,13,1,30
08/24/15,2,14,542,360,60,61,6,1,68
08/24/15,2,15,542,350,110,10,5,0,15
08/24/15,2,17,747,370,156,2,4,1,7
08/24/15,2,18,542,350,55,67,7,0,74
08/24/15,2,19,542,360,56,23,18,0,41
08/24/15,2,20,774,350,92,7,23,0,30
08/24/15,2,21,774,350,92,8,24,0,32
08/24/15,2,22,542,350,56,16,10,0,26
08/24/15,2,25,497,375,154,6,0,0,6
08/24/15,2,26,542,360,67,24,8,0,32
08/24/15,2,28,8032,375,22,3,15,0,18
08/24/15,2,29,737,270,58,25,5,0,30
08/24/15,2,30,1001,270,57,21,23,0,44
08/24/15,3,1,738,305,80,9,54,2,65
08/24/15,3,2,726,315,113,16,18,1,35
08/24/15,3,3,5302,220,33,10,2,0,12
08/24/15,3,4,996,220,65,23,4,1,28
08/24/15,3,9,542,350,93,81,9,0,90
08/24/15,3,11,8040,355,98,10,40,1,51
08/24/15,3,12,8032,350,108,26,21,1,48
08/24/15,3,13,542,350,120,35,9,0,44
08/24/15,3,14,542,360,87,86,7,2,95
08/24/15,3,15,542,350,39,3,1,0,4
08/24/15,3,17,747,370,23,2,4,1,7
08/24/15,3,18,542,350,22,20,2,0,22
08/24/15,3,19,542,360,23,4,6,0,10
08/24/15,3,20,774,350,22,3,5,0,8
08/24/15,3,21,774,350,25,3,7,0,10
08/24/15,3,25,497,375,32,1,0,0,1
08/24/15,3,26,542,360,24,6,3,0,9
08/24/15,3,27,542,360,18,9,2,0,11
08/24/15,3,29,737,270,21,13,2,0,15
08/24/15,3,30,1001,270,14,4,1,0,5
08/25/15,1,1,738,305,81,16,40,1,57
08/25/15,1,2,726,315,111,19,11,2,32
08/25/15,1,3,5302,220,84,12,3,0,15
08/25/15,1,4,996,220,44,28,22,0,50
08/25/15,1,8,7652,350,10,0,3,0,3
08/25/15,1,9,542,350,88,48,16,0,64
08/25/15,1,11,8040,355,91,34,28,0,62
08/25/15,1,12,8032,350,111,28,9,0,37
08/25/15,1,13,542,350,124,35,14,1,50
08/25/15,1,14,542,360,73,84,6,0,90
08/25/15,1,15,542,350,130,18,8,0,26
08/25/15,1,17,747,370,167,2,9,1,12
08/25/15,1,18,542,350,67,50,13,0,63
08/25/15,1,19,542,360,74,24,23,0,47
08/25/15,1,20,774,350,111,18,18,0,36
08/25/15,1,21,774,350,1158,60,22,0,82
08/25/15,1,25,497,375,181,3,0,0,3
08/25/15,1,26,542,360,63,25,12,0,37
08/25/15,1,27,542,360,77,34,10,0,44
08/25/15,1,28,8032,375,72,10,23,0,33
08/25/15,1,29,737,270,84,12,3,0,15
08/25/15,1,30,1001,270,76,12,15,0,27
08/25/15,2,1,738,305,79,1,40,11,52
08/25/15,2,2,726,315,93,34,9,1,44
08/25/15,2,3,5302,220,56,23,4,0,27
08/25/15,2,4,996,220,18,9,5,0,14
08/25/15,2,8,7652,350,123,2,5,2,9
08/25/15,2,9,542,350,54,34,17,6,57
08/25/15,2,11,8040,355,82,27,27,0,54
08/25/15,2,12,8032,350,98,21,27,0,48
08/25/15,2,13,542,350,76,16,16,1,33
08/25/15,2,14,542,360,88,34,13,1,48
08/25/15,2,15,542,350,99,14,3,0,17
08/25/15,2,17,747,370,11,0,8,0,8
08/25/15,2,18,542,350,64,34,14,0,48
08/25/15,2,19,542,360,49,13,20,0,33
08/25/15,2,20,774,350,64,9,21,0,30
08/25/15,2,21,774,350,63,6,22,0,28
08/25/15,2,22,542,350,78,28,9,0,37
08/25/15,2,25,497,375,15,0,1,0,1
08/25/15,2,26,542,360,71,22,18,0,40
08/25/15,2,27,542,360,40,23,5,0,28
08/25/15,2,28,8032,375,80,14,25,2,41
08/25/15,2,29,737,270,84,11,5,0,16
08/25/15,2,30,1001,270,22,5,6,0,11
08/25/15,3,1,738,305,89,9,51,2,62
08/25/15,3,2,726,315,98,25,24,3,52
08/25/15,3,3,5302,220,64,22,3,0,25
08/25/15,3,8,7652,350,161,3,5,0,8
08/25/15,3,9,542,350,88,66,5,1,72
08/25/15,3,11,8040,355,93,18,36,1,55
08/25/15,3,12,8032,350,111,23,19,3,45
08/25/15,3,13,542,350,120,35,9,0,44
08/25/15,3,15,542,350,131,10,6,0,16
08/25/15,3,18,542,350,17,10,5,0,15
08/25/15,3,19,542,360,20,9,4,0,13
08/25/15,3,20,774,350,66,21,13,0,34
08/25/15,3,21,774,350,27,1,4,0,5
08/25/15,3,22,542,350,10,2,3,0,5
08/25/15,3,26,542,360,27,27,4,0,31
08/25/15,3,27,542,360,9,9,4,0,13
08/25/15,3,28,8032,375,18,18,10,0,28
08/25/15,3,29,737,270,23,2,1,0,3
08/26/15,1,1,738,305,80,9,52,0,61
08/26/15,1,2,726,315,119,15,18,3,36
08/26/15,1,3,5302,220,79,15,2,0,17
08/26/15,1,4,996,220,26,10,4,0,14
08/26/15,1,8,618,350,173,8,2,0,10
08/26/15,1,9,542,350,115,48,14,0,62
08/26/15,1,11,8040,355,93,44,31,10,85
08/26/15,1,12,8032,350,127,21,21,2,44
08/26/15,1,13,542,350,117,51,11,2,64
08/26/15,1,14,542,360,73,84,6,0,90
08/26/15,1,15,542,350,114,11,4,0,15
08/26/15,1,17,747,370,167,2,9,1,12
08/26/15,1,18,542,350,93,95,14,1,110
08/26/15,1,19,542,360,64,15,30,0,45
08/26/15,1,21,774,350,71,5,22,0,27
08/26/15,1,22,542,350,77,63,4,0,67
08/26/15,1,26,542,360,112,31,12,0,43
08/26/15,1,27,542,360,85,28,12,0,40
08/26/15,1,28,8032,375,105,20,34,0,54
08/26/15,1,29,737,270,83,12,3,0,15
08/26/15,2,1,738,305,79,10,47,4,61
08/26/15,2,2,726,315,101,13,22,1,36
08/26/15,2,3,5302,220,54,17,5,0,22
08/26/15,2,4,996,220,56,14,3,0,17
08/26/15,2,5,8030,370,65,10,21,10,41
08/26/15,2,8,618,350,123,2,5,2,9
08/26/15,2,9,542,350,85,33,12,1,46
08/26/15,2,11,8040,355,95,26,19,0,45
08/26/15,2,12,8032,350,119,18,19,0,37
08/26/15,2,13,542,350,87,33,8,1,42
08/26/15,2,14,542,360,67,10,10,3,23
08/26/15,2,18,542,350,88,49,17,1,67
08/26/15,2,19,542,360,59,39,19,0,58
08/26/15,2,20,774,350,74,12,12,1,25
08/26/15,2,26,542,360,93,30,12,0,42
08/26/15,2,27,542,360,85,32,7,0,39
08/26/15,2,28,8032,375,130,13,45,3,61
08/26/15,2,29,737,270,87,11,4,0,15
08/26/15,2,30,7675,270,56,8,6,0,14
08/26/15,3,1,738,305,84,7,47,6,60
08/26/15,3,2,726,315,118,16,10,1,27
08/26/15,3,3,5302,220,61,19,4,0,23
08/26/15,3,4,996,220,63,15,0,0,15
08/26/15,3,5,8030,370,115,20,19,1,40
08/26/15,3,7,7740,345,31,13,8,13,34
08/26/15,3,8,618,350,171,4,1,1,6
08/26/15,3,9,542,350,86,62,12,1,75
08/26/15,3,11,8040,355,103,23,21,1,45
08/26/15,3,12,8032,350,112,23,15,1,39
08/26/15,3,13,542,350,25,4,2,1,7
08/26/15,3,14,542,360,137,21,7,0,28
08/26/15,3,15,542,350,43,20,6,0,26
08/26/15,3,18,542,350,30,7,4,0,11
08/26/15,3,19,542,360,16,5,11,0,16
08/26/15,3,20,774,350,12,6,2,1,9
08/26/15,3,26,542,360,27,7,3,0,10
08/26/15,3,27,542,360,27,13,1,0,14
08/26/15,3,28,8032,375,18,3,10,0,13
08/26/15,3,29,737,270,24,3,1,0,4
08/27/15,1,1,738,305,66,4,41,9,54
08/27/15,1,2,726,315,104,34,10,0,44
08/27/15,1,3,5302,220,73,16,5,0,21
08/27/15,1,4,996,220,67,12,8,0,20
08/27/15,1,5,8030,370,144,5,11,1,17
08/27/15,1,6,3062,370,43,3,5,2,10
08/27/15,1,8,618,350,172,2,6,0,8
08/27/15,1,9,542,350,97,24,22,0,46
08/27/15,1,11,8040,355,84,24,30,4,58
08/27/15,1,12,8032,350,113,10,22,0,32
08/27/15,1,13,542,350,117,46,6,2,54
08/27/15,1,14,542,360,145,6,9,0,15
08/27/15,1,15,542,350,76,36,12,0,48
08/27/15,1,17,747,370,10,0,5,2,7
08/27/15,1,18,542,350,125,20,15,1,36
08/27/15,1,19,542,360,63,26,20,0,46
08/27/15,1,20,774,350,121,9,19,0,28
08/27/15,1,22,542,350,71,50,8,0,58
08/27/15,1,25,715,375,116,4,10,0,14
08/27/15,1,26,542,360,108,33,9,0,42
08/27/15,1,27,542,360,88,36,1,0,37
08/27/15,1,28,8032,375,22,3,5,0,8
08/27/15,1,29,737,270,87,10,2,0,12
08/27/15,1,30,7675,270,69,18,15,0,33
08/27/15,2,1,738,305,68,2,51,11,64
08/27/15,2,2,726,315,99,30,6,1,37
08/27/15,2,3,5302,220,61,19,4,0,23
08/27/15,2,4,996,220,56,13,9,0,22
08/27/15,2,5,8030,370,140,15,9,1,25
08/27/15,2,6,3062,370,125,18,15,3,36
08/27/15,2,8,618,350,158,5,3,0,8
08/27/15,2,9,542,350,96,11,22,2,35
08/27/15,2,11,8040,355,58,28,32,1,61
08/27/15,2,12,8032,350,119,7,20,0,27
08/27/15,2,13,542,350,83,37,3,1,41
08/27/15,2,14,542,360,114,17,9,2,28
08/27/15,2,15,542,350,45,31,3,0,34
08/27/15,2,17,747,370,107,4,14,3,21
08/27/15,2,18,542,350,87,15,17,0,32
08/27/15,2,19,542,360,50,21,20,0,41
08/27/15,2,20,774,350,78,22,13,0,35
08/27/15,2,22,542,350,86,27,8,0,35
08/27/15,2,25,715,375,114,3,13,0,16
08/27/15,2,26,542,360,66,18,9,0,27
08/27/15,2,27,542,360,56,23,7,0,30
08/27/15,2,28,8032,375,64,8,21,1,30
08/27/15,2,29,737,270,72,12,3,0,15
08/27/15,2,30,7675,270,57,21,12,0,33
08/27/15,3,1,738,305,84,9,51,10,70
08/27/15,3,2,726,315,79,20,11,1,32
08/27/15,3,3,5302,220,79,11,5,0,16
08/27/15,3,4,996,220,62,11,6,0,17
08/27/15,3,5,8030,370,123,26,10,11,47
08/27/15,3,6,3062,370,141,22,9,8,39
08/27/15,3,8,618,350,170,3,1,0,4
08/27/15,3,9,542,350,112,25,29,0,54
08/27/15,3,12,8032,350,148,27,16,1,44
08/27/15,3,13,542,350,40,8,4,1,13
08/27/15,3,14,542,360,129,26,17,1,44
08/27/15,3,15,542,350,110,38,13,0,51
08/27/15,3,16,7527,350,19,20,5,1,26
08/27/15,3,17,747,370,23,2,4,1,7
08/27/15,3,18,542,350,36,1,4,2,7
08/27/15,3,19,542,360,25,8,7,0,15
08/27/15,3,20,774,350,36,11,1,1,13
08/27/15,3,22,542,350,39,3,5,0,8
08/27/15,3,25,715,375,46,0,2,0,2
08/27/15,3,26,542,360,33,10,0,0,10
08/27/15,3,27,542,360,19,9,3,0,12
08/27/15,3,28,8032,375,32,7,7,0,14
08/27/15,3,29,737,270,29,4,1,0,5
08/27/15,3,30,7675,270,16,2,1,0,3
08/28/15,1,1,738,305,72,9,42,9,60
08/28/15,1,2,726,315,129,18,7,0,25
08/28/15,1,3,5302,220,72,15,4,0,19
08/28/15,1,4,996,220,71,12,8,0,20
08/28/15,1,5,8030,370,135,1,21,4,26
08/28/15,1,6,3062,370,134,26,13,8,47
08/28/15,1,7,7740,345,3,1,1,0,2
08/28/15,1,8,618,350,170,2,3,0,5
08/28/15,1,9,542,350,131,21,15,0,36
08/28/15,1,11,8040,355,30,7,10,5,22
08/28/15,1,12,8032,350,4,0,3,0,3
08/28/15,1,13,542,350,136,22,7,0,29
08/28/15,1,14,542,360,143,33,9,1,43
08/28/15,1,15,542,350,82,37,9,0,46
08/28/15,1,16,7527,350,100,31,12,1,44
08/28/15,1,17,747,370,175,5,8,1,14
08/28/15,1,18,542,350,130,20,11,0,31
08/28/15,1,19,542,360,70,25,24,0,49
08/28/15,1,20,774,350,109,29,8,0,37
08/28/15,1,22,542,350,95,31,8,0,39
08/28/15,1,25,715,375,131,4,11,0,15
08/28/15,1,26,542,360,82,21,16,0,37
08/28/15,1,27,542,360,70,48,0,0,48
08/28/15,1,28,8032,375,109,13,28,2,43
08/28/15,1,29,737,270,97,5,0,0,5
08/28/15,1,30,7675,270,70,12,11,0,23
08/28/15,2,1,738,305,57,9,33,7,49
08/28/15,2,2,726,315,117,13,11,2,26
08/28/15,2,3,5302,220,70,14,5,6,25
08/28/15,2,4,996,220,50,9,7,1,17
08/28/15,2,5,8030,370,147,2,12,2,16
08/28/15,2,6,3062,370,124,19,9,3,31
08/28/15,2,8,618,350,107,2,4,0,6
08/28/15,2,9,542,350,80,42,10,0,52
08/28/15,2,11,8040,355,80,14,27,0,41
08/28/15,2,12,8032,350,93,4,28,3,35
08/28/15,2,13,542,350,90,34,6,2,42
08/28/15,2,14,542,360,108,15,14,1,30
08/28/15,2,15,542,350,40,18,11,0,29
08/28/15,2,16,7527,350,122,8,10,2,20
08/28/15,2,17,747,370,135,9,15,5,29
08/28/15,2,18,542,350,95,15,18,0,33
08/28/15,2,19,542,360,43,22,18,0,40
08/28/15,2,20,774,350,100,17,13,2,32
08/28/15,2,22,542,350,79,19,6,0,25
08/28/15,2,25,715,375,125,1,10,0,11
08/28/15,2,26,542,360,54,15,15,0,30
08/28/15,2,27,542,360,72,26,3,0,29
08/28/15,2,28,8032,375,68,15,24,0,39
08/28/15,2,29,737,270,87,10,6,0,16
08/28/15,2,30,7675,270,59,9,7,0,16
08/28/15,3,1,738,305,88,10,37,6,53
08/28/15,3,2,726,315,103,24,12,4,40
08/28/15,3,3,5302,220,68,13,4,0,17
08/28/15,3,4,996,220,36,8,6,0,14
08/28/15,3,5,8030,370,149,2,14,2,18
08/28/15,3,6,3062,370,115,31,10,0,41
08/28/15,3,8,618,350,158,5,3,0,8
08/28/15,3,9,542,350,46,60,9,1,70
08/28/15,3,10,8035,370,21,7,3,4,14
08/28/15,3,11,8040,355,78,46,31,1,78
08/28/15,3,12,8032,350,98,18,37,1,56
08/28/15,3,14,542,360,125,17,15,1,33
08/28/15,3,15,542,350,61,28,16,0,44
08/28/15,3,16,7527,350,110,7,5,1,13
08/31/15,1,1,738,305,85,15,35,9,59
08/31/15,1,2,726,315,121,19,10,1,30
08/31/15,1,3,5302,220,77,15,2,0,17
08/31/15,1,5,8030,370,147,1,16,1,18
08/31/15,1,6,3062,370,121,24,13,2,39
08/31/15,1,8,618,350,182,3,2,3,8
08/31/15,1,10,8035,370,137,2,4,0,6
08/31/15,1,11,8040,355,113,12,24,1,37
08/31/15,1,12,8032,350,103,23,33,1,57
08/31/15,1,13,542,350,70,42,5,0,47
08/31/15,1,14,542,360,137,17,12,0,29
08/31/15,1,15,542,350,112,36,15,0,51
08/31/15,1,16,7527,350,107,22,19,0,41
08/31/15,1,17,747,370,181,11,11,0,22
08/31/15,1,18,542,350,118,36,15,0,51
08/31/15,1,19,542,360,25,5,10,0,15
08/31/15,1,20,774,350,130,19,11,2,32
08/31/15,1,21,774,350,57,7,21,0,28
08/31/15,1,22,542,350,114,19,10,0,29
08/31/15,1,24,642,360,93,6,0,7,13
08/31/15,1,25,715,375,158,1,14,0,15
08/31/15,1,26,542,360,72,35,16,0,51
08/31/15,1,27,542,360,94,17,8,0,25
08/31/15,1,28,8032,375,109,13,28,2,43
08/31/15,1,29,737,270,87,12,5,0,17
08/31/15,1,30,7675,270,26,5,4,0,9
08/31/15,2,1,738,305,52,4,56,9,69
08/31/15,2,2,726,315,55,52,14,5,71
08/31/15,2,3,5302,220,68,20,4,0,24
08/31/15,2,5,8030,370,120,1,19,1,21
08/31/15,2,6,3062,370,112,18,18,6,42
08/31/15,2,7,8040,345,28,11,4,5,20
08/31/15,2,8,618,350,164,3,0,2,5
08/31/15,2,9,542,350,60,25,21,18,64
08/31/15,2,10,8035,370,158,3,1,0,4
08/31/15,2,11,8040,355,95,8,26,2,36
08/31/15,2,12,8032,350,93,6,37,1,44
08/31/15,2,13,542,350,54,38,1,0,39
08/31/15,2,14,542,360,101,17,13,1,31
08/31/15,2,15,542,350,64,10,10,0,20
08/31/15,2,16,7527,350,122,10,11,2,23
08/31/15,2,17,747,370,145,9,15,0,24
08/31/15,2,18,542,350,78,17,13,0,30
08/31/15,2,19,542,360,38,12,3,0,15
08/31/15,2,20,774,350,114,12,11,1,24
08/31/15,2,21,774,350,69,21,18,0,39
08/31/15,2,22,542,350,64,27,5,0,32
08/31/15,2,24,642,360,139,8,0,1,9
08/31/15,2,25,715,375,134,1,13,0,14
08/31/15,2,26,542,360,69,33,6,0,39
08/31/15,2,27,542,360,23,22,5,0,27
08/31/15,2,28,8032,375,59,32,23,1,56
08/31/15,2,29,737,270,64,15,5,0,20
08/31/15,2,30,7675,270,67,12,10,0,22
08/31/15,3,1,738,305,87,11,45,1,57
08/31/15,3,2,726,315,87,93,7,0,100
08/31/15,3,3,5302,220,65,0,0,0,0
08/31/15,3,5,8030,370,148,2,16,0,18
08/31/15,3,6,3062,370,144,25,2,5,32
08/31/15,3,7,8040,345,129,25,12,0,37
08/31/15,3,8,618,350,153,7,3,1,11
08/31/15,3,9,542,350,117,28,20,2,50
08/31/15,3,10,8035,370,144,5,2,4,11
08/31/15,3,11,8040,355,105,14,28,2,44
08/31/15,3,12,8032,350,101,20,34,0,54
08/31/15,3,13,542,350,115,27,9,0,36
08/31/15,3,14,542,360,36,5,5,1,11
08/31/15,3,15,542,350,122,23,16,0,39
08/31/15,3,16,7527,350,130,16,15,2,33
08/31/15,3,17,747,370,23,2,4,1,7
08/31/15,3,18,542,350,27,6,6,0,12
08/31/15,3,19,542,360,28,14,1,0,15
08/31/15,3,20,774,350,36,11,1,1,13
08/31/15,3,21,774,350,33,6,1,0,7
08/31/15,3,22,542,350,30,5,5,0,10
08/31/15,3,24,642,360,41,0,0,0,0
08/31/15,3,25,715,375,37,0,5,0,5
08/31/15,3,26,542,360,24,9,0,0,9
08/31/15,3,27,542,360,27,8,0,0,8
08/31/15,3,28,8032,375,33,6,5,0,11
08/31/15,3,30,7675,270,16,0,0,0,0
09/01/15,1,1,738,305,70,10,37,5,52
09/01/15,1,2,726,315,56,15,5,3,23
09/01/15,1,3,5302,220,58,21,5,0,26
09/01/15,1,4,996,220,37,25,5,0,30
09/01/15,1,5,8030,370,144,1,14,1,16
09/01/15,1,6,3062,370,132,23,10,4,37
09/01/15,1,7,8040,345,119,20,10,0,30
09/01/15,1,8,618,350,113,4,0,0,4
09/01/15,1,9,542,350,104,5,23,1,29
09/01/15,1,10,8035,370,147,17,1,0,18
09/01/15,1,11,8040,355,88,10,25,1,36
09/01/15,1,12,8032,350,95,16,30,0,46
09/01/15,1,13,542,350,125,18,12,0,30
09/01/15,1,14,542,360,101,28,14,2,44
09/01/15,1,15,542,350,112,18,13,0,31
09/01/15,1,16,7527,350,131,14,17,2,33
09/01/15,1,17,747,370,106,14,3,1,18
09/01/15,1,18,542,350,121,13,17,0,30
09/01/15,1,19,542,360,79,43,5,0,48
09/01/15,1,20,774,350,74,23,21,0,44
09/01/15,1,21,774,350,99,13,19,0,32
09/01/15,1,22,542,350,107,37,12,0,49
09/01/15,1,24,642,360,160,8,0,1,9
09/01/15,1,25,715,375,131,2,14,0,16
09/01/15,1,26,542,360,97,37,8,0,45
09/01/15,1,27,542,360,82,38,7,0,45
09/01/15,1,28,8032,375,87,16,23,1,40
09/01/15,1,29,737,270,48,12,5,0,17
09/01/15,1,30,7675,270,65,18,20,0,38
09/01/15,2,1,738,305,87,9,30,10,49
09/01/15,2,2,726,315,115,14,13,2,29
09/01/15,2,3,5302,220,7,15,3,0,18
09/01/15,2,4,996,220,28,35,15,0,50
09/01/15,2,5,8030,370,141,2,11,1,14
09/01/15,2,6,3062,370,138,19,6,5,30
09/01/15,2,7,8040,345,123,20,14,1,35
09/01/15,2,9,542,350,111,17,19,1,37
09/01/15,2,10,8035,370,163,4,1,0,5
09/01/15,2,11,8040,355,95,10,36,1,47
09/01/15,2,12,8032,350,104,22,30,1,53
09/01/15,2,13,542,350,121,19,10,0,29
09/01/15,2,14,542,360,126,22,14,0,36
09/01/15,2,15,542,350,85,16,6,0,22
09/01/15,2,16,7527,350,130,12,18,0,30
09/01/15,2,17,747,370,124,19,9,0,28
09/01/15,2,18,542,350,118,15,19,0,34
09/01/15,2,19,542,360,72,19,8,0,27
09/01/15,2,20,774,350,77,21,24,0,45
09/01/15,2,21,774,350,76,6,17,0,23
09/01/15,2,22,542,350,72,15,4,0,19
09/01/15,2,24,642,360,129,9,0,2,11
09/01/15,2,25,715,375,141,1,10,0,11
09/01/15,2,26,542,360,29,15,8,0,23
09/01/15,2,27,542,360,39,16,5,0,21
09/01/15,2,28,8032,375,84,18,29,0,47
09/01/15,2,29,737,270,65,23,5,0,28
09/01/15,2,30,7675,270,63,19,23,0,42
09/01/15,3,1,738,305,81,13,49,3,65
09/01/15,3,2,726,315,126,15,8,2,25
09/01/15,3,3,5302,220,114,17,5,0,22
09/01/15,3,4,996,220,58,21,10,0,31
09/01/15,3,5,8030,370,150,3,11,0,14
09/01/15,3,6,3062,370,120,32,11,8,51
09/01/15,3,7,8040,345,128,18,12,2,32
09/01/15,3,9,542,350,106,10,33,3,46
09/01/15,3,10,8035,370,165,5,0,1,6
09/01/15,3,11,8040,355,103,28,27,4,59
09/01/15,3,12,8032,350,93,38,20,4,62
09/01/15,3,14,542,360,126,40,9,3,52
09/01/15,3,15,542,350,120,19,19,0,38
09/01/15,3,16,7527,350,81,28,8,3,39
09/01/15,3,17,747,370,54,0,1,0,1
09/01/15,3,18,542,350,26,8,4,0,12
09/01/15,3,19,542,360,29,3,3,0,6
09/01/15,3,20,774,350,22,13,4,1,18
09/01/15,3,21,774,350,20,1,9,0,10
09/01/15,3,22,542,350,11,6,2,0,8
09/01/15,3,24,642,360,43,2,0,1,3
09/01/15,3,25,715,375,40,0,2,0,2
09/01/15,3,26,542,360,23,13,2,0,15
09/01/15,3,27,542,360,19,4,0,0,4
09/01/15,3,28,8032,375,30,1,10,2,13
09/01/15,3,29,737,270,19,10,3,0,13
09/01/15,3,30,7675,270,19,8,7,1,16
09/02/15,1,1,738,305,62,12,31,9,52
09/02/15,1,2,726,315,93,16,10,3,29
09/02/15,1,3,5302,220,16,5,0,0,5
09/02/15,1,4,996,220,35,33,12,0,45
09/02/15,1,5,8030,370,138,4,12,2,18
09/02/15,1,6,3062,370,109,8,13,1,22
09/02/15,1,7,8040,345,110,23,11,0,34
09/02/15,1,8,618,350,108,6,1,0,7
09/02/15,1,9,542,350,105,14,24,0,38
09/02/15,1,10,8035,370,160,6,0,0,6
09/02/15,1,11,8040,355,82,14,31,0,45
09/02/15,1,12,8032,350,90,17,28,1,46
09/02/15,1,16,7527,350,17,6,3,0,9
09/02/15,1,17,747,370,157,12,6,0,18
09/02/15,1,18,542,350,132,13,17,0,30
09/02/15,1,19,542,360,81,12,16,0,28
09/02/15,1,20,774,350,90,11,17,1,29
09/02/15,1,21,774,350,103,6,21,0,27
09/02/15,1,22,542,350,87,20,11,0,31
09/02/15,1,23,485,350,64,2,2,0,4
09/02/15,1,24,642,360,136,9,1,0,10
09/02/15,1,25,715,375,165,0,8,0,8
09/02/15,1,26,542,360,90,37,7,0,44
09/02/15,1,27,542,360,73,40,6,0,46
09/02/15,1,28,8032,375,88,8,33,1,42
09/02/15,1,29,737,270,74,15,3,0,18
09/02/15,1,30,7675,270,78,10,11,0,21
09/02/15,2,1,738,305,78,7,40,5,52
09/02/15,2,2,726,315,98,16,13,4,33
09/02/15,2,3,5302,220,79,18,4,0,22
09/02/15,2,4,996,220,61,21,20,0,41
09/02/15,2,5,8030,370,142,6,11,0,17
09/02/15,2,6,3062,370,130,11,18,3,32
09/02/15,2,7,8040,345,90,63,9,3,75
09/02/15,2,8,618,350,152,11,1,0,12
09/02/15,2,9,542,350,107,10,18,1,29
09/02/15,2,10,8035,370,166,3,0,1,4
09/02/15,2,11,8040,355,103,9,32,0,41
09/02/15,2,12,8032,350,96,17,28,0,45
09/02/15,2,14,8030,360,62,35,2,2,39
09/02/15,2,15,542,350,14,8,5,11,24
09/02/15,2,17,747,370,162,6,8,0,14
09/02/15,2,18,542,350,38,4,2,1,7
09/02/15,2,19,542,360,100,22,9,0,31
09/02/15,2,20,774,350,106,20,8,0,28
09/02/15,2,21,774,350,47,4,25,0,29
09/02/15,2,22,542,350,40,29,4,0,33
09/02/15,2,23,485,350,153,8,1,0,9
09/02/15,2,24,642,360,124,11,1,3,15
09/02/15,2,25,715,375,126,1,12,0,13
09/02/15,2,26,542,360,72,24,4,0,28
09/02/15,2,27,542,360,81,26,8,0,34
09/02/15,2,28,8032,375,76,8,27,2,37
09/02/15,2,29,737,270,62,19,5,0,24
09/02/15,2,30,7675,270,82,10,12,0,22
09/02/15,3,1,738,305,68,16,58,7,81
09/02/15,3,2,726,315,132,13,9,1,23
09/02/15,3,3,5302,220,76,17,5,0,22
09/02/15,3,4,996,220,13,6,1,0,7
09/02/15,3,5,8030,370,144,3,19,2,24
09/02/15,3,6,3062,370,137,15,16,6,37
09/02/15,3,7,8040,345,92,61,10,9,80
09/02/15,3,9,542,350,129,11,22,7,40
09/02/15,3,10,8035,370,167,2,0,0,2
09/02/15,3,11,8040,355,115,14,27,4,45
09/02/15,3,12,8032,350,109,33,27,1,61
09/02/15,3,14,8030,360,30,13,2,1,16
09/02/15,3,15,542,350,115,14,27,4,45
09/02/15,3,16,7527,350,30,13,2,1,16
09/02/15,3,17,747,370,148,1,1,1,3
09/02/15,3,19,542,360,32,5,0,0,5
09/02/15,3,20,774,350,35,3,6,1,10
09/02/15,3,21,774,350,21,1,8,0,9
09/02/15,3,22,542,350,32,7,1,0,8
09/02/15,3,23,485,350,62,0,1,0,1
09/02/15,3,24,642,360,34,3,0,2,5
09/02/15,3,25,715,375,59,0,5,0,5
09/02/15,3,26,542,360,21,7,2,0,9
09/02/15,3,27,542,360,22,14,1,0,15
09/02/15,3,28,8032,375,25,2,9,0,11
09/02/15,3,29,737,270,18,6,1,0,7
09/02/15,3,30,7675,270,23,4,2,1,7
09/03/15,1,1,738,305,85,17,53,2,72
09/03/15,1,2,726,315,29,9,0,0,9
09/03/15,1,3,5302,220,51,25,4,0,29
09/03/15,1,4,996,220,6,2,2,0,4
09/03/15,1,5,8030,370,156,6,10,0,16
09/03/15,1,6,3062,370,31,1,2,1,4
09/03/15,1,7,8040,345,130,21,8,0,29
09/03/15,1,9,542,350,14,2,6,2,10
09/03/15,1,10,8035,370,150,5,1,1,7
09/03/15,1,11,8040,355,108,22,33,2,57
09/03/15,1,12,8032,350,107,21,22,0,43
09/03/15,1,13,542,350,103,28,9,0,37
09/03/15,1,14,8030,360,159,4,3,1,8
09/03/15,1,15,542,350,116,14,23,0,37
09/03/15,1,17,747,370,168,6,8,1,15
09/03/15,1,18,542,350,23,3,0,1,4
09/03/15,1,19,542,360,111,24,6,0,30
09/03/15,1,20,774,350,114,8,15,0,23
09/03/15,1,21,774,350,117,5,25,0,30
09/03/15,1,22,542,350,122,15,12,0,27
09/03/15,1,23,485,350,184,0,5,0,5
09/03/15,1,24,642,360,147,5,1,0,6
09/03/15,1,25,715,375,159,3,10,0,13
09/03/15,1,26,542,360,33,9,2,0,11
09/03/15,1,27,542,360,98,23,4,0,27
09/03/15,1,28,8032,375,94,14,23,1,38
09/03/15,1,29,737,270,61,23,12,0,35
09/03/15,1,30,7675,270,105,8,3,0,11
09/03/15,2,1,738,305,83,13,46,1,60
09/03/15,2,2,726,315,67,5,9,2,16
09/03/15,2,3,5302,220,68,21,5,0,26
09/03/15,2,4,996,220,57,21,18,0,39
09/03/15,2,5,8030,370,152,5,12,2,19
09/03/15,2,6,3062,370,93,7,11,2,20
09/03/15,2,7,8040,345,115,14,9,1,24
09/03/15,2,9,542,350,4,13,3,7,23
09/03/15,2,10,8035,370,144,5,1,2,8
09/03/15,2,11,8040,355,102,16,29,0,45
09/03/15,2,12,8032,350,127,3,37,0,40
09/03/15,2,13,542,350,112,27,5,1,33
09/03/15,2,14,8030,360,166,0,4,2,6
09/03/15,2,15,542,350,78,9,16,0,25
09/03/15,2,17,747,370,131,5,10,3,18
09/03/15,2,18,542,350,74,27,4,0,31
09/03/15,2,19,542,360,78,14,7,0,21
09/03/15,2,20,774,350,100,12,7,1,20
09/03/15,2,21,774,350,81,4,18,0,22
09/03/15,2,22,542,350,86,16,11,0,27
09/03/15,2,23,485,350,160,1,4,0,5
09/03/15,2,24,642,360,153,7,0,0,7
09/03/15,2,25,715,375,138,2,9,0,11
09/03/15,2,26,542,360,17,25,4,0,29
09/03/15,2,27,542,360,47,19,5,0,24
09/03/15,2,28,8032,375,79,12,13,1,26
09/03/15,2,29,737,270,43,21,15,0,36
09/03/15,2,30,7675,270,78,15,7,0,22
09/03/15,3,1,738,305,89,63,51,2,116
09/03/15,3,2,726,315,108,37,10,4,51
09/03/15,3,3,5302,220,99,17,4,0,21
09/03/15,3,4,996,220,56,20,7,0,27
09/03/15,3,5,8030,370,155,4,13,0,17
09/03/15,3,7,8040,345,129,23,12,1,36
09/03/15,3,9,542,350,97,25,16,9,50
09/03/15,3,10,8035,370,158,10,2,2,14
09/03/15,3,11,8040,355,111,16,40,3,59
09/03/15,3,12,8032,350,89,5,28,3,36
09/03/15,3,13,542,350,34,8,1,0,9
09/03/15,3,14,8030,360,16,0,4,2,6
09/03/15,3,15,542,350,124,15,20,0,35
09/03/15,3,17,747,370,52,0,5,1,6
09/03/15,3,18,542,350,41,6,4,0,10
09/03/15,3,19,542,360,37,5,6,0,11
09/03/15,3,21,774,350,36,2,5,0,7
09/03/15,3,22,542,350,35,6,3,0,9
09/03/15,3,23,485,350,54,0,0,0,0
09/03/15,3,24,642,360,87,29,0,2,31
09/03/15,3,25,715,375,59,1,3,0,4
09/03/15,3,26,542,360,30,18,4,0,22
09/03/15,3,27,542,360,29,13,1,0,14
09/03/15,3,28,8032,375,32,6,11,4,21
09/03/15,3,29,737,270,23,10,4,0,14
09/03/15,3,30,7675,270,33,7,1,0,8
09/04/15,1,1,738,305,94,6,56,3,65
09/04/15,1,2,726,315,110,7,16,5,28
09/04/15,1,3,5302,220,77,21,8,0,29
09/04/15,1,4,996,220,48,23,18,0,41
09/04/15,1,5,8030,370,151,2,12,2,16
09/04/15,1,6,3062,370,58,6,6,3,15
09/04/15,1,7,8040,345,110,18,13,1,32
09/04/15,1,9,542,350,86,37,8,6,51
09/04/15,1,11,8040,355,105,18,27,0,45
09/04/15,1,13,542,350,109,43,1,2,46
09/04/15,1,14,8030,360,148,3,5,0,8
09/04/15,1,15,542,350,115,13,13,0,26
09/04/15,1,17,747,370,141,10,10,1,21
09/04/15,1,18,542,350,120,36,6,0,42
09/04/15,1,19,542,360,65,28,10,0,38
09/04/15,1,21,774,350,72,1,32,0,33
09/04/15,1,22,542,350,96,22,8,0,30
09/04/15,1,23,485,350,161,0,3,0,3
09/04/15,1,24,642,360,119,13,5,0,18
09/04/15,1,25,715,375,155,1,12,0,13
09/04/15,1,26,542,360,89,29,9,0,38
09/04/15,1,27,542,360,98,43,3,0,46
09/04/15,1,28,8032,375,91,18,21,0,39
09/04/15,1,29,737,270,63,18,9,0,27
09/04/15,2,1,738,305,74,12,37,3,52
09/04/15,2,2,726,315,121,22,6,2,30
09/04/15,2,3,5302,220,73,20,7,1,28
09/04/15,2,4,996,220,51,23,4,0,27
09/04/15,2,5,8030,370,139,1,13,1,15
09/04/15,2,6,3062,370,141,14,6,69,89
09/04/15,2,7,8040,345,18,3,4,6,13
09/04/15,2,9,542,350,93,36,12,0,48
09/04/15,2,11,8040,355,96,21,32,1,54
09/04/15,2,12,8032,350,128,9,19,6,34
09/04/15,2,13,542,350,86,33,4,0,37
09/04/15,2,14,8030,360,157,3,4,3,10
09/04/15,2,29,737,270,99,20,10,0,30
09/04/15,2,30,7675,270,90,12,2,0,14
09/04/15,3,1,738,305,65,16,38,6,60
09/04/15,3,2,726,315,108,26,14,1,41
09/04/15,3,3,5302,220,58,19,8,0,27
09/04/15,3,4,996,220,15,20,6,0,26
09/04/15,3,29,737,270,47,15,22,4,41
09/04/15,3,30,7675,270,36,8,4,0,12
09/08/15,1,1,738,305,75,12,51,3,66
09/08/15,1,3,5302,220,83,15,2,0,17
09/08/15,1,4,996,220,63,21,15,0,36
09/08/15,1,6,3062,370,54,4,5,2,11
09/08/15,1,7,8040,345,51,9,7,0,16
09/08/15,1,9,542,350,38,12,5,2,19
09/08/15,1,11,8040,355,39,7,10,2,19
09/08/15,1,12,8032,350,55,4,19,2,25
09/08/15,1,13,542,350,34,5,3,1,9
09/08/15,1,14,8030,360,45,5,2,1,8
09/08/15,1,15,542,350,46,6,10,0,16
09/08/15,1,17,747,370,51,1,6,3,10
09/08/15,1,19,542,360,41,20,3,0,23
09/08/15,1,20,774,350,2,4,2,0,6
09/08/15,1,21,774,350,55,5,13,0,18
09/08/15,1,22,542,350,54,10,3,0,13
09/08/15,1,23,485,350,79,0,5,0,5
09/08/15,1,24,642,360,54,2,2,1,5
09/08/15,1,25,715,375,91,0,3,0,3
09/08/15,1,26,542,360,106,22,16,0,38
09/08/15,1,27,542,360,99,43,10,0,53
09/08/15,1,28,8032,375,47,8,6,2,16
09/08/15,1,29,737,270,82,12,5,0,17
09/08/15,1,30,7675,270,46,21,18,0,39
09/08/15,2,1,738,305,79,5,48,11,64
09/08/15,2,2,726,315,15,4,1,3,8
09/08/15,2,3,5302,220,61,25,4,0,29
09/08/15,2,4,996,220,53,24,13,0,37
09/08/15,2,6,3062,370,140,17,8,3,28
09/08/15,2,7,8040,345,132,10,11,0,21
09/08/15,2,9,542,350,109,27,8,1,36
09/08/15,2,11,8040,355,101,15,22,0,37
09/08/15,2,12,8032,350,140,7,19,1,27
09/08/15,2,13,542,350,84,26,2,1,29
09/08/15,2,14,8030,360,163,2,5,1,8
09/08/15,2,15,542,350,88,14,8,0,22
09/08/15,2,17,747,370,124,12,11,1,24
09/08/15,2,19,542,360,67,29,6,0,35
09/08/15,2,20,774,350,28,25,2,5,32
09/08/15,2,21,774,350,66,8,22,0,30
09/08/15,2,22,542,350,89,11,11,0,22
09/08/15,2,23,485,350,160,1,5,0,6
09/08/15,2,24,642,360,126,6,6,1,13
09/08/15,2,25,715,375,136,1,11,0,12
09/08/15,2,27,542,360,79,26,4,0,30
09/08/15,2,28,8032,375,70,12,18,0,30
09/08/15,2,29,737,270,55,12,10,0,22
09/08/15,2,30,7675,270,53,18,21,0,39
09/08/15,3,1,738,305,83,7,56,2,65
09/08/15,3,2,726,315,85,20,6,2,28
09/08/15,3,3,5302,220,78,21,4,1,26
09/08/15,3,6,3062,370,138,18,17,8,43
09/08/15,3,7,8040,345,134,11,14,2,27
09/08/15,3,9,542,350,118,41,16,1,58
09/08/15,3,11,8040,355,120,24,29,2,55
09/08/15,3,12,8032,350,143,7,14,1,22
09/08/15,3,13,542,350,110,40,8,0,48
09/08/15,3,14,8030,360,156,3,9,1,13
09/08/15,3,15,542,350,33,9,4,0,13
09/08/15,3,17,747,370,63,1,3,1,5
09/08/15,3,19,542,360,28,2,3,0,5
09/08/15,3,20,774,350,32,27,2,6,35
09/08/15,3,21,774,350,31,0,6,0,6
09/08/15,3,23,485,350,36,1,1,0,2
09/08/15,3,25,715,375,33,0,3,0,3
09/08/15,3,26,542,360,18,10,1,0,11
09/08/15,3,27,542,360,18,7,2,0,9
09/08/15,3,28,8032,375,34,5,6,6,17
09/08/15,3,29,737,270,28,11,5,1,17
09/08/15,3,30,7675,270,36,10,6,0,16
09/09/15,1,1,738,305,77,8,43,2,53
09/09/15,1,2,726,315,126,17,5,2,24
09/09/15,1,3,5302,220,74,22,10,0,32
09/09/15,1,4,996,220,5,2,2,7,11
09/09/15,1,6,3062,370,122,28,14,1,43
09/09/15,1,7,8040,345,136,15,11,1,27
09/09/15,1,9,542,350,122,28,14,1,43
09/09/15,1,11,8040,355,95,23,24,2,49
09/09/15,1,12,8032,350,129,12,18,0,30
09/09/15,1,13,542,350,111,31,4,3,38
09/09/15,1,14,8030,360,163,0,4,0,4
09/09/15,1,15,542,350,130,16,18,0,34
09/09/15,1,16,8040,350,47,28,11,1,40
09/09/15,1,17,747,370,164,10,6,1,17
09/09/15,1,18,542,350,66,31,3,1,35
09/09/15,1,19,542,360,116,18,13,0,31
09/09/15,1,20,542,350,85,26,13,1,40
09/09/15,1,21,774,350,109,6,30,0,36
09/09/15,1,23,485,350,182,0,2,0,2
09/09/15,1,25,715,375,176,2,6,0,8
09/09/15,1,26,542,360,87,31,4,0,35
09/09/15,1,27,542,360,85,40,5,0,45
09/09/15,1,28,8032,375,96,17,22,0,39
09/09/15,1,29,737,270,87,23,4,0,27
09/09/15,1,30,7675,270,59,33,10,0,43
09/09/15,2,1,738,305,46,6,51,15,72
09/09/15,2,2,726,315,120,19,4,1,24
09/09/15,2,3,5302,220,11,28,9,0,37
09/09/15,2,4,996,220,56,25,15,0,40
09/09/15,2,6,3062,370,63,28,17,0,45
09/09/15,2,7,8040,345,113,16,8,0,24
09/09/15,2,9,542,350,63,28,17,0,45
09/09/15,2,11,8040,355,34,7,11,3,21
09/09/15,2,12,8032,350,133,9,15,2,26
09/09/15,2,13,542,350,111,35,3,2,40
09/09/15,2,14,8030,360,141,2,1,2,5
09/09/15,2,15,542,350,64,8,15,0,23
09/09/15,2,16,8040,350,47,48,5,0,53
09/09/15,2,17,747,370,157,14,11,2,27
09/09/15,2,18,542,350,120,30,7,2,39
09/09/15,2,19,542,360,88,23,17,0,40
09/09/15,2,20,542,350,114,22,10,2,34
09/09/15,2,21,774,350,26,0,7,0,7
09/09/15,2,22,542,350,112,20,2,0,22
09/09/15,2,23,485,350,139,1,7,0,8
09/09/15,2,25,715,375,151,1,9,0,10
09/09/15,2,26,542,360,88,27,6,0,33
09/09/15,2,27,542,360,3,1,0,0,1
09/09/15,2,28,8032,375,117,16,21,0,37
09/09/15,2,29,737,270,65,22,12,0,34
09/09/15,2,30,7675,270,44,28,15,0,43
09/09/15,3,1,738,305,79,12,39,7,58
09/09/15,3,2,726,315,127,23,10,1,34
09/09/15,3,3,5302,220,75,0,0,0,0
09/09/15,3,4,996,220,46,0,0,0,0
09/09/15,3,6,3062,370,110,36,9,5,50
09/09/15,3,7,8040,345,120,14,18,1,33
09/09/15,3,9,542,350,110,36,8,5,49
09/09/15,3,12,8032,350,145,9,10,1,20
09/09/15,3,13,542,350,120,28,5,0,33
09/09/15,3,14,8030,360,163,0,4,0,4
09/09/15,3,15,542,350,33,9,4,0,13
09/09/15,3,16,8040,350,164,31,8,1,40
09/09/15,3,17,747,370,47,2,2,1,5
09/09/15,3,18,542,350,120,2,2,1,5
09/09/15,3,19,542,360,33,9,3,0,12
09/09/15,3,20,542,350,38,15,2,0,17
09/09/15,3,22,542,350,47,2,1,0,3
09/09/15,3,23,485,350,50,0,3,0,3
09/09/15,3,25,715,375,49,0,4,0,4
09/09/15,3,26,542,360,35,6,3,0,9
09/09/15,3,27,542,360,26,14,2,0,16
09/09/15,3,28,8032,375,44,1,4,1,6
09/09/15,3,29,737,270,65,20,8,0,28
09/09/15,3,30,7675,270,62,18,7,1,26
09/10/15,1,1,738,305,48,12,23,4,39
09/10/15,1,2,726,315,119,22,5,1,28
09/10/15,1,3,5302,220,78,15,5,0,20
09/10/15,1,4,996,220,63,28,15,0,43
09/10/15,1,6,3062,370,131,11,8,7,26
09/10/15,1,7,8040,345,106,22,18,6,46
09/10/15,1,9,542,350,91,50,8,1,59
09/10/15,1,12,8032,350,134,19,11,1,31
09/10/15,1,13,542,350,107,32,2,0,34
09/10/15,1,14,8030,360,159,0,7,2,9
09/10/15,1,15,542,350,93,16,23,0,39
09/10/15,1,16,8040,350,118,28,12,0,40
09/10/15,1,17,747,370,170,6,6,0,12
09/10/15,1,18,542,350,117,26,10,0,36
09/10/15,1,19,542,360,90,14,13,0,27
09/10/15,1,20,542,350,87,28,16,1,45
09/10/15,1,22,542,350,126,19,4,0,23
09/10/15,1,23,497,350,173,3,5,0,8
09/10/15,1,25,715,375,173,1,6,0,7
09/10/15,1,26,542,360,104,18,9,0,27
09/10/15,1,27,542,360,111,19,5,0,24
09/10/15,1,28,8032,375,94,4,20,3,27
09/10/15,1,29,737,270,81,12,5,0,17
09/10/15,1,30,7675,270,50,29,12,0,41
09/10/15,2,1,738,305,83,12,46,5,63
09/10/15,2,2,726,315,126,22,3,5,30
09/10/15,2,3,5302,220,76,17,4,0,21
09/10/15,2,4,996,220,58,24,17,0,41
09/10/15,2,6,3062,370,43,4,8,0,12
09/10/15,2,7,8040,345,122,16,16,1,33
09/10/15,2,9,542,350,124,27,12,2,41
09/10/15,2,12,8032,350,124,13,12,1,26
09/10/15,2,13,542,350,79,33,5,3,41
09/10/15,2,14,8030,360,160,10,3,0,13
09/10/15,2,15,542,350,105,14,13,0,27
09/10/15,2,16,8040,350,120,29,18,1,48
09/10/15,2,17,747,370,148,6,20,0,26
09/10/15,2,18,542,350,113,17,8,0,25
09/10/15,2,19,542,360,100,30,2,0,32
09/10/15,2,20,542,350,97,18,13,0,31
09/10/15,2,21,641,350,44,14,8,0,22
09/10/15,2,22,542,350,112,13,2,0,15
09/10/15,2,23,497,350,91,0,6,0,6
09/10/15,2,25,715,375,148,0,5,0,5
09/10/15,2,26,542,360,85,24,6,0,30
09/10/15,2,27,542,360,98,20,5,0,25
09/10/15,2,29,737,270,74,15,9,0,24
09/10/15,2,30,7675,270,66,26,18,0,44
09/10/15,3,1,738,305,95,23,37,3,63
09/10/15,3,2,726,315,120,30,3,2,35
09/10/15,3,3,5302,220,76,16,5,0,21
09/10/15,3,4,996,220,52,25,16,1,42
09/10/15,3,5,8030,370,9,0,2,1,3
09/10/15,3,6,3062,370,103,12,15,6,33
09/10/15,3,7,8040,345,131,8,25,3,36
09/10/15,3,9,542,350,111,44,18,1,63
09/10/15,3,10,8035,370,128,23,2,9,34
09/10/15,3,12,8032,350,145,19,5,0,24
09/10/15,3,13,542,350,117,28,6,0,34
09/10/15,3,14,8030,360,166,3,3,2,8
09/10/15,3,15,542,350,36,3,7,0,10
09/10/15,3,16,8040,350,120,16,19,1,36
09/10/15,3,17,747,370,57,0,1,1,2
09/10/15,3,18,542,350,42,6,4,1,11
09/10/15,3,19,542,360,36,12,5,0,17
09/10/15,3,20,542,350,49,3,3,1,7
09/10/15,3,21,641,350,34,0,11,0,11
09/10/15,3,22,542,350,44,3,1,0,4
09/10/15,3,25,715,375,76,2,3,0,5
09/10/15,3,26,542,360,36,0,7,0,7
09/10/15,3,27,542,360,45,6,1,0,7
09/10/15,3,29,737,270,74,14,8,0,22
09/10/15,3,30,7675,270,69,25,18,0,43
09/11/15,1,1,738,305,102,9,47,1,57
09/11/15,1,2,726,315,99,17,3,12,32
09/11/15,1,3,5302,220,79,21,4,0,25
09/11/15,1,4,996,220,64,18,15,0,33
09/11/15,1,5,8030,370,116,4,20,1,25
09/11/15,1,6,3062,370,146,20,8,4,32
09/11/15,1,7,8040,345,127,16,19,0,35
09/11/15,1,9,542,350,129,27,9,2,38
09/11/15,1,10,8035,370,165,3,0,1,4
09/11/15,1,12,8032,350,96,4,5,1,10
09/11/15,1,13,542,350,110,20,5,2,27
09/11/15,1,14,8030,360,158,1,5,2,8
09/11/15,1,15,542,350,50,5,8,0,13
09/11/15,1,16,8040,350,114,27,9,3,39
09/11/15,1,17,747,370,172,7,9,0,16
09/11/15,1,18,542,350,111,16,14,4,34
09/11/15,1,19,542,360,129,27,6,0,33
09/11/15,1,20,542,350,123,9,11,0,20
09/11/15,1,21,641,350,103,6,13,0,19
09/11/15,1,22,542,350,162,18,1,0,19
09/11/15,1,25,715,375,125,3,9,0,12
09/11/15,1,26,542,360,136,28,14,0,42
09/11/15,1,27,542,360,24,1,16,4,21
09/11/15,1,28,8032,375,138,13,5,0,18
09/11/15,1,29,737,270,74,18,9,0,27
09/11/15,1,30,7675,270,68,15,14,0,29
09/11/15,2,1,738,305,63,6,36,12,54
09/11/15,2,2,726,315,95,18,5,2,25
09/11/15,2,3,5302,220,59,28,5,0,33
09/11/15,2,4,996,220,38,22,2,6,30
09/11/15,2,5,8030,370,120,1,12,0,13
09/11/15,2,6,3062,370,114,16,12,6,34
09/11/15,2,7,8040,345,110,14,13,0,27
09/11/15,2,8,7740,350,46,11,4,11,26
09/11/15,2,9,542,350,81,30,4,1,35
09/11/15,2,10,8035,370,149,4,1,0,5
09/11/15,2,12,8032,350,45,1,6,2,9
09/11/15,2,13,542,350,55,35,5,0,40
09/11/15,2,14,8030,360,125,3,10,1,14
09/11/15,2,16,8040,350,119,9,14,0,23
09/11/15,2,17,747,370,148,3,16,0,19
09/11/15,2,18,542,350,107,18,7,1,26
09/11/15,2,19,542,360,99,26,6,0,32
09/11/15,2,20,542,350,95,23,10,0,33
09/11/15,2,21,641,350,100,2,18,0,20
09/11/15,2,22,542,350,87,23,3,0,26
09/11/15,2,23,497,350,33,23,1,0,24
09/11/15,2,24,1005,360,3,3,0,10,13
09/11/15,2,25,715,375,170,0,7,0,7
09/11/15,2,26,542,360,69,22,4,0,26
09/11/15,2,27,542,360,72,9,10,0,19
09/11/15,2,28,8032,375,67,11,28,1,40
09/11/15,2,29,737,270,57,21,12,0,33
09/11/15,2,30,7675,270,51,23,15,0,38
09/11/15,3,1,738,305,95,10,43,3,56
09/11/15,3,2,726,315,108,24,6,10,40
09/11/15,3,3,5302,220,12,6,4,0,10
09/11/15,3,4,996,220,36,19,16,0,35
09/11/15,3,5,8030,370,150,3,12,2,17
09/11/15,3,6,3062,370,123,21,8,26,55
09/11/15,3,7,8040,345,126,20,12,3,35
09/11/15,3,9,542,350,120,41,9,1,51
09/11/15,3,10,8035,370,160,2,1,4,7
09/11/15,3,13,542,350,91,33,3,4,40
09/11/15,3,14,8030,360,158,1,6,1,8
09/11/15,3,16,8040,350,115,13,17,2,32
09/11/15,3,29,737,270,49,19,10,0,29
09/11/15,3,30,7675,270,44,21,14,0,35
09/14/15,1,1,738,305,92,18,43,3,64
09/14/15,1,2,726,315,144,14,1,4,19
09/14/15,1,3,5302,220,14,5,1,0,6
09/14/15,1,4,996,220,61,25,12,0,37
09/14/15,1,5,8030,370,150,5,15,3,23
09/14/15,1,6,3062,370,139,26,8,5,39
09/14/15,1,7,8040,345,124,25,7,5,37
09/14/15,1,9,542,350,112,35,9,2,46
09/14/15,1,10,8035,370,164,3,0,1,4
09/14/15,1,11,8040,355,119,0,0,0,0
09/14/15,1,12,8032,350,50,3,24,1,28
09/14/15,1,13,542,350,19,12,4,1,17
09/14/15,1,14,542,360,151,1,5,1,7
09/14/15,1,15,542,350,61,12,8,0,20
09/14/15,1,16,7527,350,120,20,16,0,36
09/14/15,1,17,747,370,65,2,2,1,5
09/14/15,1,19,542,360,105,37,7,0,44
09/14/15,1,20,774,350,125,14,9,3,26
09/14/15,1,21,774,350,100,2,14,0,16
09/14/15,1,22,542,350,123,24,6,0,30
09/14/15,1,23,782,350,86,38,1,0,39
09/14/15,1,24,642,360,16,1,5,0,6
09/14/15,1,25,715,375,166,1,10,0,11
09/14/15,1,26,542,360,126,23,14,0,37
09/14/15,1,27,542,360,137,14,11,0,25
09/14/15,1,28,8032,375,77,37,5,7,49
09/14/15,1,29,737,270,40,12,5,0,17
09/14/15,1,30,7675,270,50,28,10,0,38
09/14/15,2,1,738,305,68,4,44,1,49
09/14/15,2,2,726,315,125,18,0,1,19
09/14/15,2,3,5302,220,72,21,5,0,26
09/14/15,2,4,996,220,42,12,8,0,20
09/14/15,2,5,8030,370,129,0,8,1,9
09/14/15,2,6,3062,370,130,17,9,5,31
09/14/15,2,7,8040,345,133,16,11,2,29
09/14/15,2,8,618,350,11,4,3,2,9
09/14/15,2,9,542,350,57,22,12,11,45
09/14/15,2,10,8035,370,161,4,2,1,7
09/14/15,2,11,8040,355,18,17,22,6,45
09/14/15,2,12,8032,350,78,37,43,0,80
09/14/15,2,14,542,360,160,0,2,0,2
09/14/15,2,15,542,350,108,11,8,0,19
09/14/15,2,16,7527,350,121,11,17,0,28
09/14/15,2,18,542,350,96,25,13,0,38
09/14/15,2,19,542,360,8,2,2,0,4
09/14/15,2,20,774,350,119,5,11,2,18
09/14/15,2,21,774,350,106,4,13,0,17
09/14/15,2,22,542,350,38,3,2,0,5
09/14/15,2,23,782,350,92,24,0,0,24
09/14/15,2,25,715,159,159,2,6,0,8
09/14/15,2,26,542,360,83,15,9,0,24
09/14/15,2,27,542,360,97,12,13,0,25
09/14/15,2,28,8032,375,76,4,26,0,30
09/14/15,2,29,737,270,72,18,5,0,23
09/14/15,2,30,7675,270,56,24,12,0,36
09/14/15,3,1,738,305,94,8,37,3,48
09/14/15,3,2,726,315,146,15,1,1,17
09/14/15,3,3,5302,220,79,0,0,0,0
09/14/15,3,5,8030,370,161,3,6,0,9
09/14/15,3,6,3062,370,114,22,8,5,35
09/14/15,3,7,8040,345,139,14,12,3,29
09/14/15,3,8,618,350,24,3,3,2,8
09/14/15,3,10,8035,370,164,0,0,0,0
09/14/15,3,11,8040,355,101,32,30,6,68
09/14/15,3,12,8032,350,88,22,59,1,82
09/14/15,3,13,542,350,96,32,3,4,39
09/14/15,3,14,542,360,120,0,0,2,2
09/14/15,3,15,542,350,32,1,4,0,5
09/14/15,3,16,7527,350,130,16,17,2,35
09/14/15,3,18,542,350,34,2,4,6,12
09/14/15,3,20,774,350,38,3,5,1,9
09/14/15,3,21,774,350,31,1,5,0,6
09/14/15,3,23,782,350,30,17,0,0,17
09/14/15,3,25,715,375,57,1,1,0,2
09/14/15,3,26,542,360,25,10,3,0,13
09/14/15,3,27,542,360,35,2,3,0,5
09/14/15,3,28,8032,375,32,1,11,1,13
09/14/15,3,29,737,270,77,0,0,0,0
09/14/15,3,30,7675,270,50,0,0,0,0
09/15/15,1,1,738,305,93,13,35,2,50
09/15/15,1,2,726,315,114,12,11,3,26
09/15/15,1,3,5302,220,76,19,9,0,28
09/15/15,1,4,996,220,25,5,3,0,8
09/15/15,1,5,8030,370,119,7,15,7,29
09/15/15,1,7,8040,345,126,11,12,1,24
09/15/15,1,10,8035,370,165,2,1,1,4
09/15/15,1,11,8040,355,85,20,41,7,68
09/15/15,1,12,8032,350,91,4,47,2,53
09/15/15,1,13,542,350,87,48,3,0,51
09/15/15,1,15,542,350,112,20,13,0,33
09/15/15,1,16,7527,350,117,28,22,2,52
09/15/15,1,17,747,370,43,0,3,6,9
09/15/15,1,20,774,350,129,15,80,0,95
09/15/15,1,21,774,350,92,9,9,0,18
09/15/15,1,23,485,350,112,26,1,0,27
09/15/15,1,25,715,375,252,0,22,0,22
09/15/15,1,26,542,360,107,28,6,0,34
09/15/15,1,27,542,360,112,27,7,0,34
09/15/15,1,28,8032,375,72,13,31,2,46
09/15/15,1,29,737,270,80,15,5,0,20
09/15/15,1,30,7675,270,78,12,8,0,20
09/15/15,2,1,738,305,76,7,39,1,47
09/15/15,2,2,726,315,120,12,7,2,21
09/15/15,2,3,5302,220,58,21,7,0,28
09/15/15,2,4,996,220,42,18,17,0,35
09/15/15,2,5,8030,370,133,4,11,2,17
09/15/15,2,6,3062,370,59,4,6,3,13
09/15/15,2,10,8035,370,165,1,0,1,2
09/15/15,2,11,8040,355,73,12,33,0,45
09/15/15,2,12,8032,350,94,4,46,7,57
09/15/15,2,13,542,350,86,18,8,0,26
09/15/15,2,14,8030,360,57,0,6,7,13
09/15/15,2,15,542,350,73,34,6,0,40
09/15/15,2,16,7527,350,137,16,8,1,25
09/15/15,2,17,747,370,141,1,5,0,6
09/15/15,2,19,542,360,95,10,12,0,22
09/15/15,2,20,774,350,112,26,9,2,37
09/15/15,2,21,774,350,97,10,9,0,19
09/15/15,2,22,542,350,64,36,11,0,47
09/15/15,2,23,485,350,133,18,0,0,18
09/15/15,2,25,715,375,157,2,7,0,9
09/15/15,2,26,542,360,80,20,6,0,26
09/15/15,2,27,542,360,85,25,4,0,29
09/15/15,2,28,8032,375,52,5,35,0,40
09/15/15,2,29,737,270,43,18,5,0,23
09/15/15,2,30,7675,270,23,6,9,0,15
09/15/15,3,1,738,305,33,8,12,1,21
09/15/15,3,2,726,315,135,13,1,2,16
09/15/15,3,3,5302,220,76,23,8,0,31
09/15/15,3,4,996,220,60,21,3,1,25
09/15/15,3,5,8030,370,156,3,12,2,17
09/15/15,3,6,3062,370,130,0,0,0,0
09/15/15,3,9,542,350,71,18,12,15,45
09/15/15,3,10,8035,370,164,3,0,0,3
09/15/15,3,11,8040,355,114,23,17,1,41
09/15/15,3,12,8032,350,88,12,53,3,68
09/15/15,3,13,542,350,110,23,6,1,30
09/15/15,3,14,8030,360,158,2,8,2,12
09/15/15,3,15,542,350,26,0,5,0,5
09/15/15,3,16,7527,350,123,19,19,1,39
09/15/15,3,17,747,370,48,0,2,1,3
09/15/15,3,18,542,350,14,3,2,3,8
09/15/15,3,19,542,360,30,3,3,0,6
09/15/15,3,20,774,350,30,3,6,1,10
09/15/15,3,22,542,350,23,7,4,0,11
09/15/15,3,23,485,350,40,5,2,0,7
09/15/15,3,25,715,375,37,1,1,0,2
09/15/15,3,26,542,360,27,4,60,0,64
09/15/15,3,27,542,360,36,2,1,0,3
09/15/15,3,28,8032,375,15,2,11,2,15
09/15/15,3,29,737,270,43,17,6,0,23
09/15/15,3,30,7675,270,35,8,7,8,23
09/16/15,1,1,738,305,20,4,9,3,16
09/16/15,1,2,726,315,140,11,3,1,15
09/16/15,1,3,5302,220,93,12,4,0,16
09/16/15,1,4,996,220,79,19,17,0,36
09/16/15,1,5,8030,370,144,8,8,0,16
09/16/15,1,6,3062,370,131,24,11,3,38
09/16/15,1,9,542,350,112,49,9,1,59
09/16/15,1,10,8035,370,168,1,1,2,4
09/16/15,1,11,8040,355,21,6,8,1,15
09/16/15,1,12,8032,350,109,13,42,4,59
09/16/15,1,13,542,350,93,17,12,1,30
09/16/15,1,14,8030,360,161,2,2,1,5
09/16/15,1,15,542,350,143,5,12,0,17
09/16/15,1,16,8040,350,139,14,14,1,29
09/16/15,1,17,747,370,180,1,6,0,7
09/16/15,1,18,542,350,120,15,8,0,23
09/16/15,1,19,542,360,106,6,11,0,17
09/16/15,1,20,542,350,98,15,6,0,21
09/16/15,1,21,774,350,79,3,9,0,12
09/16/15,1,22,542,350,5,7,16,0,23
09/16/15,1,23,485,350,154,5,2,0,7
09/16/15,1,25,715,375,164,4,7,0,11
09/16/15,1,26,542,360,74,21,8,0,29
09/16/15,1,27,542,360,84,9,8,0,17
09/16/15,1,28,8032,375,72,2,23,0,25
09/16/15,1,29,737,270,86,15,12,0,27
09/16/15,1,30,7675,270,51,23,15,0,38
09/16/15,2,1,738,305,114,14,6,3,23
09/16/15,2,2,726,315,138,10,0,2,12
09/16/15,2,3,5302,220,55,25,3,0,28
09/16/15,2,4,996,220,52,21,12,0,33
09/16/15,2,5,8030,370,130,3,14,0,17
09/16/15,2,6,3062,370,127,19,15,0,34
09/16/15,2,9,542,350,99,28,11,0,39
09/16/15,2,10,8035,370,114,1,2,4,7
09/16/15,2,12,8032,350,93,14,40,3,57
09/16/15,2,13,542,350,113,24,6,0,30
09/16/15,2,14,8030,360,160,0,3,0,3
09/16/15,2,15,542,350,119,9,6,0,15
09/16/15,2,16,8040,350,111,21,17,1,39
09/16/15,2,17,747,370,148,10,5,0,15
09/16/15,2,18,542,350,105,15,2,2,19
09/16/15,2,19,542,360,123,20,4,0,24
09/16/15,2,20,542,350,92,17,15,1,33
09/16/15,2,21,774,350,105,7,8,0,15
09/16/15,2,22,542,350,74,5,17,0,22
09/16/15,2,23,485,350,116,14,2,0,16
09/16/15,2,25,715,375,166,0,3,0,3
09/16/15,2,26,542,360,100,29,4,0,33
09/16/15,2,27,542,360,110,13,6,0,19
09/16/15,2,28,8032,375,59,12,17,1,30
09/16/15,2,29,737,270,68,21,10,0,31
09/16/15,2,30,7675,270,94,15,10,0,25
09/16/15,3,1,738,305,108,33,8,4,45
09/16/15,3,2,726,315,67,11,1,5,17
09/16/15,3,3,5302,220,50,22,4,0,26
09/16/15,3,4,996,220,67,20,10,1,31
09/16/15,3,5,8030,370,151,5,12,5,22
09/16/15,3,6,3062,370,128,21,22,5,48
09/16/15,3,8,618,350,34,3,11,9,23
09/16/15,3,9,542,350,121,27,15,2,44
09/16/15,3,12,8032,350,117,18,35,1,54
09/16/15,3,13,542,350,126,26,6,0,32
09/16/15,3,14,8030,360,161,2,4,1,7
09/16/15,3,15,542,350,28,1,5,0,6
09/16/15,3,16,8040,350,82,17,12,1,30
09/16/15,3,17,747,370,51,0,1,1,2
09/16/15,3,18,542,350,33,4,1,1,6
09/16/15,3,19,542,360,26,11,3,0,14
09/16/15,3,20,542,350,37,2,3,5,10
09/16/15,3,21,774,350,29,0,7,0,7
09/16/15,3,22,542,350,30,6,2,0,8
09/16/15,3,23,485,350,32,4,1,0,5
09/16/15,3,24,642,360,29,0,17,17,34
09/16/15,3,25,715,375,65,0,3,0,3
09/16/15,3,26,542,360,23,11,4,0,15
09/16/15,3,27,542,360,33,8,3,0,11
09/16/15,3,28,8032,375,16,6,8,1,15
09/16/15,3,29,737,270,63,19,9,1,29
09/16/15,3,30,7675,270,64,16,8,6,30
09/17/15,1,1,738,305,122,21,8,3,32
09/17/15,1,2,726,315,114,46,1,3,50
09/17/15,1,3,5302,220,75,18,5,0,23
09/17/15,1,4,996,220,61,19,12,0,31
09/17/15,1,5,8030,370,2,0,0,4,4
09/17/15,1,6,3062,370,138,20,14,6,40
09/17/15,1,8,7740,350,159,3,8,0,11
09/17/15,1,9,542,350,124,33,11,4,48
09/17/15,1,11,8040,355,98,19,12,2,33
09/17/15,1,12,8032,350,101,27,30,2,59
09/17/15,1,13,542,350,85,65,7,0,72
09/17/15,1,14,8030,360,160,0,6,0,6
09/17/15,1,15,542,350,120,17,9,0,26
09/17/15,1,16,8040,350,1,1,1,1,3
09/17/15,1,17,747,370,162,4,9,0,13
09/17/15,1,18,542,350,156,8,5,2,15
09/17/15,1,19,542,360,109,29,9,0,38
09/17/15,1,20,542,350,56,9,1,1,11
09/17/15,1,21,641,350,117,2,14,0,16
09/17/15,1,22,542,350,61,12,10,0,22
09/17/15,1,23,497,350,119,12,5,0,17
09/17/15,1,24,1005,360,79,3,27,14,44
09/17/15,1,25,715,375,179,0,6,0,6
09/17/15,1,26,542,360,113,21,13,0,34
09/17/15,1,27,542,360,96,24,13,0,37
09/17/15,1,28,8032,375,77,13,24,0,37
09/17/15,1,29,737,270,73,22,5,0,27
09/17/15,1,30,7675,270,92,10,5,0,15
09/17/15,2,1,738,305,124,16,4,4,24
09/17/15,2,2,726,315,59,27,18,13,58
09/17/15,2,3,5302,220,69,21,6,0,27
09/17/15,2,4,996,220,55,18,10,0,28
09/17/15,2,5,8030,370,164,3,5,1,9
09/17/15,2,6,3062,370,138,16,13,2,31
09/17/15,2,8,7740,350,34,8,5,2,15
09/17/15,2,9,542,350,55,68,3,1,72
09/17/15,2,11,8040,355,102,30,11,1,42
09/17/15,2,12,8032,350,98,16,41,0,57
09/17/15,2,13,542,350,74,40,5,2,47
09/17/15,2,14,8030,360,169,1,0,1,2
09/17/15,2,15,542,350,91,17,5,0,22
09/17/15,2,17,747,370,173,2,2,0,4
09/17/15,2,18,542,350,111,7,6,0,13
09/17/15,2,19,542,360,77,15,7,1,23
09/17/15,2,20,542,350,70,7,8,0,15
09/17/15,2,21,641,350,128,6,8,0,14
09/17/15,2,22,542,350,56,6,16,0,22
09/17/15,2,23,497,350,97,17,4,0,21
09/17/15,2,24,1005,360,23,1,16,5,22
09/17/15,2,25,715,375,141,1,4,0,5
09/17/15,2,26,542,360,57,23,6,0,29
09/17/15,2,27,542,360,99,13,4,0,17
09/17/15,2,28,8032,375,45,9,16,0,25
09/17/15,2,29,737,270,55,25,4,0,29
09/17/15,2,30,7675,270,58,15,12,0,27
09/17/15,3,1,738,305,115,24,8,2,34
09/17/15,3,2,726,315,126,17,14,3,34
09/17/15,3,3,5302,220,90,12,5,0,17
09/17/15,3,4,996,220,11,2,1,0,3
09/17/15,3,5,8030,370,158,2,9,0,11
09/17/15,3,6,3062,370,137,24,12,4,40
09/17/15,3,9,542,350,121,37,15,2,54
09/17/15,3,11,8040,355,133,41,1,0,42
09/17/15,3,12,8032,350,99,14,50,3,67
09/17/15,3,13,542,350,100,52,12,3,67
09/17/15,3,14,8030,360,169,3,1,0,4
09/17/15,3,15,542,350,50,3,5,0,8
09/17/15,3,16,8040,350,62,12,2,0,14
09/17/15,3,17,747,370,97,2,0,1,3
09/17/15,3,18,542,350,64,22,4,2,28
09/17/15,3,19,542,360,60,11,3,0,14
09/17/15,3,21,641,350,72,0,6,0,6
09/17/15,3,22,542,350,60,5,10,0,15
09/17/15,3,23,497,350,56,4,5,0,9
09/17/15,3,24,1005,360,81,4,9,5,18
09/17/15,3,25,715,375,109,1,8,0,9
09/17/15,3,26,542,360,53,17,1,0,18
09/17/15,3,27,542,360,76,3,6,0,9
09/17/15,3,28,8032,375,40,4,16,4,24
09/17/15,3,29,737,270,22,20,6,0,26
09/17/15,3,30,7675,270,81,10,8,0,18
09/18/15,1,1,738,305,118,18,4,3,25
09/18/15,1,2,726,315,122,24,4,3,31
09/18/15,1,3,5302,220,75,18,10,0,28
09/18/15,1,4,996,220,20,5,4,0,9
09/18/15,1,5,8030,370,157,5,8,3,16
09/18/15,1,6,3062,370,68,23,14,2,39
09/18/15,1,9,542,350,120,23,15,2,40
09/18/15,1,11,8040,355,105,22,24,3,49
09/18/15,1,12,8032,350,96,21,34,1,56
09/18/15,1,13,542,350,101,27,16,0,43
09/18/15,1,14,8030,360,165,3,1,4,8
09/18/15,1,15,542,350,128,6,14,0,20
09/18/15,1,16,8040,350,119,31,6,2,39
09/18/15,1,17,747,370,148,2,9,1,12
09/18/15,1,18,542,350,130,18,4,0,22
09/18/15,1,19,542,360,133,12,1,0,13
09/18/15,1,20,542,350,41,2,3,3,8
09/18/15,1,21,641,350,94,4,10,0,14
09/18/15,1,22,542,350,74,10,22,0,32
09/18/15,1,23,497,350,83,21,1,0,22
09/18/15,1,24,1005,360,78,2,19,9,30
09/18/15,1,25,715,375,167,1,3,0,4
09/18/15,1,26,542,360,115,27,10,0,37
09/18/15,1,27,542,360,102,5,11,0,16
09/18/15,1,28,8032,375,68,14,31,0,45
09/18/15,1,29,737,270,51,10,24,0,34
09/18/15,1,30,7675,270,67,19,15,0,34
09/18/15,2,1,738,305,101,13,8,5,26
09/18/15,2,2,726,315,112,28,4,2,34
09/18/15,2,3,5302,220,65,21,9,0,30
09/18/15,2,4,996,220,26,9,3,0,12
09/18/15,2,5,8030,370,157,1,8,0,9
09/18/15,2,6,3062,370,112,23,11,0,34
09/18/15,2,9,542,350,71,48,5,1,54
09/18/15,2,11,8040,355,101,21,20,0,41
09/18/15,2,12,8032,350,78,16,27,0,43
09/18/15,2,13,542,350,89,18,6,1,25
09/18/15,2,14,8030,360,157,7,0,0,7
09/18/15,2,15,542,350,74,8,12,0,20
09/18/15,2,16,8040,350,114,15,4,0,19
09/18/15,2,17,747,370,129,5,5,1,11
09/18/15,2,18,542,350,91,13,7,2,22
09/18/15,2,19,542,360,108,12,7,0,19
09/18/15,2,20,542,350,87,11,12,0,23
09/18/15,2,21,641,350,62,2,10,0,12
09/18/15,2,22,542,350,51,7,14,0,21
09/18/15,2,23,497,350,154,9,0,0,9
09/18/15,2,24,1005,360,106,1,9,1,11
09/18/15,2,25,715,375,133,1,5,0,6
09/18/15,2,26,542,360,45,12,2,0,14
09/18/15,2,27,542,360,83,17,5,0,22
09/18/15,2,28,8032,375,64,5,18,1,24
09/18/15,2,29,737,270,31,18,26,0,44
09/18/15,2,30,7675,270,54,18,12,0,30
09/18/15,3,1,738,305,115,21,7,2,30
09/18/15,3,2,726,315,112,34,2,0,36
09/18/15,3,3,5302,220,71,19,9,0,28
09/18/15,3,4,996,220,61,10,4,0,14
09/18/15,3,5,8030,370,151,7,15,4,26
09/18/15,3,6,3062,370,128,22,13,4,39
09/18/15,3,9,542,350,123,19,14,1,34
09/18/15,3,11,8040,355,93,45,13,1,59
09/18/15,3,13,542,350,114,30,11,2,43
09/18/15,3,14,8030,360,153,1,6,2,9
09/18/15,3,16,8040,350,134,10,3,4,17
09/18/15,3,29,737,270,36,15,8,1,24
09/18/15,3,30,7675,270,28,14,10,0,24
09/21/15,1,1,738,305,108,28,8,7,43
09/21/15,1,2,726,315,123,34,1,5,40
09/21/15,1,3,5302,220,89,15,3,0,18
09/21/15,1,4,996,220,54,18,15,0,33
09/21/15,1,5,8030,370,154,2,12,2,16
09/21/15,1,6,3062,370,119,31,14,7,52
09/21/15,1,9,513,350,115,33,10,2,45
09/21/15,1,10,8035,370,122,3,4,1,8
09/21/15,1,11,542,355,50,23,28,3,54
09/21/15,1,13,542,350,95,19,11,0,30
09/21/15,1,14,8030,360,170,1,0,2,3
09/21/15,1,15,542,350,84,21,8,0,29
09/21/15,1,16,285,350,127,26,2,3,31
09/21/15,1,17,747,370,144,0,4,0,4
09/21/15,1,19,542,360,126,20,6,0,26
09/21/15,1,20,542,350,97,8,14,2,24
09/21/15,1,22,542,350,91,6,23,0,29
09/21/15,1,23,497,350,162,10,3,0,13
09/21/15,1,24,715,360,136,2,5,0,7
09/21/15,1,25,715,375,194,1,4,3,8
09/21/15,1,26,542,360,18,3,2,0,5
09/21/15,1,27,542,360,102,5,11,0,16
09/21/15,1,28,8032,375,87,14,20,0,34
09/21/15,1,29,737,270,89,15,5,0,20
09/21/15,1,30,7675,270,50,18,21,0,39
09/21/15,2,1,738,305,89,27,9,9,45
09/21/15,2,2,726,315,119,29,3,2,34
09/21/15,2,3,5302,220,77,18,5,0,23
09/21/15,2,4,996,220,62,17,13,0,30
09/21/15,2,5,8030,370,160,1,7,1,9
09/21/15,2,6,3062,370,133,26,10,1,37
09/21/15,2,9,513,350,119,47,14,0,61
09/21/15,2,10,8035,370,158,8,1,1,10
09/21/15,2,11,542,355,90,14,37,0,51
09/21/15,2,13,542,350,129,14,15,1,30
09/21/15,2,14,8030,360,168,0,3,1,4
09/21/15,2,16,285,350,114,37,0,2,39
09/21/15,2,17,747,370,156,0,8,4,12
09/21/15,2,18,542,350,131,28,2,0,30
09/21/15,2,19,542,360,83,11,3,0,14
09/21/15,2,20,542,350,130,8,15,0,23
09/21/15,2,21,784,350,41,3,15,0,18
09/21/15,2,22,542,350,102,10,16,0,26
09/21/15,2,23,497,350,130,5,3,0,8
09/21/15,2,24,715,360,113,8,11,2,21
09/21/15,2,25,715,159,141,3,11,0,14
09/21/15,2,26,542,360,98,19,7,0,26
09/21/15,2,27,542,360,134,47,8,0,55
09/21/15,2,28,8032,375,68,14,26,0,40
09/21/15,2,29,737,270,60,27,8,0,35
09/21/15,2,30,7675,270,53,16,20,0,36
09/21/15,3,1,738,305,107,27,3,1,31
09/21/15,3,2,726,315,126,21,5,0,26
09/21/15,3,3,5302,220,73,19,6,0,25
09/21/15,3,4,996,220,69,15,12,0,27
09/21/15,3,5,8030,370,127,2,8,0,10
09/21/15,3,6,3062,370,140,18,15,4,37
09/21/15,3,8,7740,350,34,3,2,0,5
09/21/15,3,9,513,350,115,31,10,4,45
09/21/15,3,10,8035,370,164,3,2,0,5
09/21/15,3,11,542,355,91,37,30,3,70
09/21/15,3,13,542,350,113,37,9,0,46
09/21/15,3,14,8030,360,127,0,3,0,3
09/21/15,3,15,542,350,70,11,8,0,19
09/21/15,3,17,747,370,137,0,5,1,6
09/21/15,3,18,542,350,118,3,5,0,8
09/21/15,3,19,542,360,37,7,2,0,9
09/21/15,3,20,542,350,118,3,5,2,10
09/21/15,3,21,784,350,44,1,26, ,27
09/21/15,3,22,542,350,92,10,13, ,23
09/21/15,3,23,497,350,71,10,18,0,28
09/21/15,3,24,715,360,92,4,5,0,9
09/21/15,3,25,715,375,132,0,9,0,9
09/21/15,3,26,542,360,76,20,9,0,29
09/21/15,3,27,542,360,71,40,6,0,46
09/21/15,3,28,8032,375,52,18,29,2,49
09/21/15,3,29,737,270,74,22,6,0,28
09/22/15,1,1,738,305,110,19,10,3,32
09/22/15,1,2,726,315,121,9,3,1,13
09/22/15,1,3,5302,220,80,14,6,1,21
09/22/15,1,4,996,220,63,16,5,0,21
09/22/15,1,9,513,350,120,19,9,4,32
09/22/15,1,10,8035,370,165,6,1,0,7
09/22/15,1,11,542,355,115,28,12,0,40
09/22/15,1,15,542,350,117,14,21,0,35
09/22/15,1,17,747,370,160,4,7,1,12
09/22/15,1,18,542,350,120,14,12,0,26
09/22/15,1,19,542,360,110,22,8,1,31
09/22/15,1,20,542,350,126,16,8,0,24
09/22/15,1,21,784,350,52,5,12,1,18
09/22/15,1,22,542,350,67,8,14,0,22
09/22/15,1,23,497,350,148,15,1,0,16
09/22/15,1,24,715,360,136,4,2,0,6
09/22/15,1,25,715,375,158,0,4,1,5
09/22/15,1,26,542,360,87,19,4,6,29
09/22/15,1,27,542,360,43,26,4,1,31
09/22/15,1,28,8032,375,74,9,20,0,29
09/22/15,1,29,737,270,76,15,6,0,21
09/22/15,2,1,738,305,90,17,14,5,36
09/22/15,2,2,726,315,93,14,1,9,24
09/22/15,2,3,5302,220,65,20,5,0,25
09/22/15,2,4,996,220,24,6,2,0,8
09/22/15,2,5,8030,370,56,1,3,3,7
09/22/15,2,9,513,350,116,21,8,3,32
09/22/15,2,10,8035,370,161,5,1,1,7
09/22/15,2,11,542,355,95,30,14,0,44
09/22/15,2,13,542,350,4,2,0,2,4
09/22/15,2,15,542,350,110,15,19,0,34
09/22/15,2,17,747,370,155,9,6,2,17
09/22/15,2,18,542,350,62,8,16,1,25
09/22/15,2,19,542,360,100,23,6,0,29
09/22/15,2,20,542,350,111,15,6,1,22
09/22/15,2,21,784,350,44,4,11,0,15
09/22/15,2,22,542,350,58,7,16,0,23
09/22/15,2,23,497,350,141,14,1,0,15
09/22/15,2,24,715,360,93,6,15,0,21
09/22/15,2,25,715,375,147,0,5,0,5
09/22/15,2,26,542,360,90,20,5,0,25
09/22/15,2,27,542,360,39,27,1,0,28
09/22/15,2,28,8032,375,73,10,25,0,35
09/22/15,2,29,737,270,51,12,4,1,17
09/22/15,2,30,7675,270,34,6,4,0,10
09/22/15,3,1,738,305,112,20,11,5,36
09/22/15,3,2,726,315,143,10,2,1,13
09/22/15,3,3,5302,220,65,19,6,0,25
09/22/15,3,4,996,220,22,5,1,0,6
09/22/15,3,5,8030,370,157,0,8,0,8
09/22/15,3,9,513,350,116,10,16,3,29
09/22/15,3,10,8035,370,166,4,0,0,4
09/22/15,3,11,542,355,113,18,29,5,52
09/22/15,3,13,542,350,124,21,12,3,36
09/22/15,3,14,8030,360,44,12,1,3,16
09/22/15,3,15,542,350,125,11,21,0,32
09/22/15,3,17,747,370,158,2,5,0,7
09/22/15,3,18,542,350,137,15,4,0,19
09/22/15,3,19,542,360,100,9,5,0,14
09/22/15,3,20,542,350,124,12,7,1,20
09/22/15,3,21,784,350,60,3,27,0,30
09/22/15,3,22,542,350,68,8,12,0,20
09/22/15,3,23,497,350,116,11,6,0,17
09/22/15,3,24,715,360,133,4,5,0,9
09/22/15,3,25,715,375,152,1,2,0,3
09/22/15,3,26,542,360,63,26,5,0,31
09/22/15,3,27,542,360,52,21,4,0,25
09/22/15,3,28,8032,375,61,6,20,0,26
09/22/15,3,29,737,270,70,13,5,0,18
09/22/15,3,30,7675,270,73,15,6,1,22
09/23/15,1,1,738,305,114,20,9,1,30
09/23/15,1,2,726,315,114,36,0,2,38
09/23/15,1,3,5302,220,86,15,3,0,18
09/23/15,1,4,996,220,81,18,12,0,30
09/23/15,1,5,8030,370,155,3,2,5,10
09/23/15,1,6,3062,370,109,11,14,9,34
09/23/15,1,7,8040,345,78,15,4,6,25
09/23/15,1,9,513,350,147,4,11,3,18
09/23/15,1,10,8035,370,163,4,0,2,6
09/23/15,1,11,542,355,71,40,22,2,64
09/23/15,1,12,8032,350,25,3,12,4,19
09/23/15,1,13,542,350,129,7,8,1,16
09/23/15,1,14,8030,360,157,6,3,1,10
09/23/15,1,15,542,350,96,17,23,0,40
09/23/15,1,17,747,370,167,7,8,1,16
09/23/15,1,18,542,350,69,6,1,2,9
09/23/15,1,19,542,360,118,15,8,0,23
09/23/15,1,20,542,350,81,13,18,3,34
09/23/15,1,21,784,350,62,29,3,0,32
09/23/15,1,22,542,350,48,4,18,0,22
09/23/15,1,23,497,350,136,10,1,0,11
09/23/15,1,24,715,360,139,3,4,0,7
09/23/15,1,25,715,375,176,2,4,0,6
09/23/15,1,26,542,360,88,28,7,0,35
09/23/15,1,27,542,360,98,18,13,0,31
09/23/15,1,28,8032,375,68,10,19,0,29
09/23/15,1,29,737,270,70,23,5,0,28
09/23/15,1,30,7675,270,56,33,8,0,41
09/23/15,2,1,738,305,112,12,10,3,25
09/23/15,2,2,726,315,105,27,0,2,29
09/23/15,2,3,5302,220,64,18,5,0,23
09/23/15,2,4,996,220,71,15,12,0,27
09/23/15,2,5,8030,370,155,6,4,1,11
09/23/15,2,6,3062,370,118,14,18,5,37
09/23/15,2,7,8040,345,142,9,1,0,10
09/23/15,2,9,513,350,105,14,10,0,24
09/23/15,2,10,8035,370,159,6,1,2,9
09/23/15,2,11,542,355,64,33,25,1,59
09/23/15,2,12,8032,350,107,9,21,2,32
09/23/15,2,13,542,350,102,20,11,2,33
09/23/15,2,14,8030,360,146,5,4,2,11
09/23/15,2,15,542,350,76,11,15,0,26
09/23/15,2,17,747,370,151,2,11,1,14
09/23/15,2,19,542,360,109,14,9,0,23
09/23/15,2,20,542,350,81,13,6,1,20
09/23/15,2,21,784,350,81,3,17,0,20
09/23/15,2,22,542,350,81,9,19,0,28
09/23/15,2,23,497,350,127,10,0,0,10
09/23/15,2,24,715,360,113,6,7,0,13
09/23/15,2,25,715,375,141,9,0,0,9
09/23/15,2,26,542,360,70,25,7,0,32
09/23/15,2,27,542,360,79,17,8,0,25
09/23/15,2,28,8032,375,76,12,23,0,35
09/23/15,2,29,737,270,59,22,4,0,26
09/23/15,2,30,7675,270,44,30,15,0,45
09/23/15,3,1,738,305,109,30,9,1,40
09/23/15,3,2,726,315,137,15,6,3,24
09/23/15,3,3,5302,220,82,17,3,0,20
09/23/15,3,4,996,220,88,16,10,1,27
09/23/15,3,5,8030,370,161,2,1,1,4
09/23/15,3,6,3062,370,131,18,10,9,37
09/23/15,3,7,8040,345,135,10,8,0,18
09/23/15,3,10,8035,370,151,8,4,2,14
09/23/15,3,11,542,355,78,38,23,3,64
09/23/15,3,12,8032,350,108,7,22,2,31
09/23/15,3,14,8030,360,164,11,1,0,12
09/23/15,3,15,542,350,77,3,16,0,19
09/23/15,3,17,747,370,134,1,4,5,10
09/23/15,3,19,542,360,15,0,1,0,1
09/23/15,3,20,542,350,86,7,2,0,9
09/23/15,3,21,784,350,45,3,16,0,19
09/23/15,3,22,542,350,69,4,14,0,18
09/23/15,3,23,497,350,110,18,6,0,24
09/23/15,3,24,715,360,95,3,6,0,9
09/23/15,3,25,715,375,125,0,8,0,8
09/23/15,3,26,542,360,75,30,5,0,35
09/23/15,3,27,542,360,70,25,12,0,37
09/23/15,3,28,8032,375,18,2,6,1,9
09/23/15,3,29,737,270,40,23,5,0,28
09/23/15,3,30,7675,270,67,29,16,0,45
09/24/15,1,1,738,305,111,18,7,5,30
09/24/15,1,2,726,315,126,20,3,2,25
09/24/15,1,3,5302,220,87,18,10,0,28
09/24/15,1,4,996,220,25,5,4,0,9
09/24/15,1,5,8030,370,158,4,6,0,10
09/24/15,1,6,3062,370,129,19,15,5,39
09/24/15,1,7,8040,345,138,18,8,1,27
09/24/15,1,10,8035,370,165,4,0,0,4
09/24/15,1,11,542,355,92,47,29,1,77
09/24/15,1,12,8032,350,122,8,32,1,41
09/24/15,1,14,8030,360,157,8,4,3,15
09/24/15,1,15,542,350,102,36,11,0,47
09/24/15,1,17,747,370,148,4,14,1,19
09/24/15,1,20,542,350,110,20,9,1,30
09/24/15,1,21,784,350,90,3,34,0,37
09/24/15,1,22,542,350,33,4,7,0,11
09/24/15,1,23,497,350,161,28,0,0,28
09/24/15,1,24,715,360,142,17,3,1,21
09/24/15,1,25,715,375,114,0,5,0,5
09/24/15,1,26,542,360,103,38,8,0,46
09/24/15,1,27,542,360,100,22,14,0,36
09/24/15,1,30,7675,270,44,10,18,0,28
09/24/15,2,1,738,305,116,23,7,2,32
09/24/15,2,2,726,315,145,8,2,2,12
09/24/15,2,3,5302,220,58,10,5,0,15
09/24/15,2,5,8030,370,164,2,6,1,9
09/24/15,2,6,3062,370,118,14,17,8,39
09/24/15,2,7,8040,345,139,12,9,0,21
09/24/15,2,10,8035,370,128,1,4,1,6
09/24/15,2,11,542,355,96,27,15,0,42
09/24/15,2,12,8032,350,114,8,22,0,30
09/24/15,2,14,8030,360,171,0,0,0,0
09/24/15,2,17,747,370,169,4,6,0,10
09/24/15,2,18,542,350,44,11,8,0,19
09/24/15,2,19,542,360,111,14,9,0,23
09/24/15,2,20,542,350,81,16,8,4,28
09/24/15,2,21,784,350,64,5,23,0,28
09/24/15,2,23,497,350,86,11,1,0,12
09/24/15,2,24,715,360,111,10,4,2,16
09/24/15,2,26,542,360,75,24,6,0,30
09/24/15,2,27,542,360,78,15,11,0,26
09/24/15,2,28,8032,375,74,8,12,4,24
09/24/15,2,29,737,270,21,6,3,1,10
09/24/15,3,1,738,305,44,15,6,1,22
09/24/15,3,2,726,315,116,27,5,2,34
09/24/15,3,3,5302,220,74,6,3,0,9
09/24/15,3,4,996,220,28,4,5,0,9
09/24/15,3,5,8030,370,151,3,6,1,10
09/24/15,3,6,3062,370,37,4,2,3,9
09/24/15,3,7,8040,345,150,9,3,1,13
09/24/15,3,10,8035,370,146,6,1,0,7
09/24/15,3,11,542,355,86,19,40,4,63
09/24/15,3,12,8032,350,100,9,32,1,42
09/24/15,3,14,8030,360,162,3,2,1,6
09/24/15,3,15,542,350,69,11,24,0,35
09/24/15,3,17,747,370,124,7,6,0,13
09/24/15,3,18,542,350,76,42,6,0,48
09/24/15,3,19,542,360,97,3,12,0,15
09/24/15,3,20,542,350,86,4,7,1,12
09/24/15,3,21,784,350,37,2,8,0,10
09/24/15,3,23,497,350,78,26,0,0,26
09/24/15,3,24,715,360,69,7,6,0,13
09/24/15,3,26,542,360,48,21,9,0,30
09/24/15,3,27,542,360,65,22,6,6,34
09/24/15,3,28,8032,375,79,7,18,0,25
09/24/15,3,29,737,270,36,8,5,0,13
09/25/15,1,1,738,305,58,25,3,37,65
09/25/15,1,2,726,315,121,31,2,1,34
09/25/15,1,3,5302,220,80,15,3,0,18
09/25/15,1,4,996,220,73,12,15,0,27
09/25/15,1,5,8030,370,124,0,3,2,5
09/25/15,1,6,3062,370,132,22,21,6,49
09/25/15,1,7,8040,345,143,7,10,1,18
09/25/15,1,11,542,355,100,14,22,3,39
09/25/15,1,12,8032,350,123,11,34,3,48
09/25/15,1,13,542,350,9,20,1,8,29
09/25/15,1,14,8030,360,69,1,1,1,3
09/25/15,1,15,542,350,109,23,25,0,48
09/25/15,1,17,747,370,186,3,2,0,5
09/25/15,1,18,542,350,95,71,4,3,78
09/25/15,1,19,542,360,138,14,6,0,20
09/25/15,1,20,542,350,88,17,8,1,26
09/25/15,1,21,784,350,81,6,35,0,41
09/25/15,1,23,497,350,132,29,1,0,30
09/25/15,1,24,715,360,135,14,4,1,19
09/25/15,1,26,542,360,118,27,7,0,34
09/25/15,1,27,542,360,83,30,9,0,39
09/25/15,1,28,8032,375,94,8,19,1,28
09/25/15,1,29,737,270,49,23,12,0,35
09/25/15,1,30,7675,270,41,10,15,0,25
09/25/15,2,1,738,305,106,29,12,0,41
09/25/15,2,2,726,315,129,18,3,2,23
09/25/15,2,3,5302,220,80,18,5,0,23
09/25/15,2,4,996,220,46,12,23,0,35
09/25/15,2,5,8030,370,151,3,3,0,6
09/25/15,2,6,3062,370,142,17,11,2,30
09/25/15,2,7,8040,345,163,10,1,3,14
09/25/15,2,8,7740,350,25,9,8,2,19
09/25/15,2,11,542,355,80,55,16,0,71
09/25/15,2,12,8032,350,101,12,27,0,39
09/25/15,2,13,542,350,62,39,14,2,55
09/25/15,2,14,8030,360,134,11,5,3,19
09/25/15,2,15,542,350,83,16,18,0,34
09/25/15,2,17,747,370,100,3,2,1,6
09/25/15,2,18,542,350,62,41,3,0,44
09/25/15,2,19,542,360,131,9,7,0,16
09/25/15,2,20,542,350,98,13,8,10,31
09/25/15,2,21,784,350,63,1,21,0,22
09/25/15,2,22,542,350,35,15,7,0,22
09/25/15,2,23,497,350,128,19,0,0,19
09/25/15,2,24,715,360,116,14,3,3,20
09/25/15,2,26,542,360,61,20,10,0,30
09/25/15,2,27,542,360,74,17,13,0,30
09/25/15,2,28,8032,375,88,5,14,0,19
09/25/15,2,29,737,270,36,27,15,0,42
09/25/15,2,30,7675,270,63,12,19,0,31
09/25/15,3,1,738,305,94,38,9,4,51
09/25/15,3,2,726,315,126,19,5,4,28
09/25/15,3,3,5302,220,79,17,4,1,22
09/25/15,3,4,996,220,53,14,3,0,17
09/25/15,3,5,8030,370,162,1,5,2,8
09/25/15,3,6,3062,370,127,19,12,14,45
09/25/15,3,7,8040,345,136,16,9,2,27
09/25/15,3,11,542,355,84,33,28,2,63
09/25/15,3,12,8032,350,104,16,21,1,38
09/25/15,3,13,542,350,80,36,26,4,66
09/25/15,3,14,8030,360,164,1,7,0,8
09/25/15,3,15,542,350,13,1,4,0,5
09/25/15,3,18,542,350,22,19,0,0,19
09/25/15,3,19,542,360,30,1,4,0,5
09/25/15,3,20,542,350,50,4,0,2,6
09/25/15,3,21,784,350,48,3,10,0,13
09/25/15,3,22,542,350,53,17,13,0,30
09/25/15,3,23,497,350,112,14,1,0,15
09/25/15,3,24,715,360,96,1,6,1,8
09/25/15,3,26,542,360,82,23,10,0,33
09/25/15,3,27,542,360,82,18,4,0,22
09/25/15,3,28,8032,375,61,11,29,1,41
09/25/15,3,30,7675,270,53,14,16,0,30
09/28/15,1,1,738,305,94,20,3,2,25
09/28/15,1,2,726,315,94,24,1,3,28
09/28/15,1,3,5302,220,86,15,3,0,18
09/28/15,1,4,996,220,50,16,12,0,28
09/28/15,1,5,8030,370,156,2,8,1,11
09/28/15,1,6,3062,370,132,14,11,4,29
09/28/15,1,7,774,345,140,11,7,3,21
09/28/15,1,11,542,355,94,21,20,0,41
09/28/15,1,12,8032,350,93,15,24,1,40
09/28/15,1,13,542,350,50,32,7,1,40
09/28/15,1,14,8030,360,135,10,3,7,20
09/28/15,1,15,542,350,104,15,21,0,36
09/28/15,1,19,775,360,115,17,1,0,18
09/28/15,1,20,542,350,86,11,13,0,24
09/28/15,1,21,784,350,69,5,20,0,25
09/28/15,1,22,542,350,50,6,20,0,26
09/28/15,1,23,497,350,69,9,2,0,11
09/28/15,1,24,715,360,122,9,2,0,11
09/28/15,1,26,542,360,83,27,3,0,30
09/28/15,1,27,542,360,87,19,7,0,26
09/28/15,1,28,8032,375,77,2,20,3,25
09/28/15,1,30,7675,270,44,15,15,0,30
09/28/15,2,1,738,305,106,21,4,4,29
09/28/15,2,2,726,315,75,54,3,4,61
09/28/15,2,3,5302,220,61,14,4,1,19
09/28/15,2,4,996,220,57,14,8,2,24
09/28/15,2,5,8030,370,143,3,3,1,7
09/28/15,2,6,3062,370,126,6,16,14,36
09/28/15,2,7,774,345,149,5,5,2,12
09/28/15,2,11,542,355,84,31,19,3,53
09/28/15,2,12,8032,350,105,10,29,1,40
09/28/15,2,13,542,350,83,27,10,0,37
09/28/15,2,14,8030,360,155,4,1,0,5
09/28/15,2,15,542,350,72,4,18,0,22
09/28/15,2,18,542,350,65,12,10,2,24
09/28/15,2,19,775,360,135,9,9,0,18
09/28/15,2,20,542,350,109,10,11,2,23
09/28/15,2,21,784,350,56,3,20,0,23
09/28/15,2,22,542,350,45,2,17,0,19
09/28/15,2,24,715,360,121,2,6,3,11
09/28/15,2,26,542,360,64,23,9,0,32
09/28/15,2,27,542,360,30,13,7,0,20
09/28/15,2,28,8032,375,69,6,16,0,22
09/28/15,2,29,729,270,39,12,5,1,18
09/28/15,2,30,7675,270,39,15,6,1,22
09/28/15,3,1,738,305,98,23,5,2,30
09/28/15,3,2,726,315,97,34,5,3,42
09/28/15,3,3,5302,220,73,12,4,0,16
09/28/15,3,4,996,220,51,15,7,0,22
09/28/15,3,5,8030,370,151,1,8,0,9
09/28/15,3,6,3062,370,118,15,11,5,31
09/28/15,3,9,7601,350,67,17,3,6,26
09/28/15,3,11,542,355,49,58,9,0,67
09/28/15,3,12,8032,350,90,9,22,3,34
09/28/15,3,13,542,350,51,27,4,0,31
09/28/15,3,14,8030,360,171,1,0,1,2
09/28/15,3,15,542,350,78,6,12,0,18
09/28/15,3,17,747,370,14,2,3,0,5
09/28/15,3,18,542,350,57,7,6,0,13
09/28/15,3,19,775,360,64,6,9,0,15
09/28/15,3,20,542,350,27,3,10,5,18
09/28/15,3,21,784,350,5,0,3,0,3
09/28/15,3,22,542,350,16,7,0,0,7
09/28/15,3,24,715,360,23,2,3,0,5
09/28/15,3,26,542,360,21,20,0,0,20
09/28/15,3,27,542,360,73,21,9,0,30
09/28/15,3,28,8032,375,79,15,16,0,31
09/28/15,3,29,729,270,25,11,6, ,17
09/28/15,3,30,7675,270,35,14,6,1,21
09/29/15,1,1,738,305,102,20,9,2,31
09/29/15,1,2,726,315,105,47,4,0,51
09/29/15,1,3,5302,220,64,21,5,0,26
09/29/15,1,5,8030,370,160,3,4,1,8
09/29/15,1,6,3062,370,140,17,8,3,28
09/29/15,1,9,7601,350,135,18,5,1,24
09/29/15,1,10,8035,370,12,8,2,2,12
09/29/15,1,11,542,355,71,78,15,5,98
09/29/15,1,12,8032,350,106,15,30,1,46
09/29/15,1,13,542,350,59,72,4,0,76
09/29/15,1,14,8030,360,163,0,1,2,3
09/29/15,1,15,542,350,109,14,22,0,36
09/29/15,1,17,747,370,164,1,5,1,7
09/29/15,1,18,542,350,127,28,2,0,30
09/29/15,1,19,775,360,127,7,8,0,15
09/29/15,1,20,542,350,99,13,11,1,25
09/29/15,1,21,784,350,72,0,31,0,31
09/29/15,1,22,542,350,6,0,1,0,1
09/29/15,1,24,715,360,130,5,6,1,12
09/29/15,1,26,542,360,64,11,16,0,27
09/29/15,1,27,542,360,77,17,12,0,29
09/29/15,1,28,8032,375,84,17,16,2,35
09/29/15,1,29,729,270,64,18,6,0,24
09/29/15,1,30,7675,270,37,23,18,0,41
09/29/15,2,1,738,305,111,18,7,8,33
09/29/15,2,2,726,315,96,31,4,2,37
09/29/15,2,3,5302,220,69,18,4,0,22
09/29/15,2,4,996,220,47,21,12,0,33
09/29/15,2,5,8030,370,138,2,12,1,15
09/29/15,2,6,3062,370,125,20,11,6,37
09/29/15,2,8,7740,350,32,13,8,2,23
09/29/15,2,9,7601,350,137,8,9,0,17
09/29/15,2,10,8035,370,135,6,8,5,19
09/29/15,2,11,542,355,71,24,20,1,45
09/29/15,2,12,8032,350,100,6,27,1,34
09/29/15,2,13,542,350,67,25,5,1,31
09/29/15,2,14,8030,360,131,10,1,2,13
09/29/15,2,15,542,350,88,9,13,0,22
09/29/15,2,16,285,350,17,10,6,6,22
09/29/15,2,17,747,370,157,3,6,2,11
09/29/15,2,18,542,350,83,35,3,1,39
09/29/15,2,19,775,360,138,10,9,0,19
09/29/15,2,20,542,350,94,16,12,3,31
09/29/15,2,21,784,350,40,1,21,0,22
09/29/15,2,22,542,350,30,4,15,0,19
09/29/15,2,24,715,360,123,3,4,1,8
09/29/15,2,26,542,360,73,27,2,0,29
09/29/15,2,27,542,360,55,10,11,0,21
09/29/15,2,28,8032,375,81,4,22,1,27
09/29/15,2,29,729,270,43,28,6,0,34
09/29/15,2,30,7675,270,36,28,15,0,43
09/29/15,3,1,738,305,106,15,8,2,25
09/29/15,3,2,726,315,110,39,1,0,40
09/29/15,3,3,5302,220,66,17,5,0,22
09/29/15,3,4,996,220,37,19,4,0,23
09/29/15,3,5,8030,370,144,1,15,1,17
09/29/15,3,6,3062,370,127,22,21,14,57
09/29/15,3,9,7601,350,156,12,1,2,15
09/29/15,3,10,8035,370,154,15,3,0,18
09/29/15,3,11,542,355,100,34,35,3,72
09/29/15,3,13,542,350,98,25,15,1,41
09/29/15,3,14,8030,360,163,4,1,1,6
09/29/15,3,15,542,350,85,4,15,0,19
09/29/15,3,16,285,350,104,31,17,8,56
09/29/15,3,17,747,370,130,5,4,4,13
09/29/15,3,18,542,350,103,12,6,0,18
09/29/15,3,19,775,360,125,13,2,0,15
09/29/15,3,20,542,350,106,9,17,3,29
09/29/15,3,21,784,350,58,2,19,0,21
09/29/15,3,22,542,350,43,5,22,0,27
09/29/15,3,24,715,360,106,2,4,0,6
09/29/15,3,25,715,375,37,0,24,0,24
09/29/15,3,26,542,360,63,18,5,0,23
09/29/15,3,27,542,360,75,16,10,0,26
09/29/15,3,28,8032,375,91,7,17,0,24
09/29/15,3,29,729,270,46,25,7,0,32
09/30/15,1,1,738,305,86,23,12,5,40
09/30/15,1,2,726,315,119,28,1,4,33
09/30/15,1,3,5302,220,80,15,5,0,20
09/30/15,1,4,996,220,62,23,12,0,35
09/30/15,1,5,8030,370,158,4,3,1,8
09/30/15,1,6,3062,370,133,22,5,11,38
09/30/15,1,7,7601,345,32,4,1,3,8
09/30/15,1,9,7601,350,138,16,5,2,23
09/30/15,1,10,8035,370,141,8,8,1,17
09/30/15,1,11,542,355,94,45,4,1,50
09/30/15,1,12,8032,350,1,1,1,2,4
09/30/15,1,13,542,350,88,66,7,0,73
09/30/15,1,14,8030,360,125,17,0,4,21
09/30/15,1,15,542,350,89,8,9,0,17
09/30/15,1,16,285,350,124,14,14,2,30
09/30/15,1,17,747,370,164,7,8,0,15
09/30/15,1,18,542,350,104,25,10,0,35
09/30/15,1,19,775,360,106,9,12,0,21
09/30/15,1,20,542,350,89,11,16,1,28
09/30/15,1,21,784,350,57,5,23,0,28
09/30/15,1,22,542,350,81,9,14,0,23
09/30/15,1,24,715,360,116,2,7,0,9
09/30/15,1,25,715,375,46,2,31,0,33
09/30/15,1,26,542,360,104,33,6,0,39
09/30/15,1,28,8032,375,95,4,22,1,27
09/30/15,1,29,729,270,57,23,5,0,28
09/30/15,1,30,7675,270,55,18,19,0,37
09/30/15,2,1,738,305,116,23,8,3,34
09/30/15,2,2,726,315,134,19,1,1,21
09/30/15,2,3,5302,220,40,15,8,0,23
09/30/15,2,4,996,220,54,18,15,0,33
09/30/15,2,5,8030,370,158,3,8,0,11
09/30/15,2,7,7601,345,116,9,5,0,14
09/30/15,2,9,7601,350,156,10,4,1,15
09/30/15,2,10,8035,370,147,8,8,1,17
09/30/15,2,11,542,355,37,15,2,1,18
09/30/15,2,12,8032,350,100,11,20,4,35
09/30/15,2,13,542,350,95,25,14,0,39
09/30/15,2,14,8030,360,110,15,2,0,17
09/30/15,2,16,285,350,110,13,11,2,26
09/30/15,2,17,747,370,132,2,5,2,9
09/30/15,2,18,542,350,80,27,7,0,34
09/30/15,2,19,775,360,92,9,18,0,27
09/30/15,2,20,542,350,107,13,8,1,22
09/30/15,2,21,784,350,61,1,16,0,17
09/30/15,2,22,542,350,51,8,13,0,21
09/30/15,2,24,715,360,127,2,7,3,12
09/30/15,2,25,715,375,19,0,12,0,12
09/30/15,2,26,542,360,65,20,7,0,27
09/30/15,2,28,8032,375,67,8,22,0,30
09/30/15,2,29,729,270,21,20,8,0,28
09/30/15,2,30,7675,270,48,23,21,0,44
09/30/15,3,1,738,305,105,21,11,4,36
09/30/15,3,2,726,315,130,7,2,2,11
09/30/15,3,3,5302,220,66,17,6,1,24
09/30/15,3,4,996,220,39,12,5,0,17
09/30/15,3,5,8030,370,150,6,6,1,13
09/30/15,3,7,7601,345,139,14,2,3,19
09/30/15,3,9,7601,350,141,7,7,4,18
09/30/15,3,10,8035,370,134,16,6,2,24
09/30/15,3,12,8032,350,97,10,25,1,36
09/30/15,3,13,542,350,92,20,8,0,28
09/30/15,3,14,8030,360,166,1,0,3,4
09/30/15,3,15,542,350,26,5,5,0,10
09/30/15,3,16,285,350,62,64,3,3,70
09/30/15,3,17,747,370,114,1,1,3,5
09/30/15,3,19,775,360,93,10,6,0,16
09/30/15,3,20,542,350,23,2,1,0,3
09/30/15,3,21,784,350,39,0,10,0,10
09/30/15,3,22,542,350,65,11,14,0,25
09/30/15,3,24,715,360,136,1,7,1,9
09/30/15,3,25,715,375,23,0,15,0,15
09/30/15,3,26,542,360,83,22,5,0,27
09/30/15,3,28,8032,375,67,4,26,1,31
09/30/15,3,29,729,270,18,22,9,0,31
09/30/15,3,30,7675,270,62,21,15,0,36
10/01/15,1,1,738,305,102,24,7,4,35
10/01/15,1,2,726,315,126,22,1,3,26
10/01/15,1,3,5302,220,82,12,2,1,15
10/01/15,1,4,996,220,43,8,6,0,14
10/01/15,1,5,8030,370,155,8,4,0,12
10/01/15,1,7,7601,345,142,20,0,1,21
10/01/15,1,9,7601,350,153,6,4,3,13
10/01/15,1,10,8035,370,146,19,2,0,21
10/01/15,1,11,542,355,5,4,0,3,7
10/01/15,1,12,8032,350,129,11,34,3,48
10/01/15,1,13,542,350,88,24,12,3,39
10/01/15,1,14,8030,360,159,3,5,0,8
10/01/15,1,15,542,350,132,20,6,0,26
10/01/15,1,16,285,350,122,22,14,3,39
10/01/15,1,17,747,370,172,3,6,0,9
10/01/15,1,18,542,350,42,7,2,3,12
10/01/15,1,19,775,360,87,16,6,0,22
10/01/15,1,20,542,350,87,7,1,2,10
10/01/15,1,21,784,350,59,5,26,0,31
10/01/15,1,22,542,350,75,5,20,0,25
10/01/15,1,23,497,350,6,7,0,0,7
10/01/15,1,24,715,360,15,0,1,0,1
10/01/15,1,25,715,375,77,0,24,0,24
10/01/15,1,26,542,360,70,21,5,0,26
10/01/15,1,27,542,360,29,17,1,0,18
10/01/15,1,28,8032,375,68,3,19,0,22
10/01/15,1,29,729,270,76,15,3,0,18
10/01/15,1,30,7675,270,41,22,18,0,40
10/01/15,2,1,738,305,116,16,10,0,26
10/01/15,2,2,726,315,108,26,2,2,30
10/01/15,2,3,5302,220,67,19,3,0,22
10/01/15,2,4,996,220,61,12,9,0,21
10/01/15,2,5,8030,370,155,8,4,1,13
10/01/15,2,6,3062,370,19,13,9,12,34
10/01/15,2,7,7601,345,143,20,0,1,21
10/01/15,2,9,7601,350,153,8,2,2,12
10/01/15,2,10,8035,370,132,7,7,2,16
10/01/15,2,11,542,355,47,4,0,3,7
10/01/15,2,12,8032,350,92,14,20,2,36
10/01/15,2,13,542,350,58,24,12,3,39
10/01/15,2,14,8030,360,134,4,4,1,9
10/01/15,2,15,542,350,80,15,5,0,20
10/01/15,2,16,285,350,102,10,15,6,31
10/01/15,2,17,747,370,145,4,8,0,12
10/01/15,2,18,542,350,80,22,8,1,31
10/01/15,2,19,775,360,98,15,7,0,22
10/01/15,2,21,784,350,56,2,20,0,22
10/01/15,2,22,542,350,73,8,9,0,17
10/01/15,2,23,497,350,25,26,2,0,28
10/01/15,2,25,715,375,145,2,12,0,14
10/01/15,2,26,542,360,67,25,4,0,29
10/01/15,2,27,542,360,44,13,6,0,19
10/01/15,2,28,8032,375,91,7,12,0,19
10/01/15,2,29,729,270,43,18,5,0,23
10/01/15,2,30,7675,270,42,26,19,0,45
10/01/15,3,1,738,305,92,39,9,5,53
10/01/15,3,2,726,315,97,49,3,2,54
10/01/15,3,3,5302,220,36,17,5,1,23
10/01/15,3,4,996,220,59,9,6,0,15
10/01/15,3,6,3062,370,122,1,6,11,18
10/01/15,3,7,7601,345,150,13,0,4,17
10/01/15,3,8,7740,350,35,2,1,0,3
10/01/15,3,9,7601,350,150,17,0,4,21
10/01/15,3,10,8035,370,135,6,9,2,17
10/01/15,3,11,542,355,117,37,9,1,47
10/01/15,3,12,8032,350,107,24,23,0,47
10/01/15,3,13,542,350,93,27,12,0,39
10/01/15,3,14,8030,360,153,0,2,0,2
10/01/15,3,15,542,350,56,8,1,0,9
10/01/15,3,16,285,350,90,20,12,3,35
10/01/15,3,17,747,370,83,0,3,3,6
10/01/15,3,18,542,350,55,13,1,0,14
10/01/15,3,19,775,360,33,12,5,0,17
10/01/15,3,21,784,350,37,0,14,0,14
10/01/15,3,22,542,350,38,9,6,0,15
10/01/15,3,23,497,350,67,30,4,0,34
10/01/15,3,25,715,375,82,0,7,0,7
10/01/15,3,26,542,360,54,16,6,0,22
10/01/15,3,27,542,360,60,17,10,0,27
10/01/15,3,28,8032,375,56,7,24,1,32
10/01/15,3,29,729,270,68,20,4,0,24
10/01/15,3,30,7675,270,67,22,10,0,32
10/02/15,1,1,738,305,97,26,9,6,41
10/02/15,1,2,726,315,96,37,5,2,44
10/02/15,1,4,996,220,51,22,18,0,40
10/02/15,1,6,3062,370,160,1,2,4,7
10/02/15,1,7,7601,345,139,14,0,0,14
10/02/15,1,9,7601,350,161,11,0,4,15
10/02/15,1,10,776,370,143,11,3,0,14
10/02/15,1,11,542,355,99,24,10,2,36
10/02/15,1,12,8032,350,6,27,18,3,48
10/02/15,1,13,542,350,90,44,4,2,50
10/02/15,1,14,8030,360,162,5,2,2,9
10/02/15,1,15,542,350,125,18,14,0,32
10/02/15,1,16,285,350,7,4,4,1,9
10/02/15,1,17,747,370,157,5,6,0,11
10/02/15,1,18,542,350,112,13,11,3,27
10/02/15,1,19,775,360,99,26,7,0,33
10/02/15,1,21,784,350,66,4,29,0,33
10/02/15,1,22,542,350,63,10,17,0,27
10/02/15,1,23,497,350,93,26,0,0,26
10/02/15,1,25,715,375,126,0,21,0,21
10/02/15,1,26,542,360,88,23,9,0,32
10/02/15,1,27,542,360,68,28,11,0,39
10/02/15,1,28,8032,375,90,6,19,3,28
10/02/15,1,29,729,270,62,15,5,0,20
10/02/15,1,30,7675,270,21,9,6,0,15
10/02/15,2,1,738,305,110,22,8,1,31
10/02/15,2,2,726,315,94,39,11,2,52
10/02/15,2,3,5302,220,12,5,2,0,7
10/02/15,2,4,996,220,23,5,7,0,12
10/02/15,2,5,8030,370,43,0,4,2,6
10/02/15,2,6,3062,370,152,0,0,4,4
10/02/15,2,7,7601,345,139,6,3,2,11
10/02/15,2,9,7601,350,156,9,7,0,16
10/02/15,2,10,776,370,141,3,13,0,16
10/02/15,2,11,542,355,136,14,8,2,24
10/02/15,2,12,8032,350,88,18,29,2,49
10/02/15,2,13,542,350,74,13,8,6,27
10/02/15,2,14,8030,360,155,5,2,2,9
10/02/15,2,15,542,350,65,15,10,0,25
10/02/15,2,17,747,370,154,7,2,3,12
10/02/15,2,18,542,350,109,28,6,1,35
10/02/15,2,19,775,360,103,28,2,0,30
10/02/15,2,20,542,350,43,5,7,0,12
10/02/15,2,21,784,350,53,0,26,0,26
10/02/15,2,22,542,350,52,11,14,0,25
10/02/15,2,23,497,350,78,23,5,0,28
10/02/15,2,24,715,360,37,16,3,8,27
10/02/15,2,25,715,375,76,2,17,0,19
10/02/15,2,26,542,360,35,11,7,0,18
10/02/15,2,27,542,360,12,1,6,0,7
10/02/15,2,29,729,270,40,17,5,0,22
10/02/15,3,1,738,305,89,28,7,2,37
10/02/15,3,2,726,315,122,20,2,4,26
10/02/15,3,3,5302,220,45,10,1,0,11
10/02/15,3,4,996,220,34,6,1,0,7
10/02/15,3,5,8030,370,138,13,10,4,27
10/02/15,3,6,3062,370,162,1,1,4,6
10/02/15,3,7,7601,345,136,15,1,2,18
10/02/15,3,9,7601,350,129,9,3,2,14
10/02/15,3,10,776,370,137,9,5,0,14
10/02/15,3,11,542,355,101,31,7,2,40
10/02/15,3,12,8032,350,90,25,13,3,41
10/02/15,3,13,542,350,94,30,6,2,38
10/02/15,3,14,8030,360,146,9,1,1,11
10/02/15,3,17,747,370,99,5,3,1,9
10/02/15,3,19,775,360,99,26,7,0,33
10/02/15,3,20,542,350,18,7,3,2,12
10/02/15,3,21,784,350,37,0,14,0,14
10/02/15,3,22,542,350,62,13,13,0,26
10/02/15,3,25,715,375,51,0,11,0,11
10/02/15,3,26,542,360,95,29,6,0,35
10/02/15,3,29,729,270,64,16,10,0,26
10/05/15,1,1,738,305,102,30,8,2,40
10/05/15,1,2,726,315,134,18,6,3,27
10/05/15,1,3,996,220,50,18,57,0,75
10/05/15,1,4,996,220,53,22,45,0,67
10/05/15,1,5,8011,370,167,2,7,0,9
10/05/15,1,6,8038,370,158,3,1,4,8
10/05/15,1,7,7601,345,150,19,0,0,19
10/05/15,1,9,7601,350,115,9,5,7,21
10/05/15,1,10,776,370,122,5,6,2,13
10/05/15,1,11,542,355,120,28,10,1,39
10/05/15,1,12,8032,350,113,7,24,0,31
10/05/15,1,13,542,350,85,40,16,0,56
10/05/15,1,14,8030,360,145,14,1,0,15
10/05/15,1,15,542,350,125,16,13,0,29
10/05/15,1,16,293,350,44,9,10,9,28
10/05/15,1,17,747,370,166,9,6,2,17
10/05/15,1,18,542,350,112,29,8,5,42
10/05/15,1,19,775,360,32,2,5,0,7
10/05/15,1,21,784,350,67,20,1,0,21
10/05/15,1,22,542,350,56,6,15,0,21
10/05/15,1,23,775,350,100,28,2,0,30
10/05/15,1,24,7652,360,68,30,1,0,31
10/05/15,1,25,715,375,78,0,24,0,24
10/05/15,1,26,542,360,97,18,7,0,25
10/05/15,1,28,8032,375,22,5,5,0,10
10/05/15,1,29,729,270,42,25,6,0,31
10/05/15,1,30,7625,270,6,3,2,0,5
10/05/15,2,1,738,305,100,33,6,1,40
10/05/15,2,2,726,315,108,11,5,7,23
10/05/15,2,3,996,220,18,15,5,0,20
10/05/15,2,4,996,220,54,19,10,0,29
10/05/15,2,5,8011,370,156,2,7,1,10
10/05/15,2,6,8038,370,153,0,1,2,3
10/05/15,2,7,7601,345,149,10,0,2,12
10/05/15,2,10,776,370,123,3,9,1,13
10/05/15,2,11,542,355,102,21,9,0,30
10/05/15,2,12,8032,350,109,21,19,0,40
10/05/15,2,13,542,350,67,27,6,0,33
10/05/15,2,14,8030,360,124,17,1,0,18
10/05/15,2,15,542,350,80,14,8,0,22
10/05/15,2,16,293,350,129,7,11,0,18
10/05/15,2,17,747,370,164,5,4,0,9
10/05/15,2,18,542,350,37,22,0,0,22
10/05/15,2,21,784,350,60,4,13,0,17
10/05/15,2,22,542,350,61,4,14,0,18
10/05/15,2,23,775,350,89,19,2,0,21
10/05/15,2,24,7652,360,32,13,8,0,21
10/05/15,2,25,715,159,75,1,21,0,22
10/05/15,2,26,542,360,87,14,9,0,23
10/05/15,2,27,542,360,17,17,1,0,18
10/05/15,2,28,8032,375,66,15,17,0,32
10/05/15,2,29,729,270,34,27,4,0,31
10/05/15,2,30,7625,270,24,23,10,0,33
10/05/15,3,1,738,305,97,31,3,4,38
10/05/15,3,2,726,315,111,27,7,0,34
10/05/15,3,3,996,220,49,18,7,0,25
10/05/15,3,4,996,220,48,20,8,1,29
10/05/15,3,5,8011,370,161,3,6,1,10
10/05/15,3,6,8038,370,155,0,2,6,8
10/05/15,3,7,7601,345,150,7,1,3,11
10/05/15,3,10,776,370,149,4,10,1,15
10/05/15,3,11,542,355,121,24,8,2,34
10/05/15,3,12,8032,350,102,15,26,1,42
10/05/15,3,13,542,350,77,40,11,0,51
10/05/15,3,14,8030,360,169,1,1,1,3
10/05/15,3,15,542,350,26,7,7,0,14
10/05/15,3,16,293,350,138,12,5,4,21
10/05/15,3,18,542,350,24,14,1,1,16
10/05/15,3,19,775,360,38,1,0,1,2
10/05/15,3,21,784,350,22,1,7,0,8
10/05/15,3,22,542,350,38,2,4,0,6
10/05/15,3,23,775,350,101,20,6,0,26
10/05/15,3,24,7652,360,33,19,0,1,20
10/05/15,3,25,715,375,26,1,8,0,9
10/05/15,3,26,542,360,73,24,8,0,32
10/05/15,3,27,542,360,3,1,0,0,1
10/05/15,3,28,8032,375,57,6,18,1,25
10/05/15,3,29,729,270,61,23,6,0,29
10/05/15,3,30,7625,270,48,28,9,0,37
10/06/15,1,1,738,305,96,23,5,17,45
10/06/15,1,2,726,315,118,13,7,3,23
10/06/15,1,3,996,220,67,15,8,0,23
10/06/15,1,4,996,220,64,17,9,0,26
10/06/15,1,5,8011,370,147,2,4,1,7
10/06/15,1,6,8038,370,166,1,0,1,2
10/06/15,1,7,7601,345,149,10,1,6,17
10/06/15,1,9,7601,350,97,4,5,4,13
10/06/15,1,10,776,370,154,4,7,0,11
10/06/15,1,11,542,355,127,30,6,0,36
10/06/15,1,12,8032,350,120,19,25,0,44
10/06/15,1,13,542,350,83,31,10,0,41
10/06/15,1,14,8030,360,165,1,1,0,2
10/06/15,1,15,542,350,123,21,12,0,33
10/06/15,1,16,293,350,120,13,6,4,23
10/06/15,1,17,747,370,154,7,10,1,18
10/06/15,1,18,542,350,67,15,7,2,24
10/06/15,1,19,775,360,150,5,11,0,16
10/06/15,1,20,542,350,9,9,2,11,22
10/06/15,1,21,784,350,69,4,19,0,23
10/06/15,1,22,542,350,112,9,13,0,22
10/06/15,1,23,775,350,93,27,9,0,36
10/06/15,1,24,7652,360,49,11,1,0,12
10/06/15,1,25,715,375,64,0,18,0,18
10/06/15,1,26,542,360,54,13,7,0,20
10/06/15,1,27,542,360,22,23,0,0,23
10/06/15,1,28,8032,375,79,4,20,1,25
10/06/15,1,29,729,270,51,18,21,0,39
10/06/15,1,30,7625,270,37,21,26,0,47
10/06/15,2,1,738,305,103,11,7,2,20
10/06/15,2,2,726,315,113,26,3,3,32
10/06/15,2,3,996,220,57,19,21,0,40
10/06/15,2,4,996,220,49,18,25,0,43
10/06/15,2,5,8011,370,153,2,6,1,9
10/06/15,2,6,8038,370,153,2,0,2,4
10/06/15,2,7,7601,345,145,7,1,3,11
10/06/15,2,8,7740,350,21,6,1,11,18
10/06/15,2,9,7601,350,22,3,2,1,6
10/06/15,2,10,776,370,141,1,6,1,8
10/06/15,2,11,542,355,105,14,8,1,23
10/06/15,2,12,8032,350,102,6,22,0,28
10/06/15,2,13,542,350,61,34,4,1,39
10/06/15,2,14,8030,360,68,12,1,1,14
10/06/15,2,15,542,350,60,12,7,0,19
10/06/15,2,16,293,350,121,21,6,0,27
10/06/15,2,17,747,370,161,4,6,3,13
10/06/15,2,19,775,360,121,8,7,0,15
10/06/15,2,20,542,350,32,8,19,5,32
10/06/15,2,21,784,350,64,2,14,0,16
10/06/15,2,22,542,350,75,12,13,0,25
10/06/15,2,23,775,350,72,27,4,0,31
10/06/15,2,24,7652,360,121,4,5,1,10
10/06/15,2,25,715,375,56,2,17,0,19
10/06/15,2,26,542,360,48,19,2,0,21
10/06/15,2,27,542,360,32,17,2,0,19
10/06/15,2,28,8032,375,60,9,25,0,34
10/06/15,2,29,729,270,37,19,20,0,39
10/06/15,2,30,7625,270,29,24,22,0,46
10/06/15,3,1,738,305,31,31,1,3,35
10/06/15,3,2,726,315,10,1,1,0,2
10/06/15,3,3,996,220,64,16,8,0,24
10/06/15,3,4,996,220,51,19,20,1,40
10/06/15,3,5,8011,370,147,5,4,2,11
10/06/15,3,6,8038,370,159,0,3,3,6
10/06/15,3,7,7601,345,145,14,0,0,14
10/06/15,3,10,776,370,143,5,12,0,17
10/06/15,3,11,542,355,124,23,11,0,34
10/06/15,3,12,8032,350,120,16,23,1,40
10/06/15,3,13,542,350,114,23,6,0,29
10/06/15,3,15,542,350,108,40,5,0,45
10/06/15,3,16,293,350,127,20,5,3,28
10/06/15,3,17,747,370,109,3,6,1,10
10/06/15,3,19,775,360,145,5,7,0,12
10/06/15,3,20,542,350,62,5,17,7,29
10/06/15,3,21,784,350,52,1,18,0,19
10/06/15,3,22,542,350,87,15,9,0,24
10/06/15,3,23,775,350,94,38,4,0,42
10/06/15,3,24,7652,360,109,6,3,4,13
10/06/15,3,25,715,375,37,1,14,0,15
10/06/15,3,26,542,360,73,24,8,0,32
10/06/15,3,27,542,360,69,51,5,0,56
10/06/15,3,28,8032,375,77,9,26,1,36
10/06/15,3,29,729,270,65,21,13,0,34
10/06/15,3,30,7625,270,71,17,5,0,22
10/07/15,1,1,738,305,54,86,1,8,95
10/07/15,1,3,996,220,79,12,10,0,22
10/07/15,1,4,996,220,19,5,3,0,8
10/07/15,1,5,8011,370,159,8,11,4,23
10/07/15,1,6,8038,370,19,1,0,1,2
10/07/15,1,7,7601,345,49,2,1,4,7
10/07/15,1,10,776,370,153,4,7,2,13
10/07/15,1,11,542,355,117,52,13,3,68
10/07/15,1,12,8032,350,120,16,38,2,56
10/07/15,1,13,542,350,111,26,8,2,36
10/07/15,1,14,8030,360,81,5,0,1,6
10/07/15,1,15,542,350,134,21,6,0,27
10/07/15,1,16,293,350,51,8,3,3,14
10/07/15,1,17,747,370,166,3,12,1,16
10/07/15,1,19,775,360,150,9,7,0,16
10/07/15,1,20,8040,350,58,8,37,3,48
10/07/15,1,21,784,350,71,3,23,0,26
10/07/15,1,22,542,350,50,3,5,0,8
10/07/15,1,23,775,350,74,34,5,0,39
10/07/15,1,24,7652,360,129,11,5,6,22
10/07/15,1,25,715,375,80,0,22,0,22
10/07/15,1,27,542,360,66,30,7,0,37
10/07/15,1,28,8032,375,87,8,23,0,31
10/07/15,1,29,729,270,42,20,5,0,25
10/07/15,1,30,7625,270,63,12,10,0,22
10/07/15,2,1,738,305,102,42,7,2,51
10/07/15,2,2,726,315,34,11,1,5,17
10/07/15,2,3,996,220,53,8,6,0,14
10/07/15,2,4,996,220,55,18,7,0,25
10/07/15,2,5,8011,370,165,5,5,1,11
10/07/15,2,10,776,370,161,5,4,1,10
10/07/15,2,11,542,355,115,30,7,0,37
10/07/15,2,12,8032,350,124,14,25,1,40
10/07/15,2,13,542,350,56,20,17,1,38
10/07/15,2,14,8030,360,163,1,1,0,2
10/07/15,2,15,542,350,75,21,5,0,26
10/07/15,2,17,747,370,138,9,8,1,18
10/07/15,2,18,490,350,90,8,3,1,12
10/07/15,2,19,775,360,101,4,12,0,16
10/07/15,2,20,8040,350,61,14,19,3,36
10/07/15,2,21,784,350,58,1,19,0,20
10/07/15,2,23,775,350,55,28,3,0,31
10/07/15,2,24,7652,360,13,8,3,3,14
10/07/15,2,25,715,375,56,1,13,0,14
10/07/15,2,27,542,360,61,25,2,0,27
10/07/15,2,28,8032,375,75,11,19,1,31
10/07/15,2,29,729,270,38,19,4,0,23
10/07/15,2,30,7625,270,57,19,6,0,25
10/07/15,3,1,738,305,102,31,11,3,45
10/07/15,3,2,726,315,107,21,8,4,33
10/07/15,3,3,996,220,29,10,5,4,19
10/07/15,3,4,996,220,52,19,6,0,25
10/07/15,3,5,8011,370,2,0,0,1,1
10/07/15,3,9,7601,350,51,37,3,10,50
10/07/15,3,10,776,370,149,8,11,2,21
10/07/15,3,11,542,355,121,28,10,2,40
10/07/15,3,12,8032,350,105,11,23,2,36
10/07/15,3,13,542,350,119,17,14,1,32
10/07/15,3,14,8030,360,158,3,3,1,7
10/07/15,3,15,542,350,56,9,4,0,13
10/07/15,3,17,747,370,107,12,3,3,18
10/07/15,3,18,490,350,35,12,4,1,17
10/07/15,3,19,775,360,93,9,10,0,19
10/07/15,3,20,8040,350,60,3,11,6,20
10/07/15,3,23,775,350,67,22,8,0,30
10/07/15,3,24,7652,360,97,4,4,3,11
10/07/15,3,25,715,375,87,0,18,0,18
10/07/15,3,27,542,360,69,15,10,0,25
10/07/15,3,28,8032,375,70,4,8,1,13
10/07/15,3,29,729,270,56,20,4,0,24
10/07/15,3,30,7625,270,62,16,5,0,21
10/08/15,1,1,738,305,100,25,7,4,36
10/08/15,1,2,726,315,112,19,6,4,29
10/08/15,1,3,996,220,69,12,9,0,21
10/08/15,1,4,996,220,55,15,12,0,27
10/08/15,1,7,783,345,38,37,9,18,64
10/08/15,1,9,8003,350,100,42,4,16,62
10/08/15,1,10,776,370,146,14,4,1,19
10/08/15,1,11,542,355,106,39,9,4,52
10/08/15,1,12,8032,350,107,15,29,0,44
10/08/15,1,13,542,350,91,16,15,0,31
10/08/15,1,14,8030,360,168,1,1,0,2
10/08/15,1,15,542,350,3,0,0,0,0
10/08/15,1,17,747,370,165,5,5,2,12
10/08/15,1,18,490,350,123,15,8,1,24
10/08/15,1,19,775,360,360,6,8,0,14
10/08/15,1,20,8040,350,350,19,19,6,44
10/08/15,1,23,775,350,43,44,3,0,47
10/08/15,1,24,7652,360,91,3,5,2,10
10/08/15,1,25,715,375,111,0,23,0,23
10/08/15,1,27,542,360,83,30,9,0,39
10/08/15,1,28,8032,375,71,8,17,0,25
10/08/15,1,29,729,270,45,15,18,0,33
10/08/15,1,30,7625,270,66,10,10,0,20
10/08/15,2,1,738,305,120,22,7,3,32
10/08/15,2,2,726,315,106,24,10,6,40
10/08/15,2,3,996,220,66,10,11,0,21
10/08/15,2,4,996,220,53,11,14,0,25
10/08/15,2,9,8003,350,82,48,0,2,50
10/08/15,2,10,776,370,31,1,5,2,8
10/08/15,2,12,8032,350,116,16,29,0,45
10/08/15,2,13,542,350,113,17,5,0,22
10/08/15,2,14,8030,360,151,8,1,0,9
10/08/15,2,15,542,350,90,22,5,0,27
10/08/15,2,16,285,350,81,13,6,8,27
10/08/15,2,17,747,370,135,0,9,2,11
10/08/15,2,18,490,350,130,5,10,2,17
10/08/15,2,19,775,360,93,7,4,0,11
10/08/15,2,20,8040,350,89,2,24,5,31
10/08/15,2,22,542,350,44,12,12,0,24
10/08/15,2,23,775,350,61,31,1,0,32
10/08/15,2,25,715,375,83,0,15,0,15
10/08/15,2,27,542,360,47,16,7,0,23
10/08/15,2,28,8032,375,73,14,29,2,45
10/08/15,2,29,729,270,36,10,27,0,37
10/08/15,2,30,7625,270,55,21,12,0,33
10/08/15,3,1,738,305,106,17,13,6,36
10/08/15,3,2,726,315,124,22,3,1,26
10/08/15,3,3,996,220,72,13,10,1,24
10/08/15,3,4,996,220,52,15,13,0,28
10/08/15,3,9,8003,350,111,29,12,11,52
10/08/15,3,10,776,370,6,0,0,0,0
10/08/15,3,13,542,350,91,18,19,2,39
10/08/15,3,14,8030,360,165,2,4,0,6
10/08/15,3,15,542,350,70,7,13,0,20
10/08/15,3,16,285,350,129,14,9,2,25
10/08/15,3,17,747,370,78,0,5,1,6
10/08/15,3,18,490,350,70,7,3,4,14
10/08/15,3,19,775,360,73,5,8,0,13
10/08/15,3,20,8040,350,2,3,26,2,31
10/08/15,3,22,542,350,35,12,6,0,18
10/08/15,3,23,775,350,34,21,5,0,26
10/08/15,3,24,7652,360,26,0,6,9,15
10/08/15,3,25,715,375,89,1,11,0,12
10/08/15,3,27,542,360,55,14,7,0,21
10/08/15,3,28,8032,375,35,12,13,1,26
10/08/15,3,29,729,270,26,9,17,0,26
10/08/15,3,30,7625,270,44,20,10,0,30
10/09/15,1,1,738,305,122,17,3,7,27
10/09/15,1,2,726,315,119,26,6,4,36
10/09/15,1,3,996,220,72,12,10,0,22
10/09/15,1,4,996,220,72,15,8,0,23
10/09/15,1,9,8003,350,117,16,3,6,25
10/09/15,1,10,776,370,145,9,8,3,20
10/09/15,1,13,542,350,103,18,11,0,29
10/09/15,1,14,8030,360,161,5,2,2,9
10/09/15,1,15,542,350,120,30,9,0,39
10/09/15,1,16,285,350,135,13,11,4,28
10/09/15,1,17,747,370,117,9,4,9,22
10/09/15,1,18,490,350,129,15,4,2,21
10/09/15,1,19,775,360,139,7,12,0,19
10/09/15,1,20,8040,350,67,2,27,6,35
10/09/15,1,22,542,350,51,13,15,0,28
10/09/15,1,23,775,350,69,39,3,0,42
10/09/15,1,24,7652,360,127,8,5,5,18
10/09/15,1,25,715,375,83,0,22,0,22
10/09/15,1,26,542,360,16,8,1,0,9
10/09/15,1,27,542,360,83,29,5,0,34
10/09/15,1,28,8032,375,61,22,22,0,44
10/09/15,1,29,729,270,18,6,3,0,9
10/09/15,1,30,7625,270,81,20,6,0,26
10/09/15,2,1,738,305,121,19,12,3,34
10/09/15,2,2,726,315,134,16,4,2,22
10/09/15,2,3,996,220,48,10,8,0,18
10/09/15,2,4,996,220,20,5,6,0,11
10/09/15,2,7,783,345,76,14,8,3,25
10/09/15,2,9,8003,350,101,16,3,16,35
10/09/15,2,10,776,370,155,6,5,1,12
10/09/15,2,11,542,355,6,7,19,0,26
10/09/15,2,13,542,350,68,12,18,3,33
10/09/15,2,14,8030,360,166,4,0,1,5
10/09/15,2,15,542,350,34,6,5,0,11
10/09/15,2,16,285,350,148,8,5,5,18
10/09/15,2,18,490,350,122,6,5,0,11
10/09/15,2,19,775,360,125,12,8,0,20
10/09/15,2,20,8040,350,63,7,21,5,33
10/09/15,2,22,542,350,56,11,11,0,22
10/09/15,2,23,775,350,61,15,7,0,22
10/09/15,2,24,7652,360,79,7,12,7,26
10/09/15,2,25,715,375,71,1,15,0,16
10/09/15,2,26,542,360,76,11,14,0,25
10/09/15,2,27,542,360,62,27,2,0,29
10/09/15,2,28,8032,375,46,27,16,0,43
10/09/15,2,29,729,270,21,12,4,0,16
10/09/15,2,30,7625,270,50,17,5,0,22
10/09/15,3,1,738,305,104,32,4,3,39
10/09/15,3,2,726,315,120,29,7,2,38
10/09/15,3,3,996,220,11,0,0,0,0
10/09/15,3,4,996,220,18,0,0,0,0
10/09/15,3,7,783,345,130,33,8,1,42
10/09/15,3,9,8003,350,25,21,1,21,43
10/09/15,3,10,776,370,158,9,3,0,12
10/09/15,3,11,542,355,38,5,30,3,38
10/09/15,3,14,8030,360,167,1,0,4,5
10/09/15,3,16,285,350,123,26,9,5,40
10/09/15,3,22,542,350,29,5,9,0,14
10/09/15,3,23,775,350,21,17,2,0,19
10/09/15,3,24,7652,360,40,9,0,3,12
10/09/15,3,25,715,375,39,0,6,0,6
10/09/15,3,26,542,360,32,5,18,0,23
10/09/15,3,27,542,360,68,27,9,0,36
10/09/15,3,28,8032,375,39,9,15,1,25
10/09/15,3,29,729,270,34,17,6,1,24
10/09/15,3,30,7625,270,45,21,5,1,27
10/12/15,1,1,738,305,108,16,10,4,30
10/12/15,1,2,726,315,133,23,4,3,30
10/12/15,1,3,996,220,86,5,6,0,11
10/12/15,1,4,996,220,70,12,8,0,20
10/12/15,1,7,783,345,108,13,3,4,20
10/12/15,1,10,776,370,67,2,4,2,8
10/12/15,1,11,8032,355,80,12,54,0,66
10/12/15,1,12,8032,350,62,26,36,6,68
10/12/15,1,14,8030,360,166,2,1,0,3
10/12/15,1,15,542,350,62,2,6,0,8
10/12/15,1,16,285,350,136,20,4,7,31
10/12/15,1,17,747,370,117,9,4,9,22
10/12/15,1,18,490,350,90,14,4,0,18
10/12/15,1,19,775,360,166,10,9,0,19
10/12/15,1,20,8040,350,78,11,12,5,28
10/12/15,1,22,542,350,82,9,27,0,36
10/12/15,1,23,775,350,73,17,2,0,19
10/12/15,1,24,7652,360,80,9,9,2,20
10/12/15,1,25,715,375,93,0,20,0,20
10/12/15,1,26,542,360,107,15,15,0,30
10/12/15,1,27,542,360,68,34,9,0,43
10/12/15,1,28,8032,375,80,9,22,2,33
10/12/15,1,29,729,270,67,17,10,0,27
10/12/15,1,30,7625,270,68,18,12,0,30
10/12/15,2,1,738,305,105,17,14,1,32
10/12/15,2,2,726,315,47,18,0,6,24
10/12/15,2,3,996,220,55,15,12,0,27
10/12/15,2,4,996,220,54,17,10,0,27
10/12/15,2,7,783,345,132,13,6,1,20
10/12/15,2,10,776,370,116,4,5,4,13
10/12/15,2,11,8032,355,92,18,52,0,70
10/12/15,2,12,8032,350,95,12,60,2,74
10/12/15,2,13,542,350,15,3,3,4,10
10/12/15,2,14,8030,360,160,3,3,1,7
10/12/15,2,15,542,350,32,22,6,0,28
10/12/15,2,16,285,350,129,30,6,5,41
10/12/15,2,18,490,350,80,18,6,7,31
10/12/15,2,19,775,360,112,9,9,0,18
10/12/15,2,20,8040,350,75,15,18,5,38
10/12/15,2,22,542,350,57,16,13,0,29
10/12/15,2,23,775,350,53,23,8,0,31
10/12/15,2,24,7652,360,88,11,10,0,21
10/12/15,2,25,715,159,55,0,17,0,17
10/12/15,2,26,542,360,111,16,7,0,23
10/12/15,2,27,542,360,60,19,3,0,22
10/12/15,2,28,8032,375,76,8,23,2,33
10/12/15,2,29,729,270,44,23,5,0,28
10/12/15,2,30,7625,270,34,7,4,0,11
10/12/15,3,1,738,305,117,20,6,2,28
10/12/15,3,3,996,220,72,10,3,0,13
10/12/15,3,4,996,220,64,11,12,0,23
10/12/15,3,7,783,345,114,28,22,1,51
10/12/15,3,8,715,350,119,1,12,12,25
10/12/15,3,10,776,370,159,9,4,0,13
10/12/15,3,11,8032,355,58,7,62,4,73
10/12/15,3,12,8032,350,114,33,26,2,61
10/12/15,3,13,542,350,109,20,15,2,37
10/12/15,3,14,8030,360,157,6,3,2,11
10/12/15,3,15,542,350,23,7,3,0,10
10/12/15,3,16,285,350,134,30,5,4,39
10/12/15,3,18,490,350,103,10,9,1,20
10/12/15,3,19,775,360,23,17,2,1,20
10/12/15,3,20,8040,350,38,4,7,1,12
10/12/15,3,22,542,350,67,15,16,0,31
10/12/15,3,23,775,350,40,28,1,0,29
10/12/15,3,24,7652,360,78,2,6,4,12
10/12/15,3,25,715,375,37,0,18,0,18
10/12/15,3,26,542,360,86,24,12,0,36
10/12/15,3,27,542,360,73,42,0,0,42
10/12/15,3,28,8032,375,58,11,19,1,31
10/12/15,3,29,729,270,65,20,1,0,21
10/12/15,3,30,7625,270,65,15,4,0,19
10/13/15,1,1,738,305,112,27,6,1,34
10/13/15,1,3,996,220,35,12,3,0,15
10/13/15,1,4,996,220,33,10,4,1,15
10/13/15,1,5,8035,370,51,9,7,10,26
10/13/15,1,7,783,345,137,17,5,2,24
10/13/15,1,8,715,350,135,0,9,4,13
10/13/15,1,10,776,370,155,11,2,0,13
10/13/15,1,11,8032,355,114,21,15,4,40
10/13/15,1,12,8032,350,112,21,23,1,45
10/13/15,1,13,542,350,108,12,9,4,25
10/13/15,1,14,8030,360,131,7,2,2,11
10/13/15,1,15,542,350,89,20,14,0,34
10/13/15,1,16,285,350,5,1,0,1,2
10/13/15,1,18,490,350,148,7,8,1,16
10/13/15,1,20,8040,350,92,9,16,3,28
10/13/15,1,22,542,350,85,23,3,0,26
10/13/15,1,23,775,350,63,7,23,0,30
10/13/15,1,24,7652,360,131,14,6,3,23
10/13/15,1,25,715,375,62,0,27,0,27
10/13/15,1,26,542,360,88,16,8,0,24
10/13/15,1,27,542,360,59,27,4,0,31
10/13/15,1,28,8032,375,75,7,20,0,27
10/13/15,1,29,729,270,76,16,6,0,22
10/13/15,1,30,7625,270,55,15,7,0,22
10/13/15,2,1,738,305,118,23,9,4,36
10/13/15,2,3,996,220,47,13,5,0,18
10/13/15,2,4,996,220,33,14,4,0,18
10/13/15,2,5,8035,370,138,2,12,0,14
10/13/15,2,7,783,345,132,15,4,0,19
10/13/15,2,8,715,350,152,0,16,0,16
10/13/15,2,10,776,370,160,4,4,2,10
10/13/15,2,11,8032,355,131,14,20,0,34
10/13/15,2,12,8032,350,124,11,28,2,41
10/13/15,2,13,542,350,89,23,9,0,32
10/13/15,2,14,8030,360,151,15,2,1,18
10/13/15,2,15,542,350,89,13,12,0,25
10/13/15,2,18,490,350,110,11,7,1,19
10/13/15,2,20,8040,350,81,8,25,4,37
10/13/15,2,22,542,350,63,29,3,0,32
10/13/15,2,23,775,350,63,5,24,0,29
10/13/15,2,24,7652,360,103,77,0,0,77
10/13/15,2,25,715,375,50,0,19,0,19
10/13/15,2,26,542,360,89,17,5,0,22
10/13/15,2,27,542,360,38,16,3,0,19
10/13/15,2,28,8032,375,77,11,25,0,36
10/13/15,2,29,729,270,72,17,5,0,22
10/13/15,2,30,7625,270,80,13,8,0,21
10/13/15,3,1,738,305,97,23,13,2,38
10/13/15,3,2,726,315,77,43,25,10,78
10/13/15,3,3,996,220,47,0,18,3,21
10/13/15,3,5,8035,370,134,0,0,0,0
10/13/15,3,7,783,345,139,10,6,0,16
10/13/15,3,8,715,350,168,0,9,0,9
10/13/15,3,10,776,370,151,11,2,0,13
10/13/15,3,11,8032,355,90,14,48,1,63
10/13/15,3,12,8032,350,126,12,24,0,36
10/13/15,3,13,542,350,132,14,5,1,20
10/13/15,3,14,8030,360,158,6,2,1,9
10/13/15,3,15,542,350,27,6,5,0,11
10/13/15,3,18,490,350,94,12,7,0,19
10/13/15,3,19,775,360,23,17,2,0,19
10/13/15,3,20,8040,350,49,8,8,1,17
10/13/15,3,22,542,350,60,10,14,0,24
10/13/15,3,23,775,350,64,36,4,0,40
10/13/15,3,24,7652,360,77,3,5,2,10
10/13/15,3,25,715,375,14,0,5,0,5
10/13/15,3,26,542,360,99,10,10,0,20
10/13/15,3,27,542,360,18,11,0,0,11
10/13/15,3,28,8032,375,97,3,24,1,28
10/13/15,3,29,729,270,84,20,7,0,27
10/13/15,3,30,7625,270,83,15,6,0,21
10/14/15,1,1,738,305,111,29,4,2,35
10/14/15,1,2,726,315,101,45,11,5,61
10/14/15,1,3,996,220,8,4,2,0,6
10/14/15,1,4,5302,220,36,8,1,0,9
10/14/15,1,5,8035,370,132,2,22,1,25
10/14/15,1,7,783,345,134,15,8,3,26
10/14/15,1,8,715,350,156,1,13,0,14
10/14/15,1,10,776,370,159,12,0,0,12
10/14/15,1,11,8032,355,126,14,24,3,41
10/14/15,1,12,8032,350,119,18,18,4,40
10/14/15,1,13,542,350,126,14,6,0,20
10/14/15,1,14,8030,360,159,7,1,0,8
10/14/15,1,15,542,350,67,27,11,0,38
10/14/15,1,16,293,350,3,0,3,5,8
10/14/15,1,18,490,350,143,7,8,3,18
10/14/15,1,19,775,360,94,34,8,0,42
10/14/15,1,20,8040,350,80,21,17,0,38
10/14/15,1,22,542,350,66,11,18,0,29
10/14/15,1,23,775,350,69,40,6,0,46
10/14/15,1,24,7652,360,139,10,3,0,13
10/14/15,1,25,715,375,129,3,17,0,20
10/14/15,1,26,542,360,100,21,4,0,25
10/14/15,1,27,542,360,69,42,4,0,46
10/14/15,1,28,8032,375,32,3,11,2,16
10/14/15,1,29,729,270,78,8,6,0,14
10/14/15,1,30,7625,270,58,21,9,0,30
10/14/15,2,1,738,305,102,14,10,5,29
10/14/15,2,2,726,315,100,30,14,5,49
10/14/15,2,3,996,220,72,18,6,0,24
10/14/15,2,4,5302,220,62,22,3,0,25
10/14/15,2,5,8035,370,106,1,28,3,32
10/14/15,2,6,542,370,27,26,4,0,30
10/14/15,2,7,783,345,135,19,6,0,25
10/14/15,2,8,715,350,168,1,7,1,9
10/14/15,2,10,776,370,157,12,1,0,13
10/14/15,2,11,8032,355,125,16,14,1,31
10/14/15,2,12,8032,350,139,10,8,0,18
10/14/15,2,13,542,350,92,8,5,0,13
10/14/15,2,14,8030,360,139,7,0,1,8
10/14/15,2,15,542,350,74,18,9,0,27
10/14/15,2,16,293,350,150,16,4,5,25
10/14/15,2,18,490,350,103,12,9,0,21
10/14/15,2,19,775,360,95,22,3,0,25
10/14/15,2,20,8040,350,53,6,24,1,31
10/14/15,2,22,542,350,54,11,17,0,28
10/14/15,2,23,775,350,46,38,3,0,41
10/14/15,2,24,7652,360,124,9,6,1,16
10/14/15,2,25,715,375,116,2,13,0,15
10/14/15,2,26,542,360,105,28,4,0,32
10/14/15,2,27,542,360,28,31,4,0,35
10/14/15,2,29,729,270,66,18,9,0,27
10/14/15,2,30,7625,270,58,25,7,0,32
10/14/15,3,1,738,305,114,17,12,5,34
10/14/15,3,2,726,315,88,32,26,2,60
10/14/15,3,3,996,220,84,20,7,0,27
10/14/15,3,4,5302,220,66,21,4,1,26
10/14/15,3,5,8035,370,136,5,22,0,27
10/14/15,3,7,783,345,107,10,14,1,25
10/14/15,3,8,715,350,167,1,6,1,8
10/14/15,3,10,776,370,151,8,3,2,13
10/14/15,3,11,8032,355,128,17,16,1,34
10/14/15,3,12,8032,350,133,8,15,3,26
10/14/15,3,13,542,350,138,7,7,3,17
10/14/15,3,14,8030,360,165,1,3,0,4
10/14/15,3,15,542,350,38,6,7,0,13
10/14/15,3,16,293,350,119,27,6,3,36
10/14/15,3,18,490,350,118,14,1,1,16
10/14/15,3,19,775,360,6,0,0,0,0
10/14/15,3,20,8040,350,35,1,10,2,13
10/14/15,3,21,7697,350,34,13,2,0,15
10/14/15,3,22,542,350,75,14,15,0,29
10/14/15,3,23,775,350,64,44,0,0,44
10/14/15,3,24,7652,360,92,6,3,2,11
10/14/15,3,25,715,375,41,                ,4,0,4
10/14/15,3,26,542,360,7,11,7,0,18
10/14/15,3,27,542,360,59,40,6,0,46
10/14/15,3,29,729,270,87,21,8,0,29
10/14/15,3,30,7625,270,75,23,5,0,28
10/15/15,1,1,738,305,92,19,7,7,33
10/15/15,1,2,726,315,102,33,9,1,43
10/15/15,1,3,996,220,58,15,8,0,23
10/15/15,1,4,5302,220,70,13,2,0,15
10/15/15,1,5,8035,370,136,0,14,3,17
10/15/15,1,6,542,370,19,8,3,3,14
10/15/15,1,7,783,345,116,16,5,2,23
10/15/15,1,8,715,350,141,1,12,0,13
10/15/15,1,10,776,370,153,8,3,0,11
10/15/15,1,11,8032,355,107,18,18,1,37
10/15/15,1,12,8032,350,127,9,21,2,32
10/15/15,1,13,542,350,122,12,3,0,15
10/15/15,1,14,8030,360,140,8,2,3,13
10/15/15,1,15,542,350,107,18,7,0,25
10/15/15,1,16,293,350,116,27,13,6,46
10/15/15,1,17,747,370,18,2,9,3,14
10/15/15,1,18,490,350,112,18,8,1,27
10/15/15,1,20,8040,350,69,14,8,1,23
10/15/15,1,21,7697,350,12,11,0,0,11
10/15/15,1,22,542,350,42,10,18,0,28
10/15/15,1,23,775,350,23,35,1,0,36
10/15/15,1,24,7652,360,109,6,6,3,15
10/15/15,1,25,715,375,75,0,19,0,19
10/15/15,1,26,542,360,102,16,10,0,26
10/15/15,1,27,542,360,75,22,7,0,29
10/15/15,1,28,8032,375,30,9,7,4,20
10/15/15,1,29,729,270,79,12,3,0,15
10/15/15,1,30,7625,270,60,12,15,0,27
10/15/15,2,2,726,315,124,16,9,2,27
10/15/15,2,3,996,220,61,14,7,0,21
10/15/15,2,4,5302,220,62,17,1,0,18
10/15/15,2,5,8035,370,132,3,21,1,25
10/15/15,2,7,783,345,5,0,4,0,4
10/15/15,2,8,715,350,158,0,9,2,11
10/15/15,2,9,308,350,5,2,6,4,12
10/15/15,2,10,776,370,160,5,5,1,11
10/15/15,2,11,8032,355,130,22,16,0,38
10/15/15,2,12,8032,350,118,23,34,0,57
10/15/15,2,13,542,350,123,15,5,1,21
10/15/15,2,14,8030,360,129,8,1,1,10
10/15/15,2,15,542,350,68,11,16,0,27
10/15/15,2,16,293,350,128,29,5,2,36
10/15/15,2,17,747,370,125,14,12,0,26
10/15/15,2,18,490,350,100,33,3,0,36
10/15/15,2,20,8040,350,54,17,10,5,32
10/15/15,2,21,7697,350,49,34,2,0,36
10/15/15,2,22,542,350,43,10,9,0,19
10/15/15,2,23,775,350,19,22,4,0,26
10/15/15,2,24,7652,360,81,6,9,1,16
10/15/15,2,25,715,375,29,0,20,0,20
10/15/15,2,26,542,360,73,15,3,0,18
10/15/15,2,27,542,360,56,11,8,0,19
10/15/15,2,28,8032,375,55,9,17,0,26
10/15/15,2,29,729,270,58,18,5,0,23
10/15/15,2,30,7625,270,40,23,5,0,28
10/15/15,3,1,738,305,75,21,15,17,53
10/15/15,3,2,726,315,118,21,4,1,26
10/15/15,3,3,996,220,79,15,6,0,21
10/15/15,3,4,5302,220,62,20,1,0,21
10/15/15,3,5,8035,370,117,3,30,1,34
10/15/15,3,8,715,350,150,0,10,0,10
10/15/15,3,9,308,350,35,8,3,0,11
10/15/15,3,10,776,370,110,5,5,0,10
10/15/15,3,11,8032,355,121,25,9,0,34
10/15/15,3,12,8032,350,114,13,26,3,42
10/15/15,3,13,542,350,133,8,4,0,12
10/15/15,3,14,8030,360,127,1,4,2,7
10/15/15,3,15,542,350,23,13,3,0,16
10/15/15,3,16,293,350,109,23,7,0,30
10/15/15,3,17,747,370,100,7,1,2,10
10/15/15,3,18,490,350,37,23,1,1,25
10/15/15,3,21,7697,350,42,16,3,0,19
10/15/15,3,22,542,350,29,7,15,0,22
10/15/15,3,23,775,350,25,34,2,2,38
10/15/15,3,24,7652,360,97,6,2,0,8
10/15/15,3,25,715,375,24,2,12,0,14
10/15/15,3,26,542,360,59,20,4,0,24
10/15/15,3,27,542,360,57,23,0,0,23
10/15/15,3,28,8032,375,63,10,13,0,23
10/15/15,3,29,729,270,58,20,6,0,26
10/15/15,3,30,7625,270,47,21,8,0,29
10/16/15,1,1,738,305,111,18,8,1,27
10/16/15,1,2,726,315,111,30,9,0,39
10/16/15,1,3,996,220,72,12,9,0,21
10/16/15,1,4,5302,220,65,21,3,0,24
10/16/15,1,5,8035,370,139,3,22,1,26
10/16/15,1,7,783,345,73,15,5,5,25
10/16/15,1,8,715,350,170,1,9,2,12
10/16/15,1,11,8032,355,145,17,7,2,26
10/16/15,1,12,8032,350,43,11,8,3,22
10/16/15,1,13,542,350,119,10,8,1,19
10/16/15,1,15,542,350,115,12,23,0,35
10/16/15,1,16,293,350,114,29,13,3,45
10/16/15,1,17,747,370,182,2,4,1,7
10/16/15,1,20,8040,350,37,4,3,3,10
10/16/15,1,21,7697,350,40,28,7,0,35
10/16/15,1,22,542,350,81,16,14,0,30
10/16/15,1,24,7652,360,106,10,5,1,16
10/16/15,1,25,715,375,132,1,15,0,16
10/16/15,1,26,542,360,102,27,5,0,32
10/16/15,1,27,542,360,71,26,5,0,31
10/16/15,1,28,8032,375,55,6,26,0,32
10/16/15,1,29,729,270,48,23,7,0,30
10/16/15,1,30,7625,270,32,18,28,0,46
10/16/15,2,1,738,305,103,10,10,6,26
10/16/15,2,2,726,315,112,18,26,3,47
10/16/15,2,3,996,220,51,10,6,1,17
10/16/15,2,4,5302,220,58,19,5,0,24
10/16/15,2,5,8035,370,130,3,19,0,22
10/16/15,2,7,783,345,124,20,9,1,30
10/16/15,2,8,715,350,157,1,2,0,3
10/16/15,2,9,308,350,30,24,19,5,48
10/16/15,2,11,8032,355,126,19,14,0,33
10/16/15,2,12,8032,350,115,32,7,0,39
10/16/15,2,13,542,350,116,32,7,0,39
10/16/15,2,15,542,350,81,11,12,0,23
10/16/15,2,17,747,370,152,8,5,1,14
10/16/15,2,20,8040,350,113,9,9,5,23
10/16/15,2,21,7697,350,59,36,1,0,37
10/16/15,2,22,542,350,52,16,11,0,27
10/16/15,2,24,7652,360,111,6,6,1,13
10/16/15,2,25,715,375,97,15,1,0,16
10/16/15,2,26,542,360,70,21,4,0,25
10/16/15,2,27,542,360,18,15,3,0,18
10/16/15,2,28,8032,375,66,10,20,0,30
10/16/15,2,29,729,270,24,17,6,0,23
10/16/15,2,30,7625,270,33,15,20,0,35
10/16/15,3,1,738,305,104,32,10,2,44
10/16/15,3,2,726,315,108,38,13,2,53
10/16/15,3,3,996,220,10,3,4,1,8
10/16/15,3,4,5302,220,65,17,4,0,21
10/16/15,3,5,8035,370,125,4,20,4,28
10/16/15,3,7,783,345,143,11,8,1,20
10/16/15,3,8,715,350,155,0,0,0,0
10/16/15,3,11,8032,355,132,11,12,2,25
10/16/15,3,13,542,350,135,8,0,0,8
10/16/15,3,15,542,350,94,16,12,0,28
10/16/15,3,16,293,350,121,18,8,3,29
10/16/15,3,22,542,350,49,12,14,0,26
10/16/15,3,24,7652,360,57,5,5,1,11
10/16/15,3,26,542,360,84,24,5,6,35
10/16/15,3,27,542,360,19,24,0,0,24
10/16/15,3,28,8032,375,66,10,25,1,36
10/16/15,3,29,729,270,33,16,9,1,26
10/16/15,3,30,7625,270,43,17,19,1,37
10/19/15,1,1,738,305,124,15,9,11,35
10/19/15,1,2,726,315,119,31,18,3,52
10/19/15,1,4,996,220,62,18,3,0,21
10/19/15,1,5,8035,370,139,2,25,2,29
10/19/15,1,7,783,345,141,16,13,1,30
10/19/15,1,8,715,350,67,1,13,4,18
10/19/15,1,10,776,370,10,1,2,4,7
10/19/15,1,11,8032,355,147,12,13,0,25
10/19/15,1,13,542,350,129,11,9,2,22
10/19/15,1,15,542,350,113,30,13,0,43
10/19/15,1,16,285,350,130,26,9,4,39
10/19/15,1,17,747,370,173,3,5,2,10
10/19/15,1,20,8040,350,129,9,7,0,16
10/19/15,1,21,7697,350,51,27,5,0,32
10/19/15,1,22,542,350,57,16,18,0,34
10/19/15,1,23,775,350,29,24,1,0,25
10/19/15,1,24,7652,360,52,12,4,0,16
10/19/15,1,25,715,375,135,2,23,0,25
10/19/15,1,26,542,360,78,15,8,0,23
10/19/15,1,27,542,360,4,3,0,0,3
10/19/15,1,28,8032,375,65,9,26,0,35
10/19/15,1,29,729,270,21,9,2,0,11
10/19/15,1,30,7625,270,35,23,12,0,35
10/19/15,2,1,738,305,126,9,13,2,24
10/19/15,2,2,726,315,119,20,11,1,32
10/19/15,2,4,996,220,70,20,5,0,25
10/19/15,2,5,8035,370,125,1,22,1,24
10/19/15,2,7,783,345,131,16,12,0,28
10/19/15,2,8,715,350,142,1,16,0,17
10/19/15,2,10,776,370,141,3,5,1,9
10/19/15,2,11,8032,355,113,12,9,0,21
10/19/15,2,12,8032,350,106,9,12,3,24
10/19/15,2,13,542,350,128,10,10,0,20
10/19/15,2,15,542,350,76,20,14,0,34
10/19/15,2,16,285,350,109,18,10,2,30
10/19/15,2,17,747,370,122,16,5,13,34
10/19/15,2,20,8040,350,92,6,17,6,29
10/19/15,2,21,7697,350,47,0,0,0,0
10/19/15,2,22,542,350,34,7,20,0,27
10/19/15,2,23,775,350,42,34,1,0,35
10/19/15,2,25,715,159,101,2,13,0,15
10/19/15,2,26,542,360,55,10,6,0,16
10/19/15,2,28,8032,375,72,17,22,0,39
10/19/15,2,29,729,270,38,12,4,1,17
10/19/15,2,30,7625,270,31,22,10,0,32
10/19/15,3,1,738,305,116,8,18,5,31
10/19/15,3,2,726,315,112,20,19,1,40
10/19/15,3,4,996,220,71,29,4,1,34
10/19/15,3,5,8035,370,117,5,22,0,27
10/19/15,3,7,783,345,133,18,0,3,21
10/19/15,3,8,715,350,152,2,14,0,16
10/19/15,3,10,776,370,152,3,5,1,9
10/19/15,3,11,8032,355,92,6,16,2,24
10/19/15,3,12,8032,350,133,12,7,1,20
10/19/15,3,13,542,350,129,13,12,3,28
10/19/15,3,15,542,350,35,6,8,0,14
10/19/15,3,16,285,350,109,17,7,6,30
10/19/15,3,17,747,370,60,21,1,1,23
10/19/15,3,20,8040,350,111,15,5,2,22
10/19/15,3,21,7697,350,22,13,1,0,14
10/19/15,3,22,542,350,78,15,15,0,30
10/19/15,3,25,715,375,55,5,2,0,7
10/19/15,3,29,729,270,70,17,5,0,22
10/19/15,3,30,7625,270,48,23,11,0,34
10/20/15,1,1,738,305,123,12,11,5,28
10/20/15,1,2,726,315,16,14,1,5,20
10/20/15,1,3,996,220,63,18,12,0,30
10/20/15,1,4,996,220,79,12,1,0,13
10/20/15,1,7,783,345,134,15,15,2,32
10/20/15,1,8,715,350,152,0,12,4,16
10/20/15,1,10,776,370,135,4,6,5,15
10/20/15,1,12,8032,350,140,18,18,2,38
10/20/15,1,13,542,350,140,4,9,4,17
10/20/15,1,15,542,350,116,26,20,0,46
10/20/15,1,16,285,350,137,37,7,4,48
10/20/15,1,17,747,370,186,3,3,6,12
10/20/15,1,18,490,350,77,5,2,7,14
10/20/15,1,20,8040,350,148,6,2,4,12
10/20/15,1,21,7697,350,56,55,4,0,59
10/20/15,1,22,542,350,75,23,15,0,38
10/20/15,1,24,7652,360,84,9,10,9,28
10/20/15,1,25,715,375,108,2,23,0,25
10/20/15,1,28,8032,375,27,2,4,28,34
10/20/15,1,29,729,270,39,29,12,0,41
10/20/15,1,30,7625,270,78,15,3,0,18
10/20/15,2,1,738,305,132,17,7,1,25
10/20/15,2,2,726,315,23,13,6,5,24
10/20/15,2,3,996,220,87,20,10,1,31
10/20/15,2,4,996,220,77,14,6,0,20
10/20/15,2,7,783,345,142,18,5,0,23
10/20/15,2,8,715,350,147,0,20,0,20
10/20/15,2,10,776,370,156,1,5,1,7
10/20/15,2,12,8032,350,148,10,12,0,22
10/20/15,2,13,542,350,121,12,6,0,18
10/20/15,2,15,542,350,81,16,16,0,32
10/20/15,2,17,747,370,164,5,5,2,12
10/20/15,2,18,490,350,73,6,1,0,7
10/20/15,2,20,8040,350,96,10,4,21,35
10/20/15,2,21,7697,350,42,29,1,0,30
10/20/15,2,22,542,350,43,19,7,0,26
10/20/15,2,24,7652,360,66,13,19,3,35
10/20/15,2,25,715,375,87,3,16,0,19
10/20/15,2,28,8032,375,54,6,19,2,27
10/20/15,2,29,729,270,46,20,8,0,28
10/20/15,2,30,7625,270,24,6,1,0,7
10/20/15,3,1,738,305,125,3,11,3,17
10/20/15,3,3,996,220,82,19,11,0,30
10/20/15,3,4,996,220,80,15,8,1,24
10/20/15,3,7,783,345,141,19,8,1,28
10/20/15,3,8,715,350,166,0,9,0,9
10/20/15,3,10,776,370,156,0,6,4,10
10/20/15,3,11,8032,355,105,9,27,1,37
10/20/15,3,12,8032,350,136,8,17,4,29
10/20/15,3,13,542,350,137,13,9,1,23
10/20/15,3,15,542,350,49,12,5,0,17
10/20/15,3,17,747,370,106,8,7,3,18
10/20/15,3,18,490,350,71,7,2,1,10
10/20/15,3,20,8040,350,145,6,4,1,11
10/20/15,3,22,542,350,71,7,18,0,25
10/20/15,3,24,7652,360,96,11,16,0,27
10/20/15,3,25,715,375,59,6,6,0,12
10/20/15,3,28,8032,375,109,13,29,1,43
10/20/15,3,29,729,270,65,23,9,1,33
10/20/15,3,30,7625,270,5,1,2,1,4
10/21/15,1,1,738,305,118,14,13,1,28
10/21/15,1,3,996,220,80,19,12,0,31
10/21/15,1,4,5302,220,74,19,3,0,22
10/21/15,1,7,783,345,135,27,8,0,35
10/21/15,1,8,715,350,139,5,12,2,19
10/21/15,1,10,8035,370,165,1,2,0,3
10/21/15,1,11,8032,355,130,17,29,1,47
10/21/15,1,12,8032,350,140,10,17,3,30
10/21/15,1,13,542,350,117,10,8,1,19
10/21/15,1,15,542,350,104,18,17,0,35
10/21/15,1,16,294,350,88,17,4,3,24
10/21/15,1,17,747,370,110,76,3,3,82
10/21/15,1,20,8040,350,120,7,7,5,19
10/21/15,1,22,542,350,68,9,10,0,19
10/21/15,1,24,783,360,90,10,3,2,15
10/21/15,1,25,715,375,48,10,23,4,37
10/21/15,1,26,542,360,142,2,9,0,11
10/21/15,1,27,542,360,19,1,2,0,3
10/21/15,1,29,729,270,79,12,6,0,18
10/21/15,1,30,1001,270,27,5,21,0,26
10/21/15,2,1,738,305,121,7,11,3,21
10/21/15,2,2,726,315,85,35,15,3,53
10/21/15,2,3,996,220,53,21,10,0,31
10/21/15,2,4,5302,220,68,21,5,0,26
10/21/15,2,7,783,345,95,11,2,0,13
10/21/15,2,8,715,350,133,2,19,1,22
10/21/15,2,10,8035,370,144,1,9,1,11
10/21/15,2,11,8032,355,108,16,26,2,44
10/21/15,2,12,8032,350,136,12,17,2,31
10/21/15,2,13,542,350,86,14,1,0,15
10/21/15,2,15,542,350,98,13,9,0,22
10/21/15,2,16,294,350,122,27,9,4,40
10/21/15,2,17,747,370,93,48,0,2,50
10/21/15,2,19,774,360,66,29,5,0,34
10/21/15,2,20,8040,350,134,3,7,1,11
10/21/15,2,22,542,350,67,14,21,0,35
10/21/15,2,23,491,350,29,0,3,0,3
10/21/15,2,24,783,360,117,8,3,1,12
10/21/15,2,25,715,375,58,7,33,2,42
10/21/15,2,26,542,360,100,2,13,0,15
10/21/15,2,27,542,360,115,12,10,0,22
10/21/15,2,29,729,270,5,2,3,0,5
10/21/15,2,30,1001,270,43,8,4,0,12
10/21/15,3,1,738,305,98,7,8,2,17
10/21/15,3,2,726,315,107,31,17,2,50
10/21/15,3,3,996,220,76,20,9,0,29
10/21/15,3,4,5302,220,60,0,0,0,0
10/21/15,3,8,715,350,136,3,17,4,24
10/21/15,3,10,8035,370,156,2,8,1,11
10/21/15,3,11,8032,355,130,17,22,2,41
10/21/15,3,12,8032,350,114,5,15,5,25
10/21/15,3,14,3062,360,75,32,7,9,48
10/21/15,3,15,542,350,40,6,8,0,14
10/21/15,3,16,294,350,143,14,11,2,27
10/21/15,3,17,747,370,62,16,1,1,18
10/21/15,3,18,3062,350,56,7,4,1,12
10/21/15,3,19,774,360,37,20,6,6,32
10/21/15,3,20,8040,350,55,5,5,7,17
10/21/15,3,22,542,350,64,4,11,0,15
10/21/15,3,23,491,350,127,6,2,0,8
10/21/15,3,24,783,360,107,17,7,1,25
10/21/15,3,25,715,375,57,1,6,0,7
10/21/15,3,26,542,360,122,11,5,0,16
10/21/15,3,28,8032,375,72,3,30,0,33
10/21/15,3,29,729,270,38,14,5,0,19
10/21/15,3,30,1001,270,73,25,8,1,34
10/22/15,1,1,738,305,75,17,6,7,30
10/22/15,1,2,726,315,67,19,11,1,31
10/22/15,1,3,996,220,34,6,3,0,9
10/22/15,1,4,5302,220,56,12,2,15,29
10/22/15,1,8,715,350,130,4,16,5,25
10/22/15,1,10,776,370,155,4,5,2,11
10/22/15,1,11,8032,355,124,20,23,1,44
10/22/15,1,12,8032,350,134,17,17,3,37
10/22/15,1,13,542,350,28,6,3,13,22
10/22/15,1,14,3062,360,122,44,7,0,51
10/22/15,1,15,542,350,100,14,20,0,34
10/22/15,1,16,294,350,142,22,6,5,33
10/22/15,1,17,7601,370,110,55,2,1,58
10/22/15,1,18,3062,350,19,8,3,3,14
10/22/15,1,19,774,360,83,26,12,0,38
10/22/15,1,20,8040,350,136,9,8,5,22
10/22/15,1,22,542,350,58,9,13,0,22
10/22/15,1,23,491,350,157,5,2,0,7
10/22/15,1,24,783,360,139,11,6,1,18
10/22/15,1,25,715,375,128,2,11,0,13
10/22/15,1,26,542,360,127,14,10,0,24
10/22/15,1,28,8032,375,60,6,28,1,35
10/22/15,1,29,729,270,61,19,5,0,24
10/22/15,1,30,1001,270,51,12,8,0,20
10/22/15,2,1,738,305,89,12,11,5,28
10/22/15,2,3,996,220,27,8,2,0,10
10/22/15,2,4,5302,220,52,8,2,21,31
10/22/15,2,8,715,350,136,4,16,5,25
10/22/15,2,10,776,370,164,2,2,1,5
10/22/15,2,11,8032,355,125,12,24,1,37
10/22/15,2,12,8032,350,118,8,29,3,40
10/22/15,2,13,542,350,116,20,8,0,28
10/22/15,2,14,3062,360,106,49,2,2,53
10/22/15,2,15,542,350,88,14,10,0,24
10/22/15,2,16,294,350,132,10,10,3,23
10/22/15,2,17,7601,370,117,19,4,3,26
10/22/15,2,18,3062,350,93,6,9,4,19
10/22/15,2,19,774,360,93,16,12,0,28
10/22/15,2,23,491,350,148,3,2,0,5
10/22/15,2,24,783,360,97,16,3,1,20
10/22/15,2,25,715,375,68,7,10,0,17
10/22/15,2,26,542,360,99,11,11,0,22
10/22/15,2,28,8032,375,64,8,35,0,43
10/22/15,2,29,729,270,64,23,3,0,26
10/22/15,2,30,1001,270,64,11,10,0,21
10/22/15,3,1,738,305,116,25,6,1,32
10/22/15,3,3,996,220,74,0,0,0,0
10/22/15,3,4,5302,220,61,0,0,0,0
10/22/15,3,8,715,350,166,3,5,0,8
10/22/15,3,10,776,370,161,1,1,1,3
10/22/15,3,11,8032,355,135,11,23,2,36
10/22/15,3,12,8032,350,131,17,26,4,47
10/22/15,3,13,542,350,133,20,2,3,25
10/22/15,3,14,3062,360,150,16,2,0,18
10/22/15,3,15,542,350,83,13,13,0,26
10/22/15,3,16,294,350,113,19,10,1,30
10/22/15,3,17,7601,370,137,6,3,1,10
10/22/15,3,18,3062,350,124,6,5,6,17
10/22/15,3,19,774,360,56,13,14,0,27
10/22/15,3,20,8040,350,41,3,19,9,31
10/22/15,3,23,491,350,96,0,2,0,2
10/22/15,3,24,783,360,118,17,2,6,25
10/22/15,3,25,715,375,121,3,17,0,20
10/22/15,3,26,542,360,110,11,19,0,30
10/22/15,3,28,8032,375,90,13,28,3,44
10/22/15,3,29,729,270,79,0,0,0,0
10/22/15,3,30,1001,270,65,0,0,0,0
10/23/15,1,1,738,305,116,28,4,3,35
10/23/15,1,3,996,220,70,12,8,0,20
10/23/15,1,4,5302,220,70,18,3,0,21
10/23/15,1,8,715,350,146,6,9,7,22
10/23/15,1,11,8032,355,115,21,22,0,43
10/23/15,1,12,8032,350,134,12,23,1,36
10/23/15,1,13,542,350,130,24,2,0,26
10/23/15,1,14,3062,360,143,16,7,0,23
10/23/15,1,15,542,350,120,18,10,0,28
10/23/15,1,16,294,350,81,18,3,8,29
10/23/15,1,17,7601,370,48,3,2,0,5
10/23/15,1,18,3062,350,141,9,9,3,21
10/23/15,1,19,774,360,94,34,9,0,43
10/23/15,1,20,8040,350,80,13,23,4,40
10/23/15,1,22,542,350,70,22,15,0,37
10/23/15,1,23,491,350,137,2,4,0,6
10/23/15,1,24,783,360,130,20,0,1,21
10/23/15,1,25,715,375,141,5,11,0,16
10/23/15,1,26,542,360,99,10,13,0,23
10/23/15,1,28,8032,375,97,15,20,0,35
10/23/15,1,29,729,270,60,19,3,0,22
10/23/15,1,30,1001,270,58,22,5,0,27
10/23/15,2,1,738,305,120,16,11,1,28
10/23/15,2,3,996,220,68,10,9,0,19
10/23/15,2,4,5302,220,69,17,5,0,22
10/23/15,2,8,715,350,158,5,14,1,20
10/23/15,2,9,542,350,40,53,8,0,61
10/23/15,2,11,8032,355,70,5,15,1,21
10/23/15,2,12,8032,350,128,27,14,1,42
10/23/15,2,13,542,350,130,18,4,1,23
10/23/15,2,14,3062,360,116,18,11,1,30
10/23/15,2,15,542,350,31,4,6,0,10
10/23/15,2,16,294,350,116,28,6,3,37
10/23/15,2,18,3062,350,130,4,10,1,15
10/23/15,2,19,774,360,70,38,5,0,43
10/23/15,2,20,8040,350,86,15,17,2,34
10/23/15,2,22,542,350,69,20,11,0,31
10/23/15,2,23,491,350,143,2,5,0,7
10/23/15,2,24,783,360,131,8,7,1,16
10/23/15,2,25,715,375,88,13,5,0,18
10/23/15,2,26,542,360,109,16,1,0,17
10/23/15,2,28,8032,375,73,9,21,0,30
10/23/15,2,29,729,270,55,21,5,0,26
10/23/15,2,30,1001,270,56,23,6,0,29
10/23/15,3,1,738,305,116,19,5,1,25
10/23/15,3,2,726,315,17,2,5,0,7
10/23/15,3,3,996,220,49,0,0,0,0
10/23/15,3,4,5302,220,54,0,0,0,0
10/23/15,3,8,715,350,143,2,10,2,14
10/23/15,3,9,542,350,54,99,5,2,106
10/23/15,3,11,8032,355,108,19,28,3,50
10/23/15,3,12,8032,350,118,31,39,2,72
10/23/15,3,13,542,350,131,20,6,1,27
10/23/15,3,14,3062,360,148,12,3,1,16
10/23/15,3,16,294,350,109,22,10,8,40
10/23/15,3,18,3062,350,63,7,6,4,17
10/23/15,3,19,774,360,31,10,5,0,15
10/23/15,3,20,8040,350,78,8,4,10,22
10/23/15,3,22,542,350,76,7,9,0,16
10/23/15,3,23,491,350,88,1,5,0,6
10/23/15,3,24,783,360,119,12,2,1,15
10/23/15,3,25,715,375,57,1,9,0,10
10/23/15,3,26,542,360,32,13,2,0,15
10/23/15,3,28,8032,375,72,6,28,2,36
10/23/15,3,29,729,270,56,20,4,0,24
10/23/15,3,30,1001,270,119,16,3,0,19
10/26/15,1,1,738,305,120,17,8,3,28
10/26/15,1,2,726,315,39,12,5,2,19
10/26/15,1,3,996,220,45,23,12,0,35
10/26/15,1,4,5302,220,58,22,5,0,27
10/26/15,1,5,715,370,24,2,1,5,8
10/26/15,1,7,783,345,8,6,1,1,8
10/26/15,1,8,715,350,147,3,12,2,17
10/26/15,1,9,542,350,62,55,12,1,68
10/26/15,1,11,8032,355,117,13,24,0,37
10/26/15,1,12,8032,350,111,16,14,1,31
10/26/15,1,13,542,350,128,12,4,1,17
10/26/15,1,14,3062,360,121,8,8,4,20
10/26/15,1,16,294,350,122,28,12,3,43
10/26/15,1,18,3062,350,127,8,2,1,11
10/26/15,1,19,774,360,82,44,9,0,53
10/26/15,1,20,8040,350,75,13,17,7,37
10/26/15,1,22,542,350,84,16,19,0,35
10/26/15,1,23,491,350,183,7,1,0,8
10/26/15,1,24,783,360,114,15,5,1,21
10/26/15,1,25,715,375,91,4,13,0,17
10/26/15,1,26,542,360,147,12,6,0,18
10/26/15,1,27,542,360,22,22,2,0,24
10/26/15,1,28,8032,375,70,7,26,4,37
10/26/15,1,29,729,270,23,15,5,0,20
10/26/15,1,30,1001,270,41,15,8,0,23
10/26/15,2,1,738,305,113,3,1,0,4
10/26/15,2,2,726,315,91,29,10,3,42
10/26/15,2,3,996,220,31,0,0,0,0
10/26/15,2,4,5302,220,51,0,0,0,0
10/26/15,2,5,715,370,138,2,0,0,2
10/26/15,2,8,715,350,156,5,10,0,15
10/26/15,2,9,542,350,49,52,10,2,64
10/26/15,2,11,8032,355,113,5,34,0,39
10/26/15,2,12,8032,350,129,21,21,3,45
10/26/15,2,13,542,350,124,21,1,3,25
10/26/15,2,14,3062,360,151,9,7,0,16
10/26/15,2,16,294,350,125,1,1,0,2
10/26/15,2,18,3062,350,132,8,8,4,20
10/26/15,2,19,774,360,105,37,9,0,46
10/26/15,2,20,8040,350,113,15,15,4,34
10/26/15,2,22,542,350,99,19,18,0,37
10/26/15,2,23,491,350,131,1,7,0,8
10/26/15,2,24,783,360,93,9,9,1,19
10/26/15,2,25,715,159,89,4,12,0,16
10/26/15,2,26,542,360,111,24,3,0,27
10/26/15,2,27,542,360,50,42,3,0,45
10/26/15,2,28,8032,375,81,13,32,2,47
10/26/15,2,29,729,270,70,14,3,0,17
10/26/15,2,30,1001,270,47,12,6,1,19
10/26/15,3,1,738,305,108,39,7,1,47
10/26/15,3,2,726,315,109,35,12,3,50
10/26/15,3,3,996,220,49,0,0,0,0
10/26/15,3,4,5302,220,48,0,0,0,0
10/26/15,3,5,715,370,155,7,4,0,11
10/26/15,3,8,715,350,143,4,11,0,15
10/26/15,3,9,542,350,75,57,9,3,69
10/26/15,3,11,8032,355,108,18,27,1,46
10/26/15,3,12,8032,350,44,3,12,1,16
10/26/15,3,13,542,350,110,16,16,2,34
10/26/15,3,14,3062,360,158,10,6,2,18
10/26/15,3,16,294,350,114,15,12,1,28
10/26/15,3,18,3062,350,80,3,4,1,8
10/26/15,3,19,774,360,74,16,6,0,22
10/26/15,3,20,8040,350,75,8,18,4,30
10/26/15,3,22,542,350,66,7,9,0,16
10/26/15,3,23,491,350,123,3,7,0,10
10/26/15,3,25,715,375,44,1,3,0,4
10/26/15,3,26,542,360,101,21,3,0,24
10/26/15,3,27,542,360,31,23,3,0,26
10/26/15,3,28,8032,375,78,13,28,1,42
10/26/15,3,29,729,270,88,15,4,1,20
10/26/15,3,30,1001,270,66,10,5,0,15
10/27/15,1,1,738,305,59,13,4,3,20
10/27/15,1,2,726,315,75,37,13,1,51
10/27/15,1,3,996,220,55,10,3,0,13
10/27/15,1,4,5302,220,52,28,6,0,34
10/27/15,1,5,715,370,142,10,7,2,19
10/27/15,1,8,715,350,170,2,5,1,8
10/27/15,1,9,542,350,128,29,10,0,39
10/27/15,1,11,8032,355,133,12,22,1,35
10/27/15,1,12,8032,350,14,1,2,6,9
10/27/15,1,13,542,350,123,18,7,3,28
10/27/15,1,14,3062,360,164,4,3,3,10
10/27/15,1,16,294,350,63,13,8,3,24
10/27/15,1,18,3062,350,136,6,15,3,24
10/27/15,1,19,774,360,116,32,8,0,40
10/27/15,1,20,8040,350,92,8,20,7,35
10/27/15,1,22,542,350,102,18,20,0,38
10/27/15,1,23,491,350,159,2,6,0,8
10/27/15,1,24,783,360,35,7,5,13,25
10/27/15,1,25,715,375,99,14,14,0,28
10/27/15,1,26,542,360,131,31,3,0,34
10/27/15,1,27,542,360,64,22,6,0,28
10/27/15,1,28,8032,375,65,13,26,7,46
10/27/15,1,29,729,270,67,18,3,0,21
10/27/15,1,30,1001,270,60,15,12,0,27
10/27/15,2,1,738,305,74,13,10,5,28
10/27/15,2,2,726,315,101,40,7,1,48
10/27/15,2,3,996,220,15,2,1,0,3
10/27/15,2,4,5302,220,54,23,2,0,25
10/27/15,2,5,715,370,148,4,10,1,15
10/27/15,2,8,715,350,160,5,7,5,17
10/27/15,2,9,542,350,76,17,8,3,28
10/27/15,2,11,8032,355,109,16,26,0,42
10/27/15,2,12,8032,350,144,6,8,2,16
10/27/15,2,13,542,350,117,14,5,1,20
10/27/15,2,14,3062,360,147,10,6,1,17
10/27/15,2,16,294,350,61,13,6,3,22
10/27/15,2,18,3062,350,118,1,12,2,15
10/27/15,2,19,774,360,103,35,5,0,40
10/27/15,2,20,8040,350,91,15,22,19,56
10/27/15,2,22,542,350,82,17,11,0,28
10/27/15,2,23,491,350,159,3,2,0,5
10/27/15,2,24,783,360,91,13,13,1,27
10/27/15,2,25,715,375,92,8,8,0,16
10/27/15,2,26,542,360,82,23,1,0,24
10/27/15,2,28,8032,375,87,16,15,1,32
10/27/15,2,29,729,270,67,21,5,0,26
10/27/15,2,30,1001,270,43,18,13,0,31
10/27/15,3,1,738,305,107,18,16,6,40
10/27/15,3,2,726,315,109,38,6,4,48
10/27/15,3,3,996,220,78,0,0,0,0
10/27/15,3,4,5302,220,67,0,0,0,0
10/27/15,3,5,715,370,161,4,5,0,9
10/27/15,3,8,715,350,153,3,13,6,22
10/27/15,3,9,542,350,126,28,11,2,41
10/27/15,3,11,8032,355,111,27,15,3,45
10/27/15,3,12,8032,350,149,6,8,0,14
10/27/15,3,13,542,350,147,11,5,0,16
10/27/15,3,14,3062,360,149,11,4,0,15
10/27/15,3,16,294,350,64,13,6,1,20
10/27/15,3,18,3062,350,136,4,9,1,14
10/27/15,3,19,774,360,106,35,3,0,38
10/27/15,3,20,8040,350,93,8,22,5,35
10/27/15,3,22,542,350,102,15,14,0,29
10/27/15,3,23,491,350,163,1,4,0,5
10/27/15,3,24,783,360,83,15,2,2,19
10/27/15,3,25,715,375,30,5,4,0,9
10/27/15,3,26,542,360,4,2,0,0,2
10/27/15,3,28,8032,375,79,10,35,3,48
10/27/15,3,29,729,270,21,0,0,0,0
10/27/15,3,30,1001,270,44,0,0,0,0
10/28/15,1,1,738,305,114,21,11,2,34
10/28/15,1,2,726,315,104,28,7,1,36
10/28/15,1,3,996,220,71,16,12,0,28
10/28/15,1,4,5302,220,60,21,4,0,25
10/28/15,1,5,8035,370,153,3,5,1,9
10/28/15,1,7,783,345,72,24,6,1,31
10/28/15,1,8,715,350,159,1,10,0,11
10/28/15,1,9,308,350,91,57,3,0,60
10/28/15,1,10,8035,370,154,3,6,1,10
10/28/15,1,11,8032,355,108,34,15,5,54
10/28/15,1,12,8032,350,154,6,5,1,12
10/28/15,1,13,542,350,139,9,10,2,21
10/28/15,1,14,3062,360,140,11,5,1,17
10/28/15,1,19,774,360,77,37,2,0,39
10/28/15,1,20,8040,350,87,3,21,5,29
10/28/15,1,22,542,350,62,12,20,0,32
10/28/15,1,23,491,350,161,3,4,1,8
10/28/15,1,24,783,360,110,22,8,0,30
10/28/15,1,25,715,375,107,8,14,0,22
10/28/15,1,26,542,360,51,27,0,0,27
10/28/15,1,28,8032,375,84,3,31,0,34
10/28/15,1,29,729,270,89,12,3,0,15
10/28/15,1,30,1001,270,50,26,12,0,38
10/28/15,2,1,738,305,123,15,13,3,31
10/28/15,2,2,726,315,91,41,10,4,55
10/28/15,2,3,996,220,70,18,9,0,27
10/28/15,2,4,5302,220,40,23,5,0,28
10/28/15,2,5,8035,370,162,2,6,0,8
10/28/15,2,8,715,350,165,3,6,1,10
10/28/15,2,9,308,350,84,24,13,0,37
10/28/15,2,10,8035,370,158,8,3,0,11
10/28/15,2,11,8032,355,130,5,25,0,30
10/28/15,2,12,8032,350,141,7,8,1,16
10/28/15,2,13,542,350,119,11,11,1,23
10/28/15,2,14,3062,360,85,49,5,1,55
10/28/15,2,19,774,360,62,39,6,0,45
10/28/15,2,20,8040,350,92,11,15,3,29
10/28/15,2,22,542,350,59,14,10,0,24
10/28/15,2,23,491,350,142,6,3,0,9
10/28/15,2,24,783,360,89,22,9,1,32
10/28/15,2,25,715,375,65,0,13,0,13
10/28/15,2,26,542,360,128,17,1,0,18
10/28/15,2,27,542,360,8,7,0,0,7
10/28/15,2,28,8032,375,73,15,18,2,35
10/28/15,2,29,729,270,62,24,5,0,29
10/28/15,2,30,1001,270,45,33,10,0,43
10/28/15,3,1,738,305,113,25,8,4,37
10/28/15,3,2,726,315,97,43,15,0,58
10/28/15,3,3,996,220,76,19,8,0,27
10/28/15,3,4,5302,220,75,24,6,1,31
10/28/15,3,5,8035,370,155,13,2,0,15
10/28/15,3,8,715,350,141,6,12,1,19
10/28/15,3,9,308,350,114,25,9,2,36
10/28/15,3,10,8035,370,138,15,5,1,21
10/28/15,3,11,8032,355,28,1,9,1,11
10/28/15,3,12,8032,350,147,6,10,2,18
10/28/15,3,14,3062,360,4,3,3,0,6
10/28/15,3,15,542,350,52,13,10,0,23
10/28/15,3,17,747,370,12,2,8,3,13
10/28/15,3,19,774,360,55,37,2,0,39
10/28/15,3,20,8040,350,61,10,17,9,36
10/28/15,3,22,542,350,56,16,8,0,24
10/28/15,3,23,491,350,121,1,1,0,2
10/28/15,3,24,783,360,61,7,3,3,13
10/28/15,3,25,715,375,98,0,9,0,9
10/28/15,3,26,542,360,24,5,0,0,5
10/28/15,3,27,542,360,37,35,1,0,36
10/28/15,3,28,8032,375,59,0,22,1,23
10/28/15,3,29,729,270,55,20,4,0,24
10/28/15,3,30,1001,270,34,26,9,0,35
10/29/15,1,1,738,305,117,16,7,3,26
10/29/15,1,2,726,315,96,47,5,5,57
10/29/15,1,3,996,220,70,12,15,0,27
10/29/15,1,4,5302,220,50,29,6,0,35
10/29/15,1,5,715,370,139,4,8,2,14
10/29/15,1,8,715,350,140,1,22,2,25
10/29/15,1,9,542,350,99,47,12,5,64
10/29/15,1,10,3062,370,154,9,4,2,15
10/29/15,1,12,8032,350,147,8,8,0,16
10/29/15,1,13,542,350,85,6,5,2,13
10/29/15,1,14,3062,360,119,22,19,0,41
10/29/15,1,15,542,350,98,20,21,0,41
10/29/15,1,16,294,350,13,1,2,2,5
10/29/15,1,17,491,370,139,10,3,1,14
10/29/15,1,18,542,350,9,0,2,14,16
10/29/15,1,19,774,360,127,16,8,0,24
10/29/15,1,20,8040,350,102,8,15,2,25
10/29/15,1,22,542,350,40,6,5,0,11
10/29/15,1,23,497,350,173,10,3,0,13
10/29/15,1,24,285,360,123,26,5,2,33
10/29/15,1,25,715,375,131,3,17,0,20
10/29/15,1,26,542,360,21,15,1,0,16
10/29/15,1,27,542,360,69,44,4,0,48
10/29/15,1,29,729,270,55,29,10,0,39
10/29/15,1,30,1001,270,55,18,12,0,30
10/29/15,2,1,738,305,114,16,10,5,31
10/29/15,2,2,726,315,64,46,9,4,59
10/29/15,2,3,996,220,62,15,18,0,33
10/29/15,2,4,5302,220,45,33,7,0,40
10/29/15,2,5,715,370,154,1,5,0,6
10/29/15,2,7,997,345,8,0,2,0,2
10/29/15,2,8,715,350,156,2,15,4,21
10/29/15,2,9,542,350,11,19,14,0,33
10/29/15,2,10,3062,370,143,4,5,1,10
10/29/15,2,12,8032,350,131,6,14,1,21
10/29/15,2,13,542,350,124,14,5,2,21
10/29/15,2,14,3062,360,107,7,14,0,21
10/29/15,2,15,542,350,99,20,7,0,27
10/29/15,2,16,294,350,23,5,1,2,8
10/29/15,2,17,491,370,134,8,3,1,12
10/29/15,2,18,542,350,69,20,15,1,36
10/29/15,2,19,774,360,45,9,6,0,15
10/29/15,2,20,8040,350,89,10,23,3,36
10/29/15,2,23,497,350,151,9,0,0,9
10/29/15,2,24,285,360,106,13,8,1,22
10/29/15,2,25,715,375,89,1,9,0,10
10/29/15,2,27,542,360,51,34,0,0,34
10/29/15,2,29,729,270,42,34,8,0,42
10/29/15,2,30,1001,270,61,12,9,0,21
10/29/15,3,1,738,305,84,14,8,5,27
10/29/15,3,2,726,315,117,28,12,0,40
10/29/15,3,3,996,220,38,8,12,0,20
10/29/15,3,4,5302,220,57,31,8,0,39
10/29/15,3,5,715,370,161,4,3,2,9
10/29/15,3,7,997,345,10,2,3,2,7
10/29/15,3,8,715,350,158,3,9,0,12
10/29/15,3,9,542,350,118,15,16,3,34
10/29/15,3,10,3062,370,143,12,7,0,19
10/29/15,3,11,7652,355,3,1,5,1,7
10/29/15,3,12,8032,350,122,6,9,1,16
10/29/15,3,13,542,350,124,19,8,0,27
10/29/15,3,14,3062,360,120,11,23,0,34
10/29/15,3,15,542,350,68,15,10,0,25
10/29/15,3,16,294,350,114,23,12,3,38
10/29/15,3,17,491,370,165,3,1,0,4
10/29/15,3,18,542,350,70,24,10,3,37
10/29/15,3,20,8040,350,110,7,14,8,29
10/29/15,3,21,497,350,68,16,1,0,17
10/29/15,3,23,497,350,163,6,1,0,7
10/29/15,3,24,285,360,107,11,7,2,20
10/29/15,3,25,715,375,98,1,12,0,13
10/29/15,3,27,542,360,55,36,3,0,39
10/29/15,3,29,729,270,60,26,9,1,36
10/29/15,3,30,1001,270,6,4,1,0,5
10/30/15,1,1,738,305,103,17,12,8,37
10/30/15,1,2,726,315,118,22,6,4,32
10/30/15,1,3,996,220,43,12,6,0,18
10/30/15,1,4,5302,220,56,27,3,0,30
10/30/15,1,5,715,370,160,3,4,0,7
10/30/15,1,8,715,350,153,2,12,1,15
10/30/15,1,9,542,350,100,32,15,1,48
10/30/15,1,10,3062,370,132,10,10,1,21
10/30/15,1,11,7652,355,109,4,25,3,32
10/30/15,1,12,8032,350,105,9,6,4,19
10/30/15,1,13,542,350,120,9,5,3,17
10/30/15,1,14,3062,360,106,26,25,0,51
10/30/15,1,15,542,350,73,29,8,0,37
10/30/15,1,16,294,350,106,16,11,2,29
10/30/15,1,17,491,370,146,4,4,1,9
10/30/15,1,18,542,350,95,28,13,4,45
10/30/15,1,20,8040,350,69,12,12,8,32
10/30/15,1,21,497,350,140,14,4,0,18
10/30/15,1,22,542,350,43,14,5,0,19
10/30/15,1,23,497,350,149,6,5,0,11
10/30/15,1,24,285,360,91,25,8,0,33
10/30/15,1,25,715,375,95,15,7,0,22
10/30/15,1,27,542,360,84,37,5,0,42
10/30/15,1,29,729,270,69,21,3,0,24
10/30/15,1,30,1001,270,50,18,16,0,34
10/30/15,2,1,738,305,130,19,10,2,31
10/30/15,2,2,726,315,99,26,10,5,41
10/30/15,2,3,996,220,75,20,9,0,29
10/30/15,2,4,5302,220,52,25,4,0,29
10/30/15,2,5,715,370,154,5,4,0,9
10/30/15,2,8,715,350,153,30,2,0,32
10/30/15,2,9,542,350,64,16,9,2,27
10/30/15,2,10,3062,370,147,11,7,2,20
10/30/15,2,11,7652,355,131,5,12,1,18
10/30/15,2,12,8032,350,120,5,14,1,20
10/30/15,2,13,542,350,125,13,3,1,17
10/30/15,2,14,3062,360,133,10,23,1,34
10/30/15,2,15,542,350,65,27,7,0,34
10/30/15,2,16,294,350,122,20,16,0,36
10/30/15,2,17,491,370,136,5,5,0,10
10/30/15,2,18,542,350,76,20,11,1,32
10/30/15,2,20,8040,350,83,8,20,4,32
10/30/15,2,21,497,350,119,11,3,0,14
10/30/15,2,22,542,350,66,14,10,0,24
10/30/15,2,23,497,350,138,15,0,0,15
10/30/15,2,24,285,360,84,17,7,0,24
10/30/15,2,25,715,375,89,1,19,0,20
10/30/15,2,27,542,360,51,29,1,0,30
10/30/15,2,29,729,270,35,15,1,0,16
10/30/15,2,30,1001,270,51,19,14,0,33
10/30/15,3,1,738,305,120,12,12,2,26
10/30/15,3,3,996,220,81,22,10,1,33
10/30/15,3,4,5302,220,23,20,3,0,23
10/30/15,3,5,715,370,166,5,2,2,9
10/30/15,3,8,715,350,75,0,12,0,12
10/30/15,3,9,542,350,121,16,26,3,45
10/30/15,3,10,3062,370,135,5,7,4,16
10/30/15,3,11,7652,355,129,113,13,5,131
10/30/15,3,12,8032,350,39,1,1,1,3
10/30/15,3,13,542,350,123,29,6,1,36
10/30/15,3,14,3062,360,114,11,19,2,32
10/30/15,3,15,542,350,70,17,6,0,23
10/30/15,3,16,294,350,15,1,20,0,21
10/30/15,3,17,491,370,119,7,8,2,17
10/30/15,3,18,542,350,55,12,14,4,30
10/30/15,3,20,8040,350,83,3,23,2,28
10/30/15,3,21,497,350,93,3,6,0,9
10/30/15,3,22,542,350,59,13,10,0,23
10/30/15,3,23,497,350,130,12,13,0,25
10/30/15,3,24,285,360,61,11,4,1,16
10/30/15,3,25,715,375,55,0,8,0,8
10/30/15,3,27,542,360,68,31,4,0,35
10/30/15,3,29,729,270,27,10,0,0,10
10/30/15,3,30,1001,270,59,20,12,0,32
11/09/15,1,1,738,305,116,18,14,1,33
11/09/15,1,3,996,220,63,12,12,0,24
11/09/15,1,4,5302,220,72,23,4,0,27
11/09/15,1,5,715,370,156,4,8,0,12
11/09/15,1,7,997,345,129,21,9,2,32
11/09/15,1,9,542,350,144,19,4,2,25
11/09/15,1,10,3062,370,142,9,43,0,52
11/09/15,1,11,7652,355,110,32,15,5,52
11/09/15,1,12,8032,350,42,9,3,5,17
11/09/15,1,13,542,350,101,45,3,0,48
11/09/15,1,14,3062,360,113,13,25,3,41
11/09/15,1,15,542,350,56,5,4,0,9
11/09/15,1,16,294,350,59,34,8,1,43
11/09/15,1,17,491,370,160,4,2,1,7
11/09/15,1,18,542,350,46,5,5,3,13
11/09/15,1,20,8040,350,85,15,14,9,38
11/09/15,1,21,497,350,127,41,5,0,46
11/09/15,1,24,285,360,85,14,7,4,25
11/09/15,1,26,542,360,29,16,4,0,20
11/09/15,1,27,542,360,103,36,6,0,42
11/09/15,1,28,8040,375,88,3,18,6,27
11/09/15,1,29,737,270,46,28,15,0,43
11/09/15,1,30,1001,270,51,18,16,0,34
11/09/15,2,1,738,305,119,15,15,6,36
11/09/15,2,2,726,315,90,16,5,4,25
11/09/15,2,3,996,220,4,0,0,0,0
11/09/15,2,4,5302,220,41,0,0,0,0
11/09/15,2,5,715,370,146,7,12,2,21
11/09/15,2,7,997,345,129,18,11,3,32
11/09/15,2,9,542,350,116,26,1,2,29
11/09/15,2,10,3062,370,145,17,7,1,25
11/09/15,2,11,7652,355,131,33,18,3,54
11/09/15,2,12,8032,350,117,15,12,1,28
11/09/15,2,13,542,350,125,32,3,1,36
11/09/15,2,14,3062,360,129,10,32,0,42
11/09/15,2,15,542,350,94,6,3,0,9
11/09/15,2,17,491,370,120,15,6,1,22
11/09/15,2,20,8040,350,81,64,6,5,75
11/09/15,2,21,497,350,77,13,9,0,22
11/09/15,2,24,285,360,120,10,3,7,20
11/09/15,2,26,542,360,19,0,20,0,20
11/09/15,2,27,542,360,62,18,3,0,21
11/09/15,2,28,8040,375,87,4,16,2,22
11/09/15,2,29,737,270,66,23,10,1,34
11/09/15,2,30,1001,270,55,16,11,0,27
11/09/15,3,1,738,305,96,15,17,6,38
11/09/15,3,2,726,315,100,44,1,2,47
11/09/15,3,3,996,220,15,0,0,0,0
11/09/15,3,4,5302,220,74,0,0,0,0
11/09/15,3,5,715,370,134,2,10,1,13
11/09/15,3,7,997,345,57,4,6,6,16
11/09/15,3,9,542,350,118,22,2,0,24
11/09/15,3,10,3062,370,104,9,9,3,21
11/09/15,3,11,7652,355,24,21,10,5,36
11/09/15,3,12,8032,350,45,6,9,1,16
11/09/15,3,13,542,350,125,32,3,1,36
11/09/15,3,15,542,350,105,18,4,0,22
11/09/15,3,16,294,350,2,1,1,0,2
11/09/15,3,17,491,370,69,19,7,1,27
11/09/15,3,20,8040,350,89,9,13,9,31
11/09/15,3,21,497,350,40,9,5,0,14
11/09/15,3,24,285,360,95,7,6,5,18
11/09/15,3,26,542,360,44,37,0,0,37
11/09/15,3,27,542,360,16,16,0,0,16
11/09/15,3,28,8040,375,100,7,16,0,23
11/09/15,3,29,737,270,40,19,12,0,31
11/09/15,3,30,1001,270,57,17,11,0,28
11/10/15,1,1,738,305,109,16,12,6,34
11/10/15,1,3,996,220,62,12,15,0,27
11/10/15,1,4,5302,220,66,19,3,0,22
11/10/15,1,5,715,370,129,13,8,2,23
11/10/15,1,7,997,345,117,16,4,4,24
11/10/15,1,9,747,350,131,17,0,2,19
11/10/15,1,10,3062,370,145,14,8,3,25
11/10/15,1,11,7652,355,102,19,11,0,30
11/10/15,1,12,8032,350,133,8,13,1,22
11/10/15,1,13,542,350,129,20,9,1,30
11/10/15,1,15,542,350,144,12,5,0,17
11/10/15,1,16,294,350,37,6,3,7,16
11/10/15,1,17,491,370,126,8,11,3,22
11/10/15,1,20,8040,350,114,20,21,9,50
11/10/15,1,21,497,350,77,23,10,0,33
11/10/15,1,24,285,360,112,14,4,15,33
11/10/15,1,25,715,375,18,0,11,0,11
11/10/15,1,26,542,360,124,36,5,0,41
11/10/15,1,28,8040,375,117,4,13,0,17
11/10/15,1,29,737,270,86,9,1,0,10
11/10/15,2,1,738,305,126,19,9,2,30
11/10/15,2,3,996,220,74,10,17,0,27
11/10/15,2,4,5302,220,70,14,2,0,16
11/10/15,2,5,715,370,146,16,5,4,25
11/10/15,2,7,997,345,52,9,7,2,18
11/10/15,2,8,7742,350,5,2,2,7,11
11/10/15,2,9,747,350,161,6,2,0,8
11/10/15,2,10,3062,370,154,14,4,1,19
11/10/15,2,11,7652,355,119,14,30,7,51
11/10/15,2,12,8032,350,132,12,16,1,29
11/10/15,2,13,542,350,133,22,3,0,25
11/10/15,2,15,542,350,125,3,9,0,12
11/10/15,2,17,491,370,137,6,10,0,16
11/10/15,2,20,8040,350,81,24,11,9,44
11/10/15,2,21,497,350,145,15,1,0,16
11/10/15,2,25,715,375,114,2,20,0,22
11/10/15,2,26,542,360,125,32,5,0,37
11/10/15,2,28,8040,375,101,7,19,1,27
11/10/15,2,29,737,270,75,12,2,0,14
11/10/15,3,1,738,305,82,15,4,2,21
11/10/15,3,3,996,220,73,11,15,0,26
11/10/15,3,4,5302,220,46,17,4,0,21
11/10/15,3,5,715,370,144,6,1,0,7
11/10/15,3,8,7742,350,97,14,14,16,44
11/10/15,3,9,747,350,158,5,1,1,7
11/10/15,3,10,3062,370,139,18,4,1,23
11/10/15,3,11,7652,355,131,16,18,4,38
11/10/15,3,12,8032,350,133,27,7,2,36
11/10/15,3,13,542,350,100,21,6,1,28
11/10/15,3,15,542,350,93,2,4,0,6
11/10/15,3,16,294,350,38,7,11,6,24
11/10/15,3,17,491,370,113,7,3,5,15
11/10/15,3,20,8040,350,66,9,14,10,33
11/10/15,3,21,497,350,115,12,5,0,17
11/10/15,3,24,285,360,5,1,2,4,7
11/10/15,3,25,715,375,98,0,15,0,15
11/10/15,3,26,542,360,106,31,1,0,32
11/10/15,3,28,8040,375,118,4,13,2,19
11/10/15,3,29,737,270,32,7,3,1,11
11/10/15,3,30,1001,270,32,12,5,1,18
11/11/15,1,1,738,305,126,8,10,7,25
11/11/15,1,3,996,220,71,12,15,0,27
11/11/15,1,4,5302,220,75,21,4,0,25
11/11/15,1,5,715,370,142,10,8,4,22
11/11/15,1,7,997,345,72,12,10,1,23
11/11/15,1,8,7742,350,133,14,14,7,35
11/11/15,1,9,747,350,158,9,2,1,12
11/11/15,1,10,8030,370,140,15,9,4,28
11/11/15,1,11,7652,355,135,8,22,8,38
11/11/15,1,12,8032,350,125,16,13,4,33
11/11/15,1,14,8035,360,34,4,1,5,10
11/11/15,1,15,542,350,134,11,8,0,19
11/11/15,1,17,491,370,128,10,7,0,17
11/11/15,1,20,8040,350,74,23,17,4,44
11/11/15,1,21,497,350,118,7,7,0,14
11/11/15,1,22,542,350,72,9,8,0,17
11/11/15,1,24,285,360,93,22,6,8,36
11/11/15,1,25,715,375,112,0,19,0,19
11/11/15,1,26,542,360,80,21,4,0,25
11/11/15,1,28,8040,375,118,3,16,1,20
11/11/15,1,29,737,270,49,26,5,0,31
11/11/15,1,30,1001,270,71,18,10,0,28
11/11/15,2,1,738,305,118,21,2,5,28
11/11/15,2,3,996,220,70,10,16,0,26
11/11/15,2,4,5302,220,71,19,4,0,23
11/11/15,2,5,715,370,152,2,5,1,8
11/11/15,2,7,997,345,119,20,11,4,35
11/11/15,2,8,7742,350,134,13,8,4,25
11/11/15,2,9,747,350,160,2,3,0,5
11/11/15,2,10,8030,370,139,22,7,2,31
11/11/15,2,11,7652,355,106,12,32,3,47
11/11/15,2,12,8032,350,124,4,8,4,16
11/11/15,2,14,8035,360,80,46,2,6,54
11/11/15,2,15,542,350,81,14,6,0,20
11/11/15,2,16,294,350,24,3,5,4,12
11/11/15,2,17,491,370,72,30,3,1,34
11/11/15,2,20,8040,350,86,9,12,4,25
11/11/15,2,21,497,350,102,4,5,0,9
11/11/15,2,22,542,350,101,18,5,0,23
11/11/15,2,24,285,360,78,11,4,5,20
11/11/15,2,25,715,375,63,0,9,0,9
11/11/15,2,26,542,360,72,28,3,0,31
11/11/15,2,28,8040,375,96,2,13,3,18
11/11/15,2,29,737,270,31,20,6,0,26
11/11/15,2,30,1001,270,58,21,11,0,32
11/11/15,3,1,738,305,112,17,8,4,29
11/11/15,3,3,996,220,71,14,10,0,24
11/11/15,3,4,5302,220,72,21,3,0,24
11/11/15,3,5,715,370,138,2,10,1,13
11/11/15,3,7,997,345,139,25,6,1,32
11/11/15,3,8,7742,350,137,18,10,5,33
11/11/15,3,9,747,350,161,0,3,3,6
11/11/15,3,10,8030,370,104,21,5,3,29
11/11/15,3,11,7652,355,133,21,16,3,40
11/11/15,3,12,8032,350,121,17,11,0,28
11/11/15,3,14,8035,360,145,21,3,3,27
11/11/15,3,15,542,350,39,10,1,0,11
11/11/15,3,20,8040,350,85,15,7,7,29
11/11/15,3,21,497,350,111,5,2,0,7
11/11/15,3,22,542,350,108,15,8,0,23
11/11/15,3,24,285,360,86,11,6,5,22
11/11/15,3,25,715,375,67,1,10,0,11
11/11/15,3,26,542,360,98,32,7,0,39
11/11/15,3,27,542,360,27,16,0,0,16
11/11/15,3,29,737,270,66,23,8,1,32
11/11/15,3,30,1001,270,38,34,9,0,43
11/12/15,1,1,738,305,123,7,13,10,30
11/12/15,1,2,726,315,83,37,3,11,51
11/12/15,1,3,996,220,47,17,5,0,22
11/12/15,1,4,5302,220,76,15,4,0,19
11/12/15,1,5,715,370,162,4,5,3,12
11/12/15,1,7,997,345,139,21,7,7,35
11/12/15,1,8,7742,350,142,22,8,10,40
11/12/15,1,9,747,350,163,6,4,0,10
11/12/15,1,11,7652,355,139,9,7,3,19
11/12/15,1,12,8032,350,143,27,12,3,42
11/12/15,1,14,8035,360,158,7,3,0,10
11/12/15,1,15,542,350,24,2,3,0,5
11/12/15,1,16,294,350,6,2,0,11,13
11/12/15,1,20,8040,350,104,11,18,15,44
11/12/15,1,21,497,350,153,15,4,0,19
11/12/15,1,22,542,350,144,21,7,0,28
11/12/15,1,26,542,360,121,43,8,0,51
11/12/15,1,27,542,360,118,40,10,0,50
11/12/15,1,29,737,270,83,13,8,0,21
11/12/15,1,30,1001,270,99,14,2,0,16
11/12/15,2,1,738,305,111,8,16,10,34
11/12/15,2,2,726,315,104,30,12,2,44
11/12/15,2,4,5302,220,50,12,3,0,15
11/12/15,2,5,715,370,158,11,8,2,21
11/12/15,2,7,997,345,127,13,12,3,28
11/12/15,2,8,7742,350,123,13,8,2,23
11/12/15,2,9,747,350,162,3,2,1,6
11/12/15,2,11,7652,355,124,14,15,1,30
11/12/15,2,12,8032,350,111,16,18,0,34
11/12/15,2,14,8035,360,151,6,4,1,11
11/12/15,2,15,542,350,103,12,9,0,21
11/12/15,2,16,7649,350,92,22,4,1,27
11/12/15,2,20,8040,350,77,16,12,6,34
11/12/15,2,21,497,350,119,10,1,0,11
11/12/15,2,22,542,350,88,12,13,0,25
11/12/15,2,26,542,360,106,23,3,0,26
11/12/15,2,27,542,360,58,21,3,0,24
11/12/15,2,29,737,270,26,14,9,1,24
11/12/15,2,30,1001,270,71,16,3,0,19
11/12/15,3,1,738,305,16,0,6,2,8
11/12/15,3,2,726,315,103,35,6,3,44
11/12/15,3,3,996,220,21,30,2,5,37
11/12/15,3,4,5302,220,58,15,4,1,20
11/12/15,3,5,715,370,166,2,4,0,6
11/12/15,3,7,997,345,143,19,7,3,29
11/12/15,3,8,7742,350,139,12,10,4,26
11/12/15,3,9,747,350,167,4,1,2,7
11/12/15,3,11,7652,355,137,16,6,6,28
11/12/15,3,12,8032,350,98,8,14,0,22
11/12/15,3,13,8030,350,39,4,9,15,28
11/12/15,3,14,8035,360,154,6,6,5,17
11/12/15,3,15,542,350,65,25,2,6,33
11/12/15,3,16,7649,350,137,26,6,2,34
11/12/15,3,21,497,350,104,5,2,0,7
11/12/15,3,22,542,350,122,19,7,0,26
11/12/15,3,24,285,360,37,5,3,9,17
11/12/15,3,26,542,360,119,18,5,0,23
11/12/15,3,27,542,360,80,39,4,0,43
11/12/15,3,29,737,270,64,13,10,1,24
11/12/15,3,30,1001,270,81,17,6,0,23
11/13/15,1,3,996,220,50,19,10,0,29
11/13/15,1,4,5302,220,41,21,7,0,28
11/13/15,1,7,997,345,5,1,1,0,2
11/13/15,1,8,7742,350,149,14,8,9,31
11/13/15,1,9,747,350,162,1,2,3,6
11/13/15,1,11,7652,355,104,29,18,4,51
11/13/15,1,13,8030,350,107,12,13,34,59
11/13/15,1,14,8035,360,165,2,8,1,11
11/13/15,1,15,542,350,105,44,8,0,52
11/13/15,1,16,7649,350,146,24,6,0,30
11/13/15,1,21,497,350,147,9,2,0,11
11/13/15,1,22,542,350,119,12,19,0,31
11/13/15,1,24,7675,360,114,15,4,14,33
11/13/15,1,26,542,360,118,33,6,0,39
11/13/15,1,29,737,270,76,15,10,0,25
11/13/15,1,30,1001,270,65,19,8,0,27
11/13/15,2,1,738,305,99,16,9,7,32
11/13/15,2,3,996,220,55,17,8,1,26
11/13/15,2,4,5302,220,41,19,7,0,26
11/13/15,2,8,7742,350,124,19,7,3,29
11/13/15,2,9,747,350,168,3,1,2,6
11/13/15,2,11,7652,355,120,21,10,4,35
11/13/15,2,13,8030,350,141,6,13,3,22
11/13/15,2,14,8035,360,165,1,0,0,1
11/13/15,2,15,542,350,99,23,9,0,32
11/13/15,2,16,7649,350,142,25,5,2,32
11/13/15,2,21,497,350,85,5,8,0,13
11/13/15,2,22,542,350,108,19,7,0,26
11/13/15,2,24,7675,360,116,6,3,8,17
11/13/15,2,26,542,360,107,31,7,0,38
11/13/15,2,28,7393,375,38,94,0,8,102
11/13/15,2,29,737,270,12,4,1,0,5
11/13/15,3,1,738,305,117,30,7,5,42
11/13/15,3,3,996,220,65,15,6,1,22
11/13/15,3,4,5302,220,40,20,6,0,26
11/13/15,3,8,7742,350,124,22,3,3,28
11/13/15,3,9,747,350,167,0,1,2,3
11/13/15,3,10,3062,370,106,10,2,2,14
11/13/15,3,11,7652,355,112,37,17,2,56
11/13/15,3,13,8030,350,130,6,13,1,20
11/13/15,3,14,8035,360,156,5,2,4,11
11/13/15,3,16,7649,350,141,16,7,3,26
11/02/15,1,1,738,305,118,13,9,6,28
11/02/15,1,3,996,220,88,15,8,0,23
11/02/15,1,4,5302,220,74,21,3,0,24
11/02/15,1,5,715,370,169,1,1,0,2
11/02/15,1,9,542,350,43,12,6,1,19
11/02/15,1,10,3062,370,142,8,2,2,12
11/02/15,1,11,7652,355,134,12,11,2,25
11/02/15,1,13,542,350,82,18,7,0,25
11/02/15,1,14,3062,360,130,19,21,4,44
11/02/15,1,15,542,350,119,38,4,0,42
11/02/15,1,16,294,350,136,16,18,6,40
11/02/15,1,17,491,370,141,6,5,3,14
11/02/15,1,18,542,350,87,31,20,2,53
11/02/15,1,20,8040,350,91,6,15,7,28
11/02/15,1,21,497,350,169,8,1,0,9
11/02/15,1,22,542,350,85,25,15,0,40
11/02/15,1,24,285,360,2,1,0,13,14
11/02/15,1,25,715,375,105,0,28,0,28
11/02/15,1,27,542,360,65,37,2,0,39
11/02/15,1,28,8040,375,38,11,6,2,19
11/02/15,1,29,729,270,53,22,12,0,34
11/02/15,1,30,1001,270,57,15,12,0,27
11/02/15,2,1,738,305,130,11,3,2,16
11/02/15,2,3,996,220,3,0,1,0,1
11/02/15,2,4,5302,220,60,28,4,0,32
11/02/15,2,5,715,370,162,1,4,1,6
11/02/15,2,7,997,345,14,4,35,31,70
11/02/15,2,10,3062,370,157,12,7,0,19
11/02/15,2,11,7652,355,125,11,13,3,27
11/02/15,2,13,542,350,104,24,6,2,32
11/02/15,2,14,3062,360,132,19,22,0,41
11/02/15,2,15,542,350,65,16,4,0,20
11/02/15,2,16,294,350,66,7,12,1,20
11/02/15,2,17,491,370,125,15,9,4,28
11/02/15,2,18,542,350,56,24,8,3,35
11/02/15,2,20,8040,350,84,7,17,3,27
11/02/15,2,21,497,350,109,13,3,0,16
11/02/15,2,22,542,350,66,13,12,0,25
11/02/15,2,24,285,360,129,7,8,1,16
11/02/15,2,25,715,159,85,0,19,0,19
11/02/15,2,27,542,360,62,27,2,0,29
11/02/15,2,28,8040,375,10,5,3,1,9
11/02/15,2,29,729,270,20,12,6,0,18
11/02/15,2,30,1001,270,52,17,10,0,27
11/02/15,3,1,738,305,117,20,5,3,28
11/02/15,3,3,996,220,71,0,0,0,0
11/02/15,3,4,5302,220,59,0,0,0,0
11/02/15,3,5,715,370,157,2,8,0,10
11/02/15,3,10,3062,370,145,13,5,0,18
11/02/15,3,11,7652,355,132,11,12,2,25
11/02/15,3,13,542,350,120,15,5,0,20
11/02/15,3,14,3062,360,115,16,15,2,33
11/02/15,3,15,542,350,74,25,9,0,34
11/02/15,3,17,491,370,28,7,6,5,18
11/02/15,3,18,542,350,54,13,8,2,23
11/02/15,3,20,8040,350,90,9,17,2,28
11/02/15,3,21,497,350,73,8,1,0,9
11/02/15,3,22,542,350,70,17,10,0,27
11/02/15,3,24,285,360,110,11,6,1,18
11/02/15,3,25,715,375,18,1,4,0,5
11/02/15,3,27,542,360,94,39,63,0,102
11/02/15,3,28,8040,375,63,17,9,3,29
11/02/15,3,30,1001,270,63,0,0,0,0
11/03/15,1,1,738,305,113,24,7,4,35
11/03/15,1,3,996,220,73,18,10,0,28
11/03/15,1,4,5302,220,13,3,0,0,3
11/03/15,1,5,715,370,161,1,10,0,11
11/03/15,1,9,747,350,30,6,2,10,18
11/03/15,1,10,3062,370,115,8,2,1,11
11/03/15,1,11,7652,355,138,12,16,3,31
11/03/15,1,13,542,350,87,9,8,3,20
11/03/15,1,14,3062,360,1,0,0,1,1
11/03/15,1,15,542,350,131,16,16,0,32
11/03/15,1,17,491,370,117,7,16,7,30
11/03/15,1,18,542,350,77,27,7,3,37
11/03/15,1,20,8040,350,95,6,15,4,25
11/03/15,1,21,497,350,144,34,1,0,35
11/03/15,1,22,542,350,92,17,13,0,30
11/03/15,1,24,285,360,136,10,6,5,21
11/03/15,1,25,715,375,117,0,18,0,18
11/03/15,1,27,542,360,42,38,2,0,40
11/03/15,1,28,8040,375,73,15,9,3,27
11/03/15,1,30,1001,270,46,22,12,0,34
11/03/15,2,1,738,305,135,4,4,4,12
11/03/15,2,3,996,220,79,19,12,0,31
11/03/15,2,4,5302,220,70,22,0,0,22
11/03/15,2,5,715,370,157,0,5,2,7
11/03/15,2,9,747,350,159,12,1,0,13
11/03/15,2,10,3062,370,31,2,5,1,8
11/03/15,2,11,7652,355,148,11,9,5,25
11/03/15,2,13,542,350,136,18,7,1,26
11/03/15,2,14,3062,360,128,23,22,0,45
11/03/15,2,15,542,350,76,8,4,0,12
11/03/15,2,16,294,350,19,3,2,6,11
11/03/15,2,17,491,370,89,3,22,1,26
11/03/15,2,18,542,350,70,27,7,4,38
11/03/15,2,20,8040,350,18,2,6,3,11
11/03/15,2,21,497,350,113,22,0,0,22
11/03/15,2,22,542,350,56,7,10,0,17
11/03/15,2,24,285,360,116,13,8,1,22
11/03/15,2,25,715,375,91,1,17,0,18
11/03/15,2,27,542,360,54,33,1,0,34
11/03/15,2,28,8040,375,80,17,13,0,30
11/03/15,2,29,729,270,15,16,10,0,26
11/03/15,2,30,1001,270,49,28,13,0,41
11/03/15,3,1,738,305,34,5,9,7,21
11/03/15,3,3,996,220,57,0,0,0,0
11/03/15,3,4,5302,220,70,0,0,0,0
11/03/15,3,5,715,370,166,0,4,0,4
11/03/15,3,9,747,350,154,20,0,0,20
11/03/15,3,11,7652,355,114,15,8,5,28
11/03/15,3,13,542,350,126,21,15,3,39
11/03/15,3,14,3062,360,86,9,17,1,27
11/03/15,3,15,542,350,87,21,9,0,30
11/03/15,3,16,294,350,126,200,12,2,214
11/03/15,3,17,491,370,61,1,17,0,18
11/03/15,3,18,542,350,96,32,6,2,40
11/03/15,3,21,497,350,100,16,0,0,16
11/03/15,3,22,542,350,106,18,11,0,29
11/03/15,3,24,285,360,123,17,8,2,27
11/03/15,3,25,715,375,54,0,11,0,11
11/03/15,3,27,542,360,64,33,3,0,36
11/03/15,3,28,8040,375,113,24,13,1,38
11/03/15,3,30,1001,270,75,0,0,0,0
11/04/15,1,1,738,305,63,10,6,3,19
11/04/15,1,3,996,220,35,12,4,0,16
11/04/15,1,4,5302,220,76,16,3,0,19
11/04/15,1,5,715,370,152,0,8,3,11
11/04/15,1,9,747,350,132,32,1,5,38
11/04/15,1,10,8030,370,115,8,2,1,11
11/04/15,1,11,7652,355,121,30,13,2,45
11/04/15,1,13,542,350,123,22,6,3,31
11/04/15,1,15,542,350,133,13,14,0,27
11/04/15,1,16,294,350,130,21,18,4,43
11/04/15,1,17,491,370,156,5,6,0,11
11/04/15,1,18,542,350,111,14,16,0,30
11/04/15,1,20,8040,350,54,10,5,7,22
11/04/15,1,21,497,350,98,377,2,0,379
11/04/15,1,22,542,350,75,12,17,0,29
11/04/15,1,24,285,360,131,16,4,2,22
11/04/15,1,25,715,375,33,1,4,0,5
11/04/15,1,27,542,360,91,41,1,0,42
11/04/15,1,28,8040,375,74,13,17,0,30
11/04/15,2,1,738,305,116,13,18,1,32
11/04/15,2,3,996,220,75,15,3,0,18
11/04/15,2,4,5302,220,43,18,4,0,22
11/04/15,2,5,715,370,163,1,2,0,3
11/04/15,2,9,747,350,161,8,0,1,9
11/04/15,2,10,8030,370,128,2,3,8,13
11/04/15,2,11,7652,355,145,3,17,2,22
11/04/15,2,13,542,350,130,11,4,1,16
11/04/15,2,15,542,350,125,18,9,0,27
11/04/15,2,16,294,350,118,23,12,5,40
11/04/15,2,17,491,370,139,6,8,3,17
11/04/15,2,18,542,350,105,29,3,3,35
11/04/15,2,20,8040,350,95,38,17,4,59
11/04/15,2,21,497,350,85,26,5,0,31
11/04/15,2,22,542,350,56,7,10,0,17
11/04/15,2,24,285,360,132,7,9,0,16
11/04/15,2,27,542,360,70,34,1,0,35
11/04/15,2,28,8040,375,86,23,11,3,37
11/04/15,3,1,738,305,112,27,12,2,41
11/04/15,3,3,996,220,45,21,3,0,24
11/04/15,3,4,5302,220,24,22,2,0,24
11/04/15,3,5,715,370,156,3,4,0,7
11/04/15,3,9,747,350,160,6,2,2,10
11/04/15,3,10,8030,370,153,13,7,0,20
11/04/15,3,11,7652,355,133,20,15,2,37
11/04/15,3,13,542,350,32,8,0,0,8
11/04/15,3,15,542,350,69,11,3,0,14
11/04/15,3,16,294,350,132,33,12,1,46
11/04/15,3,17,491,370,80,4,7,0,11
11/04/15,3,18,542,350,53,5,9,3,17
11/04/15,3,20,8040,350,62,13,3,9,25
11/04/15,3,21,497,350,55,8,3,0,11
11/04/15,3,24,285,360,72,9,6,2,17
11/04/15,3,27,542,360,54,19,3,0,22
11/04/15,3,28,8040,375,14,0,0,0,0
11/04/15,3,30,1001,270,23,6,14,3,23
11/05/15,1,1,738,305,113,31,7,4,42
11/05/15,1,3,996,220,79,12,8,0,20
11/05/15,1,4,5302,220,63,21,3,0,24
11/05/15,1,5,715,370,161,0,7,0,7
11/05/15,1,9,747,350,158,6,3,1,10
11/05/15,1,10,8030,370,130,13,6,5,24
11/05/15,1,11,7652,355,129,14,12,2,28
11/05/15,1,13,542,350,57,6,2,1,9
11/05/15,1,15,542,350,132,9,7,0,16
11/05/15,1,16,294,350,83,59,10,2,71
11/05/15,1,17,491,370,104,10,5,7,22
11/05/15,1,18,542,350,106,17,11,3,31
11/05/15,1,20,8040,350,113,19,12,9,40
11/05/15,1,21,497,350,88,24,3,0,27
11/05/15,1,24,285,360,82,4,3,2,9
11/05/15,1,27,542,360,81,26,4,0,30
11/05/15,1,28,8040,375,97,11,15,5,31
11/05/15,1,29,737,270,80,15,2,0,17
11/05/15,1,30,1001,270,46,18,11,0,29
11/05/15,2,1,738,305,103,26,6,6,38
11/05/15,2,3,996,220,58,10,6,0,16
11/05/15,2,4,5302,220,71,20,2,0,22
11/05/15,2,5,715,370,164,3,7,0,10
11/05/15,2,9,747,350,166,2,3,1,6
11/05/15,2,10,8030,370,158,11,7,0,18
11/05/15,2,11,7652,355,99,14,24,4,42
11/05/15,2,14,3062,360,101,34,13,1,48
11/05/15,2,15,542,350,83,5,5,0,10
11/05/15,2,16,294,350,119,37,6,0,43
11/05/15,2,17,491,370,89,15,6,2,23
11/05/15,2,18,542,350,94,6,10,2,18
11/05/15,2,20,8040,350,74,23,5,15,43
11/05/15,2,21,497,350,71,21,1,0,22
11/05/15,2,27,542,360,61,26,3,0,29
11/05/15,2,28,8040,375,83,11,10,3,24
11/05/15,2,29,737,270,72,19,1,0,20
11/05/15,2,30,1001,270,43,15,12,0,27
11/05/15,3,1,738,305,24,5,2,1,8
11/05/15,3,4,5302,220,19,6,2,1,9
11/05/15,3,5,715,370,96,7,7,1,15
11/05/15,3,9,747,350,146,3,0,3,6
11/05/15,3,10,8030,370,95,11,1,1,13
11/05/15,3,13,542,350,31,6,3,10,19
11/05/15,3,14,3062,360,43,9,8,0,17
11/05/15,3,16,294,350,86,14,6,4,24
11/05/15,3,17,491,370,63,1,8,1,10
11/05/15,3,18,542,350,81,14,6,2,22
11/05/15,3,20,8040,350,27,12,3,2,17
11/05/15,3,21,497,350,39,14,0,0,14
11/05/15,3,27,542,360,73,28,5,0,33
11/05/15,3,28,8040,375,96,20,12,2,34
11/05/15,3,29,737,270,37,12,4,0,16
11/05/15,3,30,1001,270,76,20,8,0,28
11/06/15,1,1,738,305,105,30,11,7,48
11/06/15,1,3,996,220,53,17,6,0,23
11/06/15,1,4,5302,220,67,21,4,0,25
11/06/15,1,5,715,370,139,16,6,0,22
11/06/15,1,7,997,345,112,36,7,7,50
11/06/15,1,9,747,350,149,19,3,1,23
11/06/15,1,10,3062,370,126,19,3,3,25
11/06/15,1,13,542,350,84,15,7,1,23
11/06/15,1,14,3062,360,123,24,17,1,42
11/06/15,1,15,542,350,132,9,7,0,16
11/06/15,1,16,294,350,129,21,11,4,36
11/06/15,1,17,491,370,159,5,3,1,9
11/06/15,1,18,542,350,116,26,13,2,41
11/06/15,1,20,8040,350,97,43,10,5,58
11/06/15,1,21,497,350,64,22,6,0,28
11/06/15,1,24,7675,360,60,6,1,11,18
11/06/15,1,27,542,360,90,51,2,0,53
11/06/15,1,28,8032,375,95,12,22,1,35
11/06/15,1,29,729,270,85,15,6,0,21
11/06/15,1,30,1001,270,43,17,8,0,25
11/06/15,2,1,738,305,110,16,21,3,40
11/06/15,2,3,996,220,75,19,5,1,25
11/06/15,2,4,5302,220,66,20,5,0,25
11/06/15,2,5,715,370,158,12,4,1,17
11/06/15,2,7,997,345,121,12,3,3,18
11/06/15,2,9,747,350,152,19,1,0,20
11/06/15,2,10,3062,370,154,15,3,0,18
11/06/15,2,11,7652,355,59,10,14,9,33
11/06/15,2,13,542,350,85,28,22,0,50
11/06/15,2,14,3062,360,145,10,15,0,25
11/06/15,2,15,542,350,126,10,9,0,19
11/06/15,2,16,294,350,107,30,15,1,46
11/06/15,2,17,491,370,137,15,10,0,25
11/06/15,2,18,542,350,106,32,11,3,46
11/06/15,2,20,8040,350,108,36,13,4,53
11/06/15,2,21,497,350,72,21,1,0,22
11/06/15,2,24,7675,360,126,27,5,1,33
11/06/15,2,27,542,360,61,26,3,0,29
11/06/15,2,28,8032,375,121,24,18,3,45
11/06/15,2,29,729,270,88,16,5,0,21
11/06/15,2,30,1001,270,65,20,7,1,28
11/06/15,3,1,738,305,113,18,2,3,23
11/06/15,3,3,996,220,60,18,6,0,24
11/06/15,3,4,5302,220,59,23,5,1,29
11/06/15,3,5,715,370,158,3,8,1,12
11/06/15,3,9,747,350,109,46,0,2,48
11/06/15,3,10,3062,370,116,17,9,4,30
11/06/15,3,18,542,350,49,11,4,3,18
11/06/15,3,20,8040,350,49,30,9,18,57
11/06/15,3,24,7675,360,87,9,2,0,11
11/06/15,3,27,542,360,73,28,5,0,33
11/06/15,3,28,8032,375,86,1,31,0,32
11/06/15,3,29,729,270,45,24,6,0,30
11/06/15,3,30,1001,270,68,23,9,1,33
11/16/15,1,1,738,305,126,10,7,2,19
11/16/15,1,2,726,315,89,26,6,0,32
11/16/15,1,3,996,220,75,15,12,0,27
11/16/15,1,4,5302,220,22,8,0,0,8
11/16/15,1,5,8038,370,68,2,2,1,5
11/16/15,1,7,542,345,8,2,1,12,15
11/16/15,1,8,7742,350,142,21,7,8,36
11/16/15,1,9,747,350,170,0,1,0,1
11/16/15,1,10,8030,370,159,10,3,3,16
11/16/15,1,13,8030,350,34,3,3,5,11
11/16/15,1,14,8035,360,162,4,4,3,11
11/16/15,1,15,542,350,79,41,4,0,45
11/16/15,1,16,7649,350,133,18,7,3,28
11/16/15,1,17,8012,370,114,2,13,6,21
11/16/15,1,22,542,350,154,17,5,0,22
11/16/15,1,24,7675,360,98,10,4,7,21
11/16/15,1,26,542,360,61,20,6,0,26
11/16/15,1,28,7393,375,41,73,1,1,75
11/16/15,2,1,738,305,105,12,5,2,19
11/16/15,2,2,726,315,107,22,10,2,34
11/16/15,2,3,996,220,62,18,10,0,28
11/16/15,2,4,5302,220,58,26,3,0,29
11/16/15,2,5,8038,370,151,3,1,2,6
11/16/15,2,7,542,345,82,34,17,0,51
11/16/15,2,8,7742,350,123,18,10,5,33
11/16/15,2,9,747,350,148,11,2,3,16
11/16/15,2,10,8030,370,134,12,5,0,17
11/16/15,2,13,8030,350,118,18,12,1,31
11/16/15,2,14,8035,360,157,3,4,1,8
11/16/15,2,15,542,350,136,20,4,0,24
11/16/15,2,16,7649,350,145,11,6,5,22
11/16/15,2,17,8012,370,111,0,13,0,13
11/16/15,2,18,8003,350,43,71,7,20,98
11/16/15,2,22,542,350,111,16,16,0,32
11/16/15,2,24,7675,360,30,4,0,3,7
11/16/15,2,26,542,360,100,27,8,0,35
11/16/15,2,27,542,360,61,17,8,0,25
11/16/15,2,28,7393,375,54,78,0,1,79
11/16/15,3,1,738,305,31,8,3,8,19
11/16/15,3,2,726,315,77,28,1,1,30
11/16/15,3,3,996,220,63,10,5,0,15
11/16/15,3,4,5302,220,70,5,1,0,6
11/16/15,3,5,8038,370,160,10,2,0,12
11/16/15,3,7,542,345,108,43,9,2,54
11/16/15,3,8,7742,350,66,11,6,4,21
11/16/15,3,9,747,350,147,8,4,3,15
11/16/15,3,10,8030,370,149,14,6,2,22
11/16/15,3,13,8030,350,116,6,12,2,20
11/16/15,3,14,8035,360,148,4,3,1,8
11/16/15,3,15,542,350,89,24,1,0,25
11/16/15,3,16,7649,350,126,18,4,3,25
11/16/15,3,17,8012,370,62,5,10,1,16
11/16/15,3,18,8003,350,85,23,0,10,33
11/16/15,3,22,542,350,134,20,12,0,32
11/16/15,3,26,542,360,105,39,16,0,55
11/16/15,3,27,542,360,107,45,7,0,52
11/16/15,3,28,7393,375,79,94,2,1,97
11/16/15,3,29,737,270,15,4,0,0,4
11/17/15,1,1,738,305,101,26,8,0,34
11/17/15,1,2,726,315,70,36,3,1,40
11/17/15,1,3,996,220,59,18,15,0,33
11/17/15,1,4,5302,220,76,21,3,0,24
11/17/15,1,5,8038,370,167,2,1,1,4
11/17/15,1,7,542,345,100,32,8,3,43
11/17/15,1,9,747,350,158,2,5,5,12
11/17/15,1,10,8030,370,153,11,3,0,14
11/17/15,1,11,7652,355,115,26,20,1,47
11/17/15,1,12,8032,350,64,11,10,8,29
11/17/15,1,13,8030,350,75,4,12,4,20
11/17/15,1,14,8035,360,163,0,7,1,8
11/17/15,1,15,542,350,98,2,2,0,4
11/17/15,1,16,7649,350,120,24,12,1,37
11/17/15,1,17,8012,370,157,2,6,2,10
11/17/15,1,18,8003,350,91,39,2,23,64
11/17/15,1,19,774,360,52,1,4,0,5
11/17/15,1,22,542,350,117,24,16,0,40
11/17/15,1,24,7675,360,32,5,0,78,83
11/17/15,1,26,542,360,75,37,8,0,45
11/17/15,1,27,542,360,109,27,6,0,33
11/17/15,1,28,7393,375,80,20,2,3,25
11/17/15,1,29,737,270,49,23,6,0,29
11/17/15,2,1,738,305,90,0,7,5,12
11/17/15,2,2,726,315,111,24,5,3,32
11/17/15,2,3,996,220,22,8,3,0,11
11/17/15,2,4,5302,220,65,23,6,0,29
11/17/15,2,5,8038,370,164,0,0,1,1
11/17/15,2,7,542,345,94,47,7,2,56
11/17/15,2,9,747,350,145,8,0,1,9
11/17/15,2,10,8030,370,100,14,7,3,24
11/17/15,2,11,7652,355,101,21,16,2,39
11/17/15,2,12,8032,350,115,16,16,0,32
11/17/15,2,13,8030,350,104,3,14,2,19
11/17/15,2,14,8035,360,8,0,2,2,4
11/17/15,2,15,542,350,8,1,2,0,3
11/17/15,2,16,7649,350,34,7,5,1,13
11/17/15,2,17,8012,370,129,4,7,1,12
11/17/15,2,18,8003,350,103,33,0,10,43
11/17/15,2,19,774,360,114,4,14,0,18
11/17/15,2,20,8040,350,23,6,4,8,18
11/17/15,2,22,542,350,43,6,7,0,13
11/17/15,2,24,7675,360,111,10,3,4,17
11/17/15,2,26,542,360,26,17,2,0,19
11/17/15,2,27,542,360,66,24,1,0,25
11/17/15,2,28,7393,375,116,15,9,2,26
11/17/15,2,29,737,270,37,29,6,0,35
11/17/15,3,1,738,305,113,20,9,2,31
11/17/15,3,2,726,315,127,24,8,2,34
11/17/15,3,3,996,220,4,1,1,0,2
11/17/15,3,4,5302,220,77,20,4,1,25
11/17/15,3,5,8038,370,163,2,2,3,7
11/17/15,3,7,542,345,114,37,7,2,46
11/17/15,3,9,747,350,157,7,5,3,15
11/17/15,3,11,7652,355,90,11,21,4,36
11/17/15,3,12,8032,350,130,18,8,0,26
11/17/15,3,13,8030,350,106,19,15,8,42
11/17/15,3,14,8035,360,12,0,11,6,17
11/17/15,3,15,542,350,101,5,5,0,10
11/17/15,3,17,8012,370,82,0,7,1,8
11/17/15,3,18,8003,350,63,30,9,0,39
11/17/15,3,19,774,360,115,4,6,0,10
11/17/15,3,20,8040,350,80,12,10,2,24
11/17/15,3,22,542,350,87,7,9,0,16
11/17/15,3,24,7675,360,78,5,3,3,11
11/17/15,3,27,542,360,91,9,2,0,11
11/17/15,3,28,7393,375,84,12,2,1,15
11/17/15,3,29,737,270,30,25,7,0,32
11/18/15,1,1,738,305,88,20,12,7,39
11/18/15,1,2,726,315,111,21,10,2,33
11/18/15,1,3,996,220,70,15,6,0,21
11/18/15,1,4,5302,220,74,22,3,0,25
11/18/15,1,5,8038,370,165,2,0,3,5
11/18/15,1,7,542,345,94,43,7,9,59
11/18/15,1,8,7742,350,19,2,0,2,4
11/18/15,1,9,747,350,147,10,3,2,15
11/18/15,1,10,8030,370,103,4,7,4,15
11/18/15,1,11,7652,355,109,21,32,1,54
11/18/15,1,12,8032,350,129,7,12,2,21
11/18/15,1,13,8030,350,136,9,17,1,27
11/18/15,1,14,8035,360,152,3,6,3,12
11/18/15,1,15,542,350,153,9,2,0,11
11/18/15,1,17,8012,370,154,1,5,0,6
11/18/15,1,18,8003,350,122,37,3,4,44
11/18/15,1,19,774,360,130,4,15,0,19
11/18/15,1,20,8040,350,109,23,7,8,38
11/18/15,1,22,542,350,127,20,8,0,28
11/18/15,1,24,7675,360,135,12,2,10,24
11/18/15,1,26,542,360,19,6,1,0,7
11/18/15,1,27,542,360,124,29,7,0,36
11/18/15,1,28,7393,375,124,12,5,0,17
11/18/15,1,29,737,270,76,22,3,0,25
11/18/15,2,1,738,305,119,13,2,3,18
11/18/15,2,2,726,315,109,23,9,2,34
11/18/15,2,3,996,220,62,17,7,0,24
11/18/15,2,4,5302,220,71,21,2,0,23
11/18/15,2,5,8038,370,158,0,2,1,3
11/18/15,2,7,542,345,110,15,10,1,26
11/18/15,2,9,747,350,160,5,0,1,6
11/18/15,2,10,8030,370,122,7,3,6,16
11/18/15,2,11,7652,355,86,3,14,0,17
11/18/15,2,12,8032,350,136,5,10,1,16
11/18/15,2,13,8030,350,90,2,21,2,25
11/18/15,2,14,8035,360,153,0,6,2,8
11/18/15,2,15,542,350,152,4,3,0,7
11/18/15,2,17,8012,370,116,0,5,1,6
11/18/15,2,18,8003,350,107,16,6,1,23
11/18/15,2,19,774,360,85,10,7,0,17
11/18/15,2,20,8040,350,82,8,7,5,20
11/18/15,2,22,542,350,61,13,9,0,22
11/18/15,2,24,7675,360,107,7,3,6,16
11/18/15,2,26,542,360,23,9,1,0,10
11/18/15,2,27,542,360,80,30,3,0,33
11/18/15,2,28,7393,375,50,13,6,4,23
11/18/15,2,29,737,270,53,26,2,0,28
11/18/15,3,1,738,305,110,19,5,5,29
11/18/15,3,2,726,315,101,31,19,3,53
11/18/15,3,3,996,220,76,14,5,0,19
11/18/15,3,4,5302,220,40,11,1,0,12
11/18/15,3,7,542,345,107,24,4,24,52
11/18/15,3,9,747,350,157,3,3,3,9
11/18/15,3,10,8030,370,160,0,3,1,4
11/18/15,3,11,7652,355,107,22,20,3,45
11/18/15,3,12,8032,350,132,3,17,2,22
11/18/15,3,13,8030,350,142,7,13,1,21
11/18/15,3,14,8035,360,167,0,6,1,7
11/18/15,3,15,542,350,152,1,6,0,7
11/18/15,3,17,8012,370,56,0,5,2,7
11/18/15,3,18,8003,350,21,2,3,0,5
11/18/15,3,19,774,360,100,33,15,0,48
11/18/15,3,20,8040,350,86,27,6,10,43
11/18/15,3,24,7675,360,101,15,3,7,25
11/18/15,3,25,715,375,43,1,13,0,14
11/18/15,3,27,542,360,91,9,2,0,11
11/18/15,3,29,737,270,71,21,3,0,24
11/19/15,1,1,738,305,126,16,3,3,22
11/19/15,1,2,726,315,123,27,7,0,34
11/19/15,1,3,996,220,50,26,12,0,38
11/19/15,1,4,5302,220,35,10,3,0,13
11/19/15,1,7,542,345,126,41,3,1,45
11/19/15,1,8,7742,350,73,11,6,1,18
11/19/15,1,9,747,350,164,3,3,1,7
11/19/15,1,10,8030,370,158,5,1,2,8
11/19/15,1,11,7652,355,127,30,17,3,50
11/19/15,1,12,8032,350,132,15,15,5,35
11/19/15,1,13,8030,350,146,1,16,9,26
11/19/15,1,14,8035,360,164,2,6,1,9
11/19/15,1,15,542,350,141,16,6,0,22
11/19/15,1,16,7649,350,4,4,5,6,15
11/19/15,1,17,8012,370,164,0,4,0,4
11/19/15,1,18,8003,350,122,37,3,4,44
11/19/15,1,19,774,360,147,7,15,0,22
11/19/15,1,20,8040,350,9,2,2,2,6
11/19/15,1,24,7675,360,90,6,3,9,18
11/19/15,1,25,715,375,76,6,25,0,31
11/19/15,1,27,542,360,120,18,12,0,30
11/19/15,1,29,737,270,3,1,0,0,1
11/19/15,2,1,738,305,102,19,4,5,28
11/19/15,2,2,726,315,42,24,5,8,37
11/19/15,2,3,996,220,40,28,15,0,43
11/19/15,2,4,5302,220,56,18,2,0,20
11/19/15,2,7,542,345,111,28,4,2,34
11/19/15,2,9,747,350,166,2,0,4,6
11/19/15,2,10,8030,370,158,8,1,1,10
11/19/15,2,11,7652,355,125,13,12,3,28
11/19/15,2,12,8032,350,134,6,21,3,30
11/19/15,2,13,8030,350,91,20,9,3,32
11/19/15,2,14,8035,360,159,2,5,2,9
11/19/15,2,15,542,350,110,20,3,0,23
11/19/15,2,16,7649,350,88,23,22,5,50
11/19/15,2,17,8012,370,129,0,2,4,6
11/19/15,2,18,8003,350,107,16,6,1,23
11/19/15,2,19,774,360,120,5,20,0,25
11/19/15,2,22,542,350,40,3,6,0,9
11/19/15,2,25,715,375,94,2,16,0,18
11/19/15,2,26,542,360,39,20,3,0,23
11/19/15,2,27,542,360,101,13,9,0,22
11/19/15,2,28,7393,375,59,59,5,12,76
11/19/15,2,29,737,270,57,12,19,0,31
11/19/15,3,1,738,305,69,17,5,10,32
11/19/15,3,2,726,315,95,28,16,0,44
11/19/15,3,3,996,220,61,25,12,0,37
11/19/15,3,4,5302,220,53,21,10,0,31
11/19/15,3,7,542,345,120,33,9,3,45
11/19/15,3,8,7742,350,5,2,1,0,3
11/19/15,3,9,747,350,165,3,1,3,7
11/19/15,3,10,8030,370,162,7,1,0,8
11/19/15,3,11,7652,355,105,40,23,5,68
11/19/15,3,12,8032,350,144,8,13,1,22
11/19/15,3,13,8030,350,69,52,7,1,60
11/19/15,3,14,8035,360,157,1,3,1,5
11/19/15,3,15,542,350,62,14,3,0,17
11/19/15,3,16,7649,350,119,19,11,8,38
11/19/15,3,17,8012,370,51,0,1,2,3
11/19/15,3,19,774,360,129,4,8,0,12
11/19/15,3,20,8040,350,67,8,6,1,15
11/19/15,3,22,542,350,112,8,8,0,16
11/19/15,3,25,715,375,31,0,8,0,8
11/19/15,3,26,542,360,79,60,5,0,65
11/19/15,3,27,542,360,113,23,11,0,34
11/19/15,3,28,7393,375,93,30,4,3,37
11/19/15,3,29,737,270,97,16,10,2,28
11/20/15,1,1,738,305,104,27,4,2,33
11/20/15,1,2,726,315,114,14,10,3,27
11/20/15,1,3,996,220,84,13,8,1,22
11/20/15,1,4,5302,220,63,17,10,0,27
11/20/15,1,7,542,345,132,17,8,0,25
11/20/15,1,8,7742,350,100,28,8,15,51
11/20/15,1,9,747,350,156,3,1,3,7
11/20/15,1,10,8030,370,160,5,0,3,8
11/20/15,1,11,7652,355,112,10,10,9,29
11/20/15,1,12,8032,350,130,9,16,0,25
11/20/15,1,13,8030,350,110,2,23,3,28
11/20/15,1,14,8035,360,160,0,4,2,6
11/20/15,1,15,542,350,139,19,3,0,22
11/20/15,1,16,285,350,130,28,7,3,38
11/20/15,1,17,8012,370,150,2,2,1,5
11/20/15,1,19,774,360,140,8,11,0,19
11/20/15,1,20,8040,350,120,18,14,2,34
11/20/15,1,22,542,350,119,7,15,0,22
11/20/15,1,25,715,375,126,1,17,0,18
11/20/15,1,26,542,360,75,40,12,0,52
11/20/15,1,27,542,360,136,23,9,0,32
11/20/15,1,28,7393,375,102,28,3,3,34
11/20/15,1,29,737,270,18,6,2,0,8
11/20/15,2,1,738,305,99,21,5,1,27
11/20/15,2,2,726,315,88,18,14,1,33
11/20/15,2,3,996,220,49,21,10,0,31
11/20/15,2,4,5302,220,24,24,11,0,35
11/20/15,2,7,542,345,108,24,6,2,32
11/20/15,2,8,7742,350,83,32,4,1,37
11/20/15,2,9,747,350,167,1,2,1,4
11/20/15,2,10,8030,370,164,5,1,0,6
11/20/15,2,11,7652,355,92,6,19,2,27
11/20/15,2,12,8032,350,65,4,10,0,14
11/20/15,2,13,8030,350,123,0,15,1,16
11/20/15,2,14,8035,360,156,0,5,1,6
11/20/15,2,15,542,350,131,12,6,0,18
11/20/15,2,16,285,350,107,22,16,4,42
11/20/15,2,17,8012,370,143,0,5,0,5
11/20/15,2,19,774,360,144,4,5,0,9
11/20/15,2,20,8040,350,70,39,10,8,57
11/20/15,2,22,542,350,120,5,7,0,12
11/20/15,2,25,715,375,78,1,13,0,14
11/20/15,2,26,542,360,77,24,9,0,33
11/20/15,2,27,542,360,77,17,5,0,22
11/20/15,2,28,7393,375,75,27,5,2,34
11/20/15,2,29,737,270,63,19,6,0,25
11/20/15,3,1,738,305,99,30,2,5,37
11/20/15,3,2,726,315,87,40,15,3,58
11/20/15,3,4,5302,220,55,20,9,0,29
11/20/15,3,7,542,345,100,16,9,5,30
11/20/15,3,8,7742,350,87,36,34,9,79
11/20/15,3,9,747,350,148,1,16,4,21
11/20/15,3,10,8030,370,155,6,4,2,12
11/20/15,3,11,7652,355,127,17,13,4,34
11/20/15,3,13,8030,350,140,3,12,1,16
11/20/15,3,14,8035,360,167,0,4,4,8
11/20/15,3,15,542,350,82,9,4,0,13
11/20/15,3,16,285,350,98,55,12,6,73
11/20/15,3,17,8012,370,64,2,2,3,7
11/20/15,3,19,774,360,116,7,9,0,16
11/20/15,3,20,8040,350,90,22,5,4,31
11/20/15,3,22,542,350,83,13,11,0,24
11/20/15,3,25,715,375,31,0,8,0,8
11/20/15,3,26,542,360,50,36,3,0,39
11/20/15,3,27,542,360,95,12,9,0,21
11/20/15,3,28,7393,375,79,25,3,2,30
11/20/15,3,29,737,270,77,20,7,0,27
11/23/15,1,1,738,305,114,27,4,2,33
11/23/15,1,2,726,315,110,32,11,5,48
11/23/15,1,3,996,220,44,10,5,0,15
11/23/15,1,4,5302,220,48,26,3,0,29
11/23/15,1,7,542,345,119,25,8,1,34
11/23/15,1,8,7742,350,108,19,8,4,31
11/23/15,1,9,747,350,163,4,2,0,6
11/23/15,1,10,8030,370,165,3,0,0,3
11/23/15,1,11,7652,355,127,3,19,3,25
11/23/15,1,13,8030,350,116,1,13,0,14
11/23/15,1,14,8035,360,158,0,4,1,5
11/23/15,1,15,542,350,99,25,6,0,31
11/23/15,1,16,285,350,107,25,13,3,41
11/23/15,1,19,774,360,134,4,6,0,10
11/23/15,1,20,8040,350,114,18,7,0,25
11/23/15,1,22,542,350,65,27,6,0,33
11/23/15,1,24,7675,360,35,3,1,3,7
11/23/15,1,25,715,375,94,0,13,0,13
11/23/15,1,26,542,360,76,24,11,0,35
11/23/15,1,27,542,360,157,11,5,0,16
11/23/15,1,28,7393,375,100,20,6,1,27
11/23/15,1,29,737,270,63,18,5,0,23
11/23/15,1,30,737,270,9,6,1,0,7
11/23/15,2,1,738,305,103,17,6,3,26
11/23/15,2,2,726,315,90,15,12,6,33
11/23/15,2,3,996,220,78,12,10,0,22
11/23/15,2,4,5302,220,20,12,1,0,13
11/23/15,2,7,542,345,38,2,4,0,6
11/23/15,2,8,7742,350,89,11,13,4,28
11/23/15,2,9,747,350,164,5,1,1,7
11/23/15,2,10,8030,370,154,8,0,1,9
11/23/15,2,11,7652,355,123,17,16,3,36
11/23/15,2,13,8030,350,118,2,10,0,12
11/23/15,2,14,8035,360,165,0,4,2,6
11/23/15,2,15,542,350,118,20,3,0,23
11/23/15,2,16,285,350,119,33,6,3,42
11/23/15,2,18,8003,350,1,16,0,7,23
11/23/15,2,20,8040,350,98,15,11,2,28
11/23/15,2,22,542,350,35,39,3,0,42
11/23/15,2,24,7675,360,101,8,9,7,24
11/23/15,2,25,715,375,96,1,22,0,23
11/23/15,2,26,542,360,79,27,9,0,36
11/23/15,2,27,542,360,99,16,7,0,23
11/23/15,2,28,7393,375,107,21,5,3,29
11/23/15,2,29,737,270,58,20,6,0,26
11/23/15,2,30,737,270,30,28,6,0,34
11/23/15,3,1,738,305,119,29,3,2,34
11/23/15,3,2,726,315,111,23,15,3,41
11/23/15,3,3,996,220,76,13,9,0,22
11/23/15,3,7,542,345,15,4,3,7,14
11/23/15,3,8,7742,350,146,13,7,5,25
11/23/15,3,9,747,350,164,4,5,2,11
11/23/15,3,10,8030,370,161,7,3,1,11
11/23/15,3,11,7652,355,131,14,9,2,25
11/23/15,3,12,8032,350,36,45,11,9,65
11/23/15,3,13,8030,350,146,0,17,1,18
11/23/15,3,14,8035,360,77,1,2,3,6
11/23/15,3,15,542,350,70,16,5,0,21
11/23/15,3,16,285,350,134,37,10,2,49
11/23/15,3,18,8003,350,31,30,21,0,51
11/23/15,3,20,8040,350,107,9,8,4,21
11/23/15,3,22,542,350,42,36,2,0,38
11/23/15,3,24,7675,360,93,10,4,4,18
11/23/15,3,25,715,375,75,1,13,0,14
11/23/15,3,26,542,360,120,17,8,0,25
11/23/15,3,28,7393,375,43,37,1,3,41
11/23/15,3,29,737,270,80,25,8,6,39
11/23/15,3,30,737,270,38,22,7,0,29
11/24/15,1,1,738,305,119,19,8,3,30
11/24/15,1,2,726,315,132,14,8,2,24
11/24/15,1,3,996,220,63,15,10,0,25
11/24/15,1,5,3062,370,82,6,19,4,29
11/24/15,1,7,542,345,120,30,8,0,38
11/24/15,1,8,7742,350,118,21,9,2,32
11/24/15,1,9,747,350,23,1,1,0,2
11/24/15,1,10,8030,370,162,4,2,4,10
11/24/15,1,11,7652,355,78,12,9,2,23
11/24/15,1,12,8032,350,107,17,11,6,34
11/24/15,1,13,8030,350,135,2,13,0,15
11/24/15,1,15,542,350,152,9,1,0,10
11/24/15,1,16,285,350,96,29,11,9,49
11/24/15,1,18,8003,350,41,19,18,1,38
11/24/15,1,20,8040,350,99,15,11,0,26
11/24/15,1,22,542,350,57,35,1,0,36
11/24/15,1,24,7675,360,131,7,13,8,28
11/24/15,1,25,715,375,87,0,18,0,18
11/24/15,1,26,542,360,119,28,6,0,34
11/24/15,1,28,7393,375,31,11,4,3,18
11/24/15,1,29,737,270,89,12,6,0,18
11/24/15,1,30,737,270,27,10,28,0,38
11/24/15,2,1,738,305,113,22,2,3,27
11/24/15,2,2,726,315,109,17,10,4,31
11/24/15,2,3,996,220,69,18,9,0,27
11/24/15,2,4,5302,220,60,24,3,0,27
11/24/15,2,5,3062,370,124,9,9,0,18
11/24/15,2,7,542,345,113,9,3,0,12
11/24/15,2,8,7742,350,104,23,9,3,35
11/24/15,2,10,8030,370,152,2,4,0,6
11/24/15,2,12,8032,350,33,7,4,1,12
11/24/15,2,13,8030,350,101,3,13,8,24
11/24/15,2,15,542,350,8,1,0,0,1
11/24/15,2,16,285,350,26,10,2,2,14
11/24/15,2,18,8003,350,55,25,20,3,48
11/24/15,2,20,8040,350,122,19,9,3,31
11/24/15,2,22,542,350,87,15,9,0,24
11/24/15,2,23,641,350,48,39,6,0,45
11/24/15,2,24,7675,360,136,8,6,5,19
11/24/15,2,25,715,375,98,1,15,0,16
11/24/15,2,26,542,360,68,23,7,0,30
11/24/15,2,27,542,360,6,8,0,0,8
11/24/15,2,29,737,270,64,23,10,0,33
11/24/15,2,30,737,270,24,9,27,0,36
11/24/15,3,1,738,305,168,30,2,1,33
11/24/15,3,2,726,315,122,29,4,4,37
11/24/15,3,3,996,220,89,19,10,0,29
11/24/15,3,4,5302,220,72,21,4,0,25
11/24/15,3,5,3062,370,116,13,23,7,43
11/24/15,3,7,542,345,116,43,7,2,52
11/24/15,3,8,7742,350,122,19,14,5,38
11/24/15,3,10,8030,370,162,4,2,1,7
11/24/15,3,12,8032,350,95,20,10,4,34
11/24/15,3,13,8030,350,149,0,11,2,13
11/24/15,3,15,542,350,43,8,3,0,11
11/24/15,3,18,8003,350,54,30,18,0,48
11/24/15,3,20,8040,350,84,14,8,3,25
11/24/15,3,22,542,350,102,22,6,0,28
11/24/15,3,23,641,350,87,31,4,0,35
11/24/15,3,24,7675,360,114,13,4,5,22
11/24/15,3,25,715,375,77,0,11,0,11
11/24/15,3,26,542,360,70,30,11,0,41
11/24/15,3,27,542,360,100,28,6,0,34
11/24/15,3,29,737,270,79,22,11,0,33
11/24/15,3,30,737,270,49,17,25,0,42
11/25/15,1,1,738,305,116,27,0,3,30
11/25/15,1,2,726,315,127,20,4,1,25
11/25/15,1,3,996,220,70,8,7,0,15
11/25/15,1,4,5302,220,65,21,2,0,23
11/25/15,1,5,3062,370,141,4,20,2,26
11/25/15,1,7,542,345,112,33,9,9,51
11/25/15,1,8,7742,350,137,23,7,5,35
11/25/15,1,10,8030,370,162,3,6,0,9
11/25/15,1,11,7652,355,44,12,9,6,27
11/25/15,1,12,294,350,100,29,15,4,48
11/25/15,1,13,8030,350,135,3,13,0,16
11/25/15,1,15,542,350,118,21,6,0,27
11/25/15,1,17,435,370,2,0,1,0,1
11/25/15,1,18,542,350,74,19,23,0,42
11/25/15,1,20,8040,350,87,24,8,1,33
11/25/15,1,22,542,350,112,11,9,0,20
11/25/15,1,23,641,350,126,6,6,0,12
11/25/15,1,24,7675,360,76,7,4,3,14
11/25/15,1,25,715,375,124,1,17,0,18
11/25/15,1,26,542,360,85,40,7,0,47
11/25/15,1,27,542,360,106,20,8,0,28
11/25/15,1,29,737,270,80,12,3,0,15
11/25/15,1,30,737,270,36,12,29,0,41
11/25/15,2,1,738,305,112,25,7,0,32
11/25/15,2,2,726,315,92,22,6,0,28
11/25/15,2,3,996,220,7,2,1,0,3
11/25/15,2,4,5302,220,45,19,3,0,22
11/25/15,2,5,3062,370,111,2,19,0,21
11/25/15,2,7,542,345,95,44,5,7,56
11/25/15,2,8,7742,350,129,21,7,2,30
11/25/15,2,10,8030,370,154,2,5,0,7
11/25/15,2,11,7652,355,105,16,9,3,28
11/25/15,2,12,294,350,57,17,1,0,18
11/25/15,2,13,8030,350,116,5,12,4,21
11/25/15,2,14,8035,360,2,19,1,3,23
11/25/15,2,15,542,350,107,6,8,0,14
11/25/15,2,17,435,370,72,1,19,1,21
11/25/15,2,18,542,350,84,21,10,0,31
11/25/15,2,20,8040,350,92,15,13,5,33
11/25/15,2,22,542,350,102,24,2,0,26
11/25/15,2,23,641,350,118,8,6,0,14
11/25/15,2,25,715,375,92,0,25,0,25
11/25/15,2,26,542,360,53,23,5,0,28
11/25/15,2,27,542,360,75,10,5,0,15
11/25/15,2,29,737,270,50,15,4,0,19
11/25/15,2,30,737,270,47,16,25,0,41
11/25/15,3,1,738,305,97,21,8,0,29
11/25/15,3,3,996,220,55,22,3,1,26
11/25/15,3,4,5302,220,60,20,2,0,22
11/25/15,3,5,3062,370,125,2,15,2,19
11/25/15,3,7,542,345,61,22,2,1,25
11/25/15,3,8,7742,350,70,10,4,3,17
11/25/15,3,10,8030,370,156,2,1,1,4
11/25/15,3,11,7652,355,109,28,10,3,41
11/25/15,3,12,294,350,110,14,15,5,34
11/25/15,3,13,8030,350,77,2,6,2,10
11/25/15,3,15,542,350,9,0,0,0,0
11/25/15,3,17,435,370,26,1,1,0,2
11/25/15,3,18,542,350,18,1,7,1,9
11/25/15,3,20,8040,350,28,0,4,5,9
11/25/15,3,22,542,350,26,5,7,0,12
11/25/15,3,23,641,350,26,3,0,0,3
11/25/15,3,25,715,375,77,0,11,0,11
11/25/15,3,26,542,360,28,17,3,0,20
11/25/15,3,27,542,360,29,7,1,0,8
11/25/15,3,29,737,270,40,11,2,0,13
11/25/15,3,30,737,270,23,10,12,0,22
11/30/15,1,1,738,305,121,26,8,4,38
11/30/15,1,2,726,315,73,13,26,3,42
11/30/15,1,3,996,220,50,28,10,0,38
11/30/15,1,4,5302,220,72,21,3,0,24
11/30/15,1,5,3062,370,126,9,21,1,31
11/30/15,1,7,542,345,130,21,6,2,29
11/30/15,1,8,7742,350,87,7,20,5,32
11/30/15,1,10,8030,370,154,8,1,0,9
11/30/15,1,11,7652,355,133,38,7,2,47
11/30/15,1,12,8032,350,80,12,5,3,20
11/30/15,1,15,542,350,171,7,2,0,9
11/30/15,1,17,542,370,150,1,2,5,8
11/30/15,1,18,8003,350,113,12,24,2,38
11/30/15,1,20,8040,350,116,32,8,2,42
11/30/15,1,22,542,350,96,23,9,0,32
11/30/15,1,23,641,350,133,13,3,0,16
11/30/15,1,24,7675,360,20,0,3,11,14
11/30/15,1,25,715,375,66,0,19,0,19
11/30/15,1,26,542,360,99,25,13,0,38
11/30/15,1,27,542,360,63,10,5,0,15
11/30/15,1,28,8040,375,9,0,3,16,19
11/30/15,1,29,737,270,90,16,15,0,31
11/30/15,1,30,737,270,18,35,6,0,41
11/30/15,2,1,738,305,113,34,10,4,48
11/30/15,2,2,726,315,122,12,21,4,37
11/30/15,2,3,996,220,68,18,9,0,27
11/30/15,2,4,5302,220,74,19,2,0,21
11/30/15,2,5,3062,370,149,8,13,1,22
11/30/15,2,7,542,345,121,24,5,1,30
11/30/15,2,8,7742,350,100,20,14,1,35
11/30/15,2,10,8030,370,146,11,3,0,14
11/30/15,2,11,7652,355,121,38,6,4,48
11/30/15,2,15,542,350,122,7,3,0,10
11/30/15,2,17,542,370,158,1,2,1,4
11/30/15,2,18,8003,350,63,9,21,0,30
11/30/15,2,20,8040,350,84,19,12,6,37
11/30/15,2,22,542,350,76,19,2,0,21
11/30/15,2,23,641,350,104,2,1,0,3
11/30/15,2,24,7675,360,87,11,6,9,26
11/30/15,2,25,715,375,61,1,11,0,12
11/30/15,2,26,542,360,70,17,4,0,21
11/30/15,2,27,542,360,89,20,5,0,25
11/30/15,2,28,8040,375,80,2,12,2,16
11/30/15,2,29,737,270,56,26,12,0,38
11/30/15,2,30,737,270,19,42,3,0,45
11/30/15,3,1,738,305,114,34,6,3,43
11/30/15,3,2,726,315,106,27,17,4,48
11/30/15,3,3,996,220,73,19,6,0,25
11/30/15,3,4,5302,220,72,20,1,0,21
11/30/15,3,5,3062,370,150,5,13,2,20
11/30/15,3,7,542,345,135,34,6,0,40
11/30/15,3,8,7742,350,126,22,14,8,44
11/30/15,3,10,8030,370,27,2,2,0,4
11/30/15,3,11,7652,355,144,0,11,1,12
11/30/15,3,14,542,360,24,3,13,2,18
11/30/15,3,15,542,350,57,8,3,0,11
11/30/15,3,17,542,370,124,2,1,0,3
11/30/15,3,18,8003,350,53,7,4,1,12
11/30/15,3,20,8040,350,76,9,5,2,16
11/30/15,3,21,497,350,27,3,13,0,16
11/30/15,3,22,542,350,77,9,4,0,13
11/30/15,3,24,7675,360,88,6,4,6,16
11/30/15,3,25,715,375,43,0,5,0,5
11/30/15,3,26,542,360,84,24,5,0,29
11/30/15,3,27,542,360,117,23,3,0,26
11/30/15,3,28,8040,375,80,5,9,3,17
11/30/15,3,29,737,270,65,24,11,0,35
11/30/15,3,30,737,270,32,32,3,0,35
12/01/15,1,1,738,305,120,31,7,3,41
12/01/15,1,2,726,315,119,38,9,3,50
12/01/15,1,3,996,220,70,12,6,0,18
12/01/15,1,4,5302,220,76,19,3,0,22
12/01/15,1,5,3062,370,150,6,13,3,22
12/01/15,1,7,542,345,125,38,5,0,43
12/01/15,1,8,7742,350,102,17,14,10,41
12/01/15,1,11,7652,355,125,33,8,2,43
12/01/15,1,13,3062,350,20,4,3,7,14
12/01/15,1,14,8035,360,118,36,2,2,40
12/01/15,1,15,542,350,142,7,4,0,11
12/01/15,1,17,542,370,147,5,0,2,7
12/01/15,1,18,8003,350,92,24,19,0,43
12/01/15,1,20,8040,350,107,25,11,5,41
12/01/15,1,21,exp,350,9,2,8,0,10
12/01/15,1,22,542,350,134,12,5,0,17
12/01/15,1,23,641,350,106,1,5,0,6
12/01/15,1,24,7675,360,136,12,6,8,26
12/01/15,1,25,715,375,101,0,18,0,18
12/01/15,1,26,542,360,40,6,1,0,7
12/01/15,1,27,542,360,108,28,2,0,30
12/01/15,1,28,8040,375,97,12,13,3,28
12/01/15,1,29,737,270,97,27,18,0,45
12/01/15,1,30,737,270,45,23,18,0,41
12/01/15,2,1,738,305,100,20,9,5,34
12/01/15,2,2,726,315,119,21,12,2,35
12/01/15,2,3,996,220,68,13,5,0,18
12/01/15,2,4,5302,220,74,18,4,0,22
12/01/15,2,5,3062,370,140,3,14,3,20
12/01/15,2,7,542,345,113,28,10,2,40
12/01/15,2,11,7652,355,100,29,13,6,48
12/01/15,2,13,3062,350,117,18,14,2,34
12/01/15,2,14,8035,360,62,102,1,1,104
12/01/15,2,15,542,350,110,5,4,0,9
12/01/15,2,17,542,370,130,0,2,1,3
12/01/15,2,18,8003,350,55,17,15,1,33
12/01/15,2,20,8040,350,66,16,6,9,31
12/01/15,2,21,exp,350,6,2,9,0,11
12/01/15,2,22,542,350,75,7,8,0,15
12/01/15,2,24,7675,360,98,9,5,5,19
12/01/15,2,25,715,375,68,2,2,0,4
12/01/15,2,26,542,360,92,3,10,2,15
12/01/15,2,27,542,360,74,15,3,0,18
12/01/15,2,28,8040,375,101,11,14,0,25
12/01/15,2,29,737,270,66,0,0,0,0
12/01/15,2,30,737,270,32,0,0,0,0
12/01/15,3,2,726,315,106,26,7,9,42
12/01/15,3,3,996,220,74,12,4,1,17
12/01/15,3,4,5302,220,49,21,5,0,26
12/01/15,3,5,3062,370,157,9,12,1,22
12/01/15,3,7,542,345,119,59,11,3,73
12/01/15,3,9,542,350,85,22,12,2,36
12/01/15,3,11,7652,355,119,15,17,9,41
12/01/15,3,13,3062,350,141,11,12,2,25
12/01/15,3,14,8035,360,115,57,4,1,62
12/01/15,3,15,542,350,100,6,1,0,7
12/01/15,3,17,542,370,85,2,1,1,4
12/01/15,3,18,8003,350,59,14,4,1,19
12/01/15,3,19,642,360,27,17,8,0,25
12/01/15,3,20,8040,350,73,6,9,5,20
12/01/15,3,22,542,350,86,9,1,0,10
12/01/15,3,24,7675,360,84,6,4,5,15
12/01/15,3,26,542,360,38,2,7,0,9
12/01/15,3,27,542,360,82,14,1,0,15
12/01/15,3,28,8040,375,93,10,4,0,14
12/01/15,3,29,737,270,20,0,0,0,0
12/01/15,3,30,737,270,40,0,0,0,0
12/02/15,1,1,738,305,99,36,3,18,57
12/02/15,1,2,726,315,56,11,6,3,20
12/02/15,1,3,996,220,14,3,2,0,5
12/02/15,1,4,5302,220,45,18,7,0,25
12/02/15,1,5,3062,370,148,4,20,1,25
12/02/15,1,7,542,345,63,36,3,2,41
12/02/15,1,9,542,350,129,10,8,6,24
12/02/15,1,10,435,370,105,0,5,11,16
12/02/15,1,11,7652,355,123,10,14,4,28
12/02/15,1,13,3062,350,102,12,19,1,32
12/02/15,1,14,8035,360,119,44,4,1,49
12/02/15,1,15,542,350,137,11,6,0,17
12/02/15,1,16,285,350,43,10,7,10,27
12/02/15,1,17,435,370,164,3,1,2,6
12/02/15,1,18,542,350,99,14,18,2,34
12/02/15,1,19,642,360,39,33,2,0,35
12/02/15,1,20,8040,350,117,7,15,2,24
12/02/15,1,22,542,350,59,3,8,0,11
12/02/15,1,23,641,350,6,0,1,0,1
12/02/15,1,24,7675,360,118,17,1,0,18
12/02/15,1,25,715,375,89,0,17,0,17
12/02/15,1,27,542,360,95,19,9,0,28
12/02/15,1,28,8040,375,68,10,12,2,24
12/02/15,1,29,737,270,93,20,3,0,23
12/02/15,1,30,737,270,44,28,10,0,38
12/02/15,2,1,738,305,96,24,4,1,29
12/02/15,2,2,726,315,81,36,16,1,53
12/02/15,2,3,996,220,16,5,3,0,8
12/02/15,2,4,5302,220,65,22,6,0,28
12/02/15,2,5,3062,370,146,4,14,1,19
12/02/15,2,7,542,345,95,36,3,2,41
12/02/15,2,9,542,350,133,6,6,2,14
12/02/15,2,10,435,370,88,0,12,0,12
12/02/15,2,11,7652,355,121,23,8,3,34
12/02/15,2,12,294,350,96,11,10,2,23
12/02/15,2,13,3062,350,98,12,5,4,21
12/02/15,2,14,8035,360,97,25,5,0,30
12/02/15,2,15,542,350,93,9,4,0,13
12/02/15,2,16,285,350,101,19,14,0,33
12/02/15,2,17,435,370,165,2,0,2,4
12/02/15,2,18,542,350,66,16,14,0,30
12/02/15,2,19,642,360,102,25,3,0,28
12/02/15,2,20,8040,350,95,15,16,3,34
12/02/15,2,22,542,350,19,1,2,0,3
12/02/15,2,24,7675,360,65,8,4,8,20
12/02/15,2,25,715,375,71,7,10,0,17
12/02/15,2,27,542,360,72,15,3,0,18
12/02/15,2,28,8040,375,67,10,16,1,27
12/02/15,2,29,737,270,67,18,5,0,23
12/02/15,2,30,737,270,53,22,8,0,30
12/02/15,3,1,738,305,115,29,2,2,33
12/02/15,3,2,726,315,101,48,11,7,66
12/02/15,3,3,996,220,45,40,6,0,46
12/02/15,3,4,5302,220,46,10,3,0,13
12/02/15,3,5,3062,370,99,6,12,0,18
12/02/15,3,7,542,345,80,77,3,3,83
12/02/15,3,9,542,350,144,20,5,2,27
12/02/15,3,10,435,370,142,0,13,2,15
12/02/15,3,11,7652,355,146,20,8,2,30
12/02/15,3,12,294,350,7,2,4,0,6
12/02/15,3,13,3062,350,115,18,11,1,30
12/02/15,3,14,8035,360,129,29,7,1,37
12/02/15,3,15,542,350,102,9,8,0,17
12/02/15,3,16,285,350,90,17,21,6,44
12/02/15,3,17,435,370,116,1,3,3,7
12/02/15,3,18,542,350,60,20,23,2,45
12/02/15,3,19,642,360,89,17,2,0,19
12/02/15,3,20,8040,350,88,21,6,4,31
12/02/15,3,22,542,350,114,11,6,0,17
12/02/15,3,25,715,375,73,5,18,0,23
12/02/15,3,26,542,360,39,23,2,0,25
12/02/15,3,27,542,360,120,25,2,0,27
12/02/15,3,28,8040,375,91,17,13,5,35
12/02/15,3,29,737,270,58,10,15,0,25
12/02/15,3,30,737,270,66,21,10,0,31
12/03/15,1,1,738,305,110,33,4,2,39
12/03/15,1,2,726,315,97,35,16,0,51
12/03/15,1,3,996,220,60,18,12,0,30
12/03/15,1,4,5302,220,21,26,5,0,31
12/03/15,1,7,542,345,48,22,1,1,24
12/03/15,1,8,542,350,2,1,0,3,4
12/03/15,1,9,542,350,144,9,11,0,20
12/03/15,1,10,435,370,138,4,6,1,11
12/03/15,1,11,7652,355,124,29,10,3,42
12/03/15,1,13,3062,350,108,15,13,1,29
12/03/15,1,14,8035,360,118,39,8,0,47
12/03/15,1,16,285,350,123,18,16,3,37
12/03/15,1,17,435,370,160,5,2,2,9
12/03/15,1,18,542,350,102,25,14,0,39
12/03/15,1,19,642,360,108,16,4,0,20
12/03/15,1,20,8040,350,7,2,1,2,5
12/03/15,1,22,542,350,97,17,14,0,31
12/03/15,1,25,715,375,91,7,21,0,28
12/03/15,1,26,542,360,108,35,7,0,42
12/03/15,1,27,542,360,108,23,3,0,26
12/03/15,1,28,8040,375,81,10,16,3,29
12/03/15,1,29,737,270,58,22,5,0,27
12/03/15,1,30,737,270,36,27,15,0,42
12/03/15,2,1,738,305,119,23,3,3,29
12/03/15,2,2,726,315,121,30,8,1,39
12/03/15,2,3,996,220,54,21,14,0,35
12/03/15,2,4,5302,220,28,33,6,0,39
12/03/15,2,8,542,350,91,8,16,2,26
12/03/15,2,9,542,350,146,20,3,2,25
12/03/15,2,10,435,370,117,2,8,1,11
12/03/15,2,11,7652,355,126,15,11,2,28
12/03/15,2,13,3062,350,108,12,17,1,30
12/03/15,2,14,8035,360,118,40,1,1,42
12/03/15,2,15,542,350,139,2,6,0,8
12/03/15,2,16,285,350,107,22,20,2,44
12/03/15,2,17,435,370,116,1,5,3,9
12/03/15,2,18,542,350,60,12,24,5,41
12/03/15,2,19,642,360,88,14,5,0,19
12/03/15,2,20,8040,350,70,11,13,4,28
12/03/15,2,22,542,350,67,16,6,0,22
12/03/15,2,25,715,375,64,1,18,0,19
12/03/15,2,26,542,360,51,19,7,0,26
12/03/15,2,27,542,360,81,27,0,0,27
12/03/15,2,28,8040,375,67,9,9,1,19
12/03/15,2,29,737,270,49,28,10,0,38
12/03/15,2,30,737,270,24,32,12,0,44
12/03/15,3,1,738,305,115,24,2,2,28
12/03/15,3,2,726,315,107,29,17,0,46
12/03/15,3,3,996,220,55,15,4,0,19
12/03/15,3,4,5302,220,65,10,1,0,11
12/03/15,3,8,542,350,66,21,10,1,32
12/03/15,3,9,542,350,147,12,4,6,22
12/03/15,3,10,435,370,155,2,6,2,10
12/03/15,3,11,7652,355,144,20,9,1,30
12/03/15,3,13,3062,350,128,13,13,3,29
12/03/15,3,14,8035,360,127,22,9,0,31
12/03/15,3,15,542,350,71,2,5,0,7
12/03/15,3,16,285,350,104,13,24,1,38
12/03/15,3,17,435,370,125,3,7,4,14
12/03/15,3,18,542,350,60,13,20,2,35
12/03/15,3,19,642,360,76,30,1,0,31
12/03/15,3,20,8040,350,54,13,14,4,31
12/03/15,3,22,542,350,76,8,7,0,15
12/03/15,3,24,7675,360,10,6,1,3,10
12/03/15,3,25,715,375,68,2,10,0,12
12/03/15,3,26,542,360,58,23,2,0,25
12/03/15,3,27,542,360,89,14,2,0,16
12/03/15,3,28,8040,375,71,5,14,4,23
12/03/15,3,29,737,270,42,10,10,0,20
12/03/15,3,30,737,270,68,13,2,0,15
12/04/15,1,1,738,305,105,22,6,2,30
12/04/15,1,2,726,315,105,16,10,3,29
12/04/15,1,3,996,220,45,18,16,0,34
12/04/15,1,4,5302,220,60,23,4,0,27
12/04/15,1,7,542,345,40,14,3,1,18
12/04/15,1,8,542,350,69,20,9,1,30
12/04/15,1,9,542,350,122,5,10,6,21
12/04/15,1,10,435,370,138,0,10,2,12
12/04/15,1,11,7652,355,32,8,4,2,14
12/04/15,1,12,294,350,37,13,0,7,20
12/04/15,1,13,3062,350,118,10,13,0,23
12/04/15,1,14,8035,360,89,38,4,1,43
12/04/15,1,15,542,350,13,0,0,0,0
12/04/15,1,16,285,350,100,20,13,0,33
12/04/15,1,17,435,370,157,4,7,0,11
12/04/15,1,18,542,350,73,22,36,2,60
12/04/15,1,19,642,360,69,37,2,0,39
12/04/15,1,20,8040,350,77,10,23,5,38
12/04/15,1,22,542,350,122,16,10,0,26
12/04/15,1,25,715,375,102,2,23,0,25
12/04/15,1,26,542,360,62,13,5,0,18
12/04/15,1,27,542,360,112,17,5,0,22
12/04/15,1,28,8040,375,103,16,10,0,26
12/04/15,1,29,737,270,61,27,18,0,45
12/04/15,1,30,737,270,39,23,12,0,35
12/04/15,2,1,738,305,104,27,1,2,30
12/04/15,2,2,726,315,101,26,17,3,46
12/04/15,2,3,996,220,48,19,15,0,34
12/04/15,2,4,5302,220,60,27,5,0,32
12/04/15,2,5,3062,370,64,22,9,11,42
12/04/15,2,7,542,345,93,39,6,0,45
12/04/15,2,8,542,350,129,12,15,0,27
12/04/15,2,9,542,350,114,12,9,3,24
12/04/15,2,10,435,370,138,3,10,1,14
12/04/15,2,12,294,350,97,17,4,1,22
12/04/15,2,13,3062,350,115,8,10,3,21
12/04/15,2,14,8035,360,130,16,7,0,23
12/04/15,2,16,285,350,104,17,18,1,36
12/04/15,2,17,435,370,136,3,5,2,10
12/04/15,2,18,542,350,40,26,19,2,47
12/04/15,2,19,642,360,82,32,0,0,32
12/04/15,2,20,8040,350,79,18,17,2,37
12/04/15,2,22,542,350,78,10,8,0,18
12/04/15,2,24,7675,360,13,3,1,11,15
12/04/15,2,25,715,375,93,6,22,0,28
12/04/15,2,27,542,360,83,14,4,0,18
12/04/15,2,28,8040,375,56,10,11,0,21
12/04/15,2,29,737,270,34,25,20,0,45
12/04/15,2,30,737,270,40,22,8,0,30
12/04/15,3,1,738,305,98,31,4,1,36
12/04/15,3,2,726,315,75,21,19,2,42
12/04/15,3,3,996,220,49,10,5,0,15
12/04/15,3,4,5302,220,55,15,1,0,16
12/04/15,3,5,3062,370,110,8,24,1,33
12/04/15,3,7,542,345,125,35,7,1,43
12/04/15,3,8,542,350,104,23,11,1,35
12/04/15,3,9,542,350,134,7,5,10,22
12/04/15,3,10,435,370,147,4,8,1,13
12/04/15,3,12,294,350,43,6,0,1,7
12/04/15,3,13,3062,350,125,8,13,1,22
12/04/15,3,14,8035,360,108,28,8,2,38
12/04/15,3,16,285,350,95,17,14,1,32
12/04/15,3,17,435,370,92,0,0,1,1
12/04/15,3,18,542,350,41,19,8,1,28
12/04/15,3,19,642,360,34,16,0,1,17
12/04/15,3,20,8040,350,45,12,11,1,24
12/04/15,3,22,542,350,102,9,5,0,14
12/04/15,3,24,7675,360,107,15,4,3,22
12/04/15,3,25,715,375,68,0,7,0,7
12/04/15,3,27,542,360,75,11,2,0,13
12/04/15,3,28,8040,375,91,14,14,0,28
12/04/15,3,29,737,270,58,10,2,0,12
12/04/15,3,30,737,270,42,10,5,1,16
12/07/15,1,1,738,305,87,35,2,8,45
12/07/15,1,2,726,315,83,25,13,3,41
12/07/15,1,3,996,220,51,18,12,0,30
12/07/15,1,4,5302,220,73,14,6,0,20
12/07/15,1,5,642,370,108,13,9,2,24
12/07/15,1,7,542,345,70,44,10,1,55
12/07/15,1,8,7742,350,23,13,9,0,22
12/07/15,1,9,747,350,113,13,5,4,22
12/07/15,1,10,8030,370,123,2,8,3,13
12/07/15,1,11,7652,355,48,3,16,3,22
12/07/15,1,12,8032,350,119,18,6,2,26
12/07/15,1,13,8030,350,129,11,10,4,25
12/07/15,1,14,542,360,122,21,1,1,23
12/07/15,1,15,774,350,35,4,4,0,8
12/07/15,1,16,285,350,93,17,21,2,40
12/07/15,1,17,542,370,114,3,1,2,6
12/07/15,1,18,8003,350,59,27,26,3,56
12/07/15,1,19,774,360,119,26,1,0,27
12/07/15,1,20,8040,350,63,24,15,2,41
12/07/15,1,22,542,350,106,19,7,0,26
12/07/15,1,24,7675,360,117,17,5,7,29
12/07/15,1,25,715,375,92,0,11,0,11
12/07/15,1,26,542,360,29,6,2,0,8
12/07/15,1,27,542,360,112,17,5,0,22
12/07/15,1,28,8040,375,54,11,17,5,33
12/07/15,1,29,737,270,42,23,10,0,33
12/07/15,1,30,737,270,39,22,21,0,43
12/07/15,2,1,738,305,97,22,6,2,30
12/07/15,2,2,726,315,91,24,13,1,38
12/07/15,2,3,996,220,53,19,11,0,30
12/07/15,2,4,5302,220,59,16,5,0,21
12/07/15,2,5,642,370,103,11,7,3,21
12/07/15,2,7,542,345,57,38,7,0,45
12/07/15,2,8,7742,350,62,19,9,0,28
12/07/15,2,9,747,350,104,16,5,0,21
12/07/15,2,10,8030,370,109,1,7,1,9
12/07/15,2,11,7652,355,92,8,14,2,24
12/07/15,2,12,8032,350,102,17,8,1,26
12/07/15,2,13,8030,350,100,17,13,1,31
12/07/15,2,14,542,360,94,24,7,0,31
12/07/15,2,15,774,350,123,9,7,0,16
12/07/15,2,16,285,350,102,9,21,2,32
12/07/15,2,17,542,370,167,1,1,0,2
12/07/15,2,18,8003,350,54,40,21,0,61
12/07/15,2,19,774,360,100,30,1,0,31
12/07/15,2,20,8040,350,75,23,19,0,42
12/07/15,2,22,542,350,103,8,12,0,20
12/07/15,2,24,7675,360,129,9,4,5,18
12/07/15,2,25,715,375,85,0,23,0,23
12/07/15,2,26,542,360,81,28,11,0,39
12/07/15,2,28,8040,375,73,9,15,2,26
12/07/15,2,29,737,270,48,21,9,0,30
12/07/15,2,30,737,270,32,21,23,0,44
12/07/15,3,1,738,305,103,26,2,1,29
12/07/15,3,2,726,315,92,43,8,4,55
12/07/15,3,4,5302,220,63,17,6,1,24
12/07/15,3,5,642,370,138,9,10,1,20
12/07/15,3,6,747,370,5,4,2,3,9
12/07/15,3,7,542,345,115,31,13,1,45
12/07/15,3,8,7742,350,112,15,18,0,33
12/07/15,3,9,747,350,132,12,14,4,30
12/07/15,3,10,8030,370,157,3,4,3,10
12/07/15,3,11,7652,355,127,10,18,2,30
12/07/15,3,12,8032,350,112,41,1,4,46
12/07/15,3,13,8030,350,128,17,14,0,31
12/07/15,3,14,542,360,104,16,15,2,33
12/07/15,3,15,774,350,80,9,7,0,16
12/07/15,3,16,285,350,97,20,25,0,45
12/07/15,3,17,542,370,117,2,2,2,6
12/07/15,3,18,8003,350,39,20,18,1,39
12/07/15,3,19,774,360,89,32,2,0,34
12/07/15,3,20,8040,350,62,13,14,3,30
12/07/15,3,22,542,350,97,11,3,0,14
12/07/15,3,24,7675,360,98,11,4,6,21
12/07/15,3,25,715,375,57,0,16,0,16
12/07/15,3,26,542,360,51,18,10,0,28
12/07/15,3,28,8040,375,67,9,11,1,21
12/07/15,3,29,737,270,47,22,8,0,30
12/07/15,3,30,737,270,43,19,21,0,40
12/08/15,1,1,738,305,71,17,4,4,25
12/08/15,1,2,726,315,72,41,6,2,49
12/08/15,1,3,996,220,56,15,12,0,27
12/08/15,1,4,5302,220,55,22,4,0,26
12/08/15,1,5,642,370,132,13,6,1,20
12/08/15,1,6,747,370,159,2,3,2,7
12/08/15,1,7,542,345,94,22,6,0,28
12/08/15,1,8,7742,350,102,12,11,0,23
12/08/15,1,9,747,350,29,12,10,4,26
12/08/15,1,10,8030,370,110,0,4,2,6
12/08/15,1,11,7652,355,119,13,9,2,24
12/08/15,1,12,8032,350,22,9,0,3,12
12/08/15,1,13,8030,350,106,12,11,0,23
12/08/15,1,15,774,350,94,8,13,0,21
12/08/15,1,16,285,350,97,22,15,0,37
12/08/15,1,17,542,370,146,1,6,0,7
12/08/15,1,18,8003,350,65,0,16,26,42
12/08/15,1,19,774,360,69,17,9,0,26
12/08/15,1,20,8040,350,75,19,16,1,36
12/08/15,1,22,542,350,99,8,13,0,21
12/08/15,1,24,7675,360,49,5,2,3,10
12/08/15,1,25,715,375,68,0,21,0,21
12/08/15,1,26,542,360,46,15,6,0,21
12/08/15,1,27,542,360,52,9,1,0,10
12/08/15,1,28,8040,375,94,14,16,1,31
12/08/15,1,29,737,270,68,22,7,0,29
12/08/15,1,30,737,270,40,27,15,0,42
12/08/15,2,1,738,305,97,22,6,2,30
12/08/15,2,2,726,315,79,32,16,0,48
12/08/15,2,3,996,220,53,18,10,0,28
12/08/15,2,4,5302,220,51,27,5,0,32
12/08/15,2,5,642,370,84,40,2,2,44
12/08/15,2,6,747,370,154,1,7,2,10
12/08/15,2,7,542,345,81,23,9,0,32
12/08/15,2,8,7742,350,83,20,8,1,29
12/08/15,2,10,8030,370,135,1,7,0,8
12/08/15,2,11,7652,355,121,13,12,2,27
12/08/15,2,12,8032,350,78,33,10,2,45
12/08/15,2,13,8030,350,108,5,10,0,15
12/08/15,2,15,774,350,92,11,9,0,20
12/08/15,2,16,285,350,110,14,19,0,33
12/08/15,2,17,542,370,143,2,4,1,7
12/08/15,2,19,774,360,78,8,11,0,19
12/08/15,2,20,8040,350,75,10,26,2,38
12/08/15,2,22,542,350,87,7,9,0,16
12/08/15,2,24,7675,360,118,9,5,4,18
12/08/15,2,25,715,375,58,0,18,0,18
12/08/15,2,27,542,360,60,11,5,0,16
12/08/15,2,28,8040,375,63,7,8,1,16
12/08/15,2,29,737,270,45,18,10,0,28
12/08/15,2,30,737,270,22,36,18,0,54
12/08/15,3,1,738,305,71,29,5,6,40
12/08/15,3,2,726,315,104,25,14,3,42
12/08/15,3,3,996,220,68,32,9,0,41
12/08/15,3,4,5302,220,43,25,6,1,32
12/08/15,3,5,642,370,123,36,8,5,49
12/08/15,3,6,747,370,161,2,6,1,9
12/08/15,3,7,542,345,129,26,8,0,34
12/08/15,3,8,7742,350,118,28,17,1,46
12/08/15,3,10,8030,370,135,0,13,5,18
12/08/15,3,11,7652,355,137,14,16,1,31
12/08/15,3,12,8032,350,27,41,3,1,45
12/08/15,3,13,8030,350,124,15,10,1,26
12/08/15,3,15,774,350,78,32,2,0,34
12/08/15,3,16,285,350,102,31,20,1,52
12/08/15,3,17,542,370,83,0,1,2,3
12/08/15,3,19,774,360,134,12,3,0,15
12/08/15,3,20,8040,350,75,11,24,4,39
12/08/15,3,22,542,350,107,13,4,0,17
12/08/15,3,24,7675,360,35,4,1,2,7
12/08/15,3,25,715,375,47,0,9,0,9
12/08/15,3,27,542,360,118,21,9,0,30
12/08/15,3,28,8040,375,94,11,13,3,27
12/08/15,3,29,737,270,78,15,9,0,24
12/08/15,3,30,737,270,33,25,16,1,42
12/09/15,1,1,738,305,88,26,4,5,35
12/09/15,1,2,726,315,78,34,10,3,47
12/09/15,1,3,996,220,41,21,2,0,23
12/09/15,1,4,5302,220,39,25,5,1,31
12/09/15,1,5,642,370,98,23,5,5,33
12/09/15,1,6,747,370,143,3,8,0,11
12/09/15,1,7,542,345,49,9,5,2,16
12/09/15,1,8,7742,350,96,21,9,2,32
12/09/15,1,9,641,350,22,20,20,7,47
12/09/15,1,10,8030,370,152,0,10,0,10
12/09/15,1,11,7652,355,107,19,20,2,41
12/09/15,1,13,8030,350,5,1,4,1,6
12/09/15,1,15,774,350,112,16,6,0,22
12/09/15,1,16,285,350,92,39,13,0,52
12/09/15,1,17,542,370,166,0,2,1,3
12/09/15,1,19,774,360,140,16,1,0,17
12/09/15,1,20,8040,350,96,20,22,2,44
12/09/15,1,21,497,350,9,2,8,0,10
12/09/15,1,22,542,350,129,6,13,0,19
12/09/15,1,24,7675,360,19,4,3,1,8
12/09/15,1,25,715,375,117,1,24,0,25
12/09/15,1,27,542,360,134,14,3,0,17
12/09/15,1,28,8040,375,107,12,17,0,29
12/09/15,1,29,737,270,65,17,8,0,25
12/09/15,1,30,737,270,41,30,4,0,34
12/09/15,2,1,738,305,99,2,4,2,8
12/09/15,2,2,726,315,88,36,10,3,49
12/09/15,2,3,996,220,66,19,4,0,23
12/09/15,2,4,5302,220,35,31,6,0,37
12/09/15,2,5,642,370,148,7,3,1,11
12/09/15,2,6,747,370,147,6,5,0,11
12/09/15,2,7,542,345,114,14,16,3,33
12/09/15,2,8,7742,350,129,15,7,0,22
12/09/15,2,9,641,350,103,9,19,5,33
12/09/15,2,10,8030,370,149,0,11,1,12
12/09/15,2,11,7652,355,79,9,25,4,38
12/09/15,2,12,8032,350,77,4,3,7,14
12/09/15,2,15,774,350,94,19,7,0,26
12/09/15,2,16,285,350,104,33,24,0,57
12/09/15,2,17,542,370,143,2,4,0,6
12/09/15,2,19,774,360,165,2,1,0,3
12/09/15,2,20,8040,350,69,17,24,4,45
12/09/15,2,21,497,350,29,5,14,0,19
12/09/15,2,22,542,350,81,14,10,0,24
12/09/15,2,25,715,375,77,1,19,0,20
12/09/15,2,27,542,360,75,18,6,0,24
12/09/15,2,28,8040,375,81,15,13,0,28
12/09/15,2,29,737,270,45,21,9,0,30
12/09/15,2,30,737,270,18,28,6,0,34
12/09/15,3,1,738,305,100,20,8,3,31
12/09/15,3,2,726,315,94,25,14,1,40
12/09/15,3,3,996,220,73,17,3,1,21
12/09/15,3,4,5302,220,52,28,4,0,32
12/09/15,3,5,642,370,160,0,5,0,5
12/09/15,3,6,747,370,153,0,1,2,3
12/09/15,3,7,542,345,105,19,13,0,32
12/09/15,3,8,7742,350,114,27,9,1,37
12/09/15,3,9,641,350,104,17,22,5,44
12/09/15,3,10,8030,370,126,2,15,2,19
12/09/15,3,11,7652,355,96,4,13,7,24
12/09/15,3,12,8032,350,127,13,12,6,31
12/09/15,3,15,774,350,60,5,4,0,9
12/09/15,3,16,285,350,113,15,29,1,45
12/09/15,3,17,542,370,100,7,2,2,11
12/09/15,3,19,774,360,161,7,0,0,7
12/09/15,3,20,8040,350,74,13,27,5,45
12/09/15,3,22,542,350,119,9,10,0,19
12/09/15,3,25,715,375,29,0,9,0,9
12/09/15,3,27,542,360,132,23,2,0,25
12/09/15,3,28,8040,375,70,15,12,1,28
12/09/15,3,29,737,270,77,15,6,0,21
12/09/15,3,30,737,270,45,23,5,0,28
12/10/15,1,1,738,305,85,25,5,4,34
12/10/15,1,2,726,315,80,26,12,1,39
12/10/15,1,3,996,220,60,18,10,0,28
12/10/15,1,4,5302,220,39,27,3,0,30
12/10/15,1,5,642,370,132,1,8,0,9
12/10/15,1,6,747,370,133,3,4,1,8
12/10/15,1,8,7742,350,58,12,8,0,20
12/10/15,1,9,641,350,79,7,10,4,21
12/10/15,1,10,8030,370,123,0,10,1,11
12/10/15,1,11,7652,355,71,3,15,1,19
12/10/15,1,12,8032,350,75,23,2,2,27
12/10/15,1,14,542,360,21,0,5,10,15
12/10/15,1,15,774,350,92,25,7,0,32
12/10/15,1,16,285,350,46,6,12,0,18
12/10/15,1,17,542,370,158,2,7,0,9
12/10/15,1,19,774,360,165,4,2,0,6
12/10/15,1,20,8040,350,112,15,18,3,36
12/10/15,1,21,641,350,10,0,1,0,1
12/10/15,1,22,542,350,76,8,13,0,21
12/10/15,1,25,715,375,120,1,23,0,24
12/10/15,1,26,542,360,35,5,3,0,8
12/10/15,1,27,542,360,131,24,9,0,33
12/10/15,1,28,8040,375,38,5,4,0,9
12/10/15,1,29,737,270,86,12,10,0,22
12/10/15,1,30,737,270,42,27,18,0,45
12/10/15,2,1,738,305,89,18,4,8,30
12/10/15,2,2,726,315,84,34,11,1,46
12/10/15,2,3,996,220,61,15,14,0,29
12/10/15,2,4,5302,220,41,29,4,0,33
12/10/15,2,5,642,370,142,2,7,3,12
12/10/15,2,6,747,370,115,2,5,1,8
12/10/15,2,8,7742,350,102,15,12,0,27
12/10/15,2,9,641,350,82,4,9,3,16
12/10/15,2,10,8030,370,140,1,6,0,7
12/10/15,2,11,7652,355,96,6,11,1,18
12/10/15,2,12,8032,350,126,14,6,2,22
12/10/15,2,14,542,360,153,3,2,0,5
12/10/15,2,15,774,350,94,26,4,0,30
12/10/15,2,16,285,350,115,12,23,0,35
12/10/15,2,17,542,370,155,0,4,1,5
12/10/15,2,19,774,360,153,6,3,0,9
12/10/15,2,20,8040,350,61,15,22,2,39
12/10/15,2,21,641,350,104,3,14,0,17
12/10/15,2,23,641,350,83,4,2,0,6
12/10/15,2,24,7675,360,14,6,2,3,11
12/10/15,2,25,715,375,47,1,10,0,11
12/10/15,2,26,542,360,75,18,16,0,34
12/10/15,2,27,542,360,97,24,3,0,27
12/10/15,2,28,8040,375,50,5,10,0,15
12/10/15,2,29,737,270,61,15,11,0,26
12/10/15,2,30,737,270,37,25,20,0,45
12/10/15,3,1,738,305,34,30,7,9,46
12/10/15,3,2,726,315,102,39,9,2,50
12/10/15,3,4,5302,220,51,23,3,0,26
12/10/15,3,5,642,370,148,9,6,5,20
12/10/15,3,6,747,370,156,2,6,2,10
12/10/15,3,8,7742,350,129,24,9,0,33
12/10/15,3,10,8030,370,142,1,4,2,7
12/10/15,3,11,7652,355,126,8,16,5,29
12/10/15,3,12,8032,350,136,14,13,2,29
12/10/15,3,14,542,360,140,12,6,5,23
12/10/15,3,15,774,350,153,10,7,0,17
12/10/15,3,16,285,350,99,33,24,0,57
12/10/15,3,17,542,370,41,0,2,0,2
12/10/15,3,18,8003,350,12,30,5,9,44
12/10/15,3,19,774,360,78,4,3,0,7
12/10/15,3,20,8040,350,62,11,25,8,44
12/10/15,3,21,641,350,52,2,8,0,10
12/10/15,3,23,641,350,89,4,2,0,6
12/10/15,3,25,715,375,24,1,8,0,9
12/10/15,3,26,542,360,86,20,13,0,33
12/10/15,3,27,542,360,9,6,0,0,6
12/10/15,3,28,8040,375,44,8,6,1,15
12/10/15,3,29,737,270,84,17,9,0,26
12/10/15,3,30,737,270,32,26,19,0,45
12/14/15,1,1,738,305,41,19,2,7,28
12/14/15,1,2,726,315,91,18,13,5,36
12/14/15,1,3,996,220,67,12,9,0,21
12/14/15,1,4,5302,220,14,5,2,0,7
12/14/15,1,5,642,370,140,8,6,2,16
12/14/15,1,6,747,370,108,29,10,2,41
12/14/15,1,7,542,345,65,51,6,1,58
12/14/15,1,9,641,350,111,5,15,2,22
12/14/15,1,11,7652,355,118,16,11,5,32
12/14/15,1,12,8032,350,112,21,5,1,27
12/14/15,1,14,8035,360,161,2,3,0,5
12/14/15,1,15,774,350,128,17,9,0,26
12/14/15,1,16,8032,350,120,21,16,1,38
12/14/15,1,18,8003,350,110,11,11,1,23
12/14/15,1,19,774,360,131,1,3,0,4
12/14/15,1,20,8040,350,16,1,0,0,1
12/14/15,1,21,497,350,66,0,17,0,17
12/14/15,1,23,641,350,155,13,5,0,18
12/14/15,1,24,1001-ex,360,14,7,3,7,17
12/14/15,1,25,715,375,92,1,19,0,20
12/14/15,1,26,542,360,89,26,14,0,40
12/14/15,1,27,542,360,129,22,8,0,30
12/14/15,1,29,737,270,93,18,5,0,23
12/14/15,1,30,737,270,57,26,12,0,38
12/14/15,2,1,738,305,81,17,14,12,43
12/14/15,2,2,726,315,102,21,14,1,36
12/14/15,2,3,996,220,75,17,10,0,27
12/14/15,2,5,642,370,165,10,1,0,11
12/14/15,2,6,747,370,131,10,5,5,20
12/14/15,2,7,542,345,89,57,3,0,60
12/14/15,2,8,7331,350,67,19,2,3,24
12/14/15,2,9,641,350,71,3,13,3,19
12/14/15,2,11,7652,355,111,12,13,1,26
12/14/15,2,12,8032,350,129,15,12,1,28
12/14/15,2,14,8035,360,159,6,0,1,7
12/14/15,2,15,774,350,116,9,14,0,23
12/14/15,2,16,8032,350,90,64,12,4,80
12/14/15,2,18,8003,350,104,16,13,1,30
12/14/15,2,19,774,360,118,11,8,0,19
12/14/15,2,20,8040,350,82,16,15,2,33
12/14/15,2,21,497,350,82,2,14,0,16
12/14/15,2,23,641,350,138,10,3,0,13
12/14/15,2,25,715,375,65,1,10,0,11
12/14/15,2,26,542,360,77,13,17,0,30
12/14/15,2,27,542,360,109,18,1,0,19
12/14/15,2,29,737,270,23,6,2,0,8
12/14/15,3,1,738,305,81,45,5,1,51
12/14/15,3,2,726,315,110,22,8,0,30
12/14/15,3,3,996,220,64,16,9,1,26
12/14/15,3,4,5302,220,37,15,13,0,28
12/14/15,3,5,642,370,145,6,6,0,12
12/14/15,3,6,747,370,111,19,9,0,28
12/14/15,3,7,542,345,105,47,6,1,54
12/14/15,3,8,7331,350,105,33,2,1,36
12/14/15,3,9,641,350,119,4,18,1,23
12/14/15,3,11,7652,355,113,9,24,7,40
12/14/15,3,12,8032,350,88,18,4,2,24
12/14/15,3,14,8035,360,159,9,1,1,11
12/14/15,3,15,774,350,49,18,8,0,26
12/14/15,3,16,8032,350,90,32,18,4,54
12/14/15,3,18,8003,350,82,8,6,1,15
12/14/15,3,19,774,360,101,2,0,0,2
12/14/15,3,20,8040,350,70,17,7,3,27
12/14/15,3,21,497,350,44,5,16,0,21
12/14/15,3,22,542,350,17,6,4,0,10
12/14/15,3,23,641,350,89,8,2,0,10
12/14/15,3,25,715,375,44,4,18,6,28
12/14/15,3,26,542,360,60,13,11,0,24
12/14/15,3,27,542,360,70,10,7,0,17
12/14/15,3,28,92,375,21,2,21,5,28
12/15/15,1,1,738,305,111,12,5,4,21
12/15/15,1,2,726,315,102,20,17,2,39
12/15/15,1,3,996,220,61,19,4,0,23
12/15/15,1,4,5302,220,54,22,3,0,25
12/15/15,1,5,642,370,160,14,5,3,22
12/15/15,1,6,747,370,132,13,13,0,26
12/15/15,1,7,542,345,105,37,9,0,46
12/15/15,1,8,7331,350,109,15,9,0,24
12/15/15,1,9,641,350,121,14,13,3,30
12/15/15,1,11,7652,355,124,19,18,3,40
12/15/15,1,14,8035,360,165,13,4,1,18
12/15/15,1,15,774,350,101,9,6,0,15
12/15/15,1,16,8032,350,90,26,24,2,52
12/15/15,1,18,542,350,114,21,10,0,31
12/15/15,1,19,642,360,161,5,3,0,8
12/15/15,1,20,8040,350,114,23,9,4,36
12/15/15,1,21,641,350,86,6,16,0,22
12/15/15,1,23,641,350,150,20,2,0,22
12/15/15,1,25,715,375,86,0,20,0,20
12/15/15,1,26,542,360,116,21,16,0,37
12/15/15,1,27,542,360,126,28,6,0,34
12/15/15,1,28,92,375,29,1,26,0,27
12/15/15,2,1,738,305,81,27,7,6,40
12/15/15,2,2,726,315,88,28,14,1,43
12/15/15,2,3,996,220,54,20,3,1,24
12/15/15,2,4,5302,220,35,26,4,0,30
12/15/15,2,5,642,370,127,6,10,2,18
12/15/15,2,6,747,370,122,4,18,1,23
12/15/15,2,7,542,345,83,58,8,0,66
12/15/15,2,8,7331,350,134,15,1,1,17
12/15/15,2,9,641,350,45,5,3,1,9
12/15/15,2,10,542,370,60,60,12,5,77
12/15/15,2,11,7652,355,137,19,12,3,34
12/15/15,2,12,7393,350,80,53,5,5,63
12/15/15,2,14,8035,360,160,2,4,1,7
12/15/15,2,15,774,350,109,10,8,0,18
12/15/15,2,16,8032,350,88,14,39,1,54
12/15/15,2,18,542,350,99,12,14,3,29
12/15/15,2,19,642,360,127,5,6,0,11
12/15/15,2,20,8040,350,104,23,5,4,32
12/15/15,2,21,641,350,42,3,14,0,17
12/15/15,2,23,641,350,83,20,6,0,26
12/15/15,2,24,1001-ex,360,13,0,0,4,4
12/15/15,2,25,715,375,51,1,13,0,14
12/15/15,2,26,542,360,57,13,10,0,23
12/15/15,2,27,542,360,85,18,6,0,24
12/15/15,2,28,92,375,32,1,20,0,21
12/15/15,2,29,737,270,8,4,2,0,6
12/15/15,2,30,737,270,35,20,10,0,30
12/15/15,3,1,738,305,91,33,8,6,47
12/15/15,3,2,726,315,108,27,9,1,37
12/15/15,3,4,5302,220,72,15,2,0,17
12/15/15,3,5,642,370,153,10,6,2,18
12/15/15,3,6,747,370,148,4,13,1,18
12/15/15,3,7,542,345,43,31,3,2,36
12/15/15,3,8,7331,350,134,12,6,0,18
12/15/15,3,9,641,350,145,5,13,4,22
12/15/15,3,10,542,370,123,29,4,12,45
12/15/15,3,11,7652,355,125,21,11,3,35
12/15/15,3,12,7393,350,101,50,5,4,59
12/15/15,3,14,8035,360,163,0,7,2,9
12/15/15,3,15,774,350,75,4,7,0,11
12/15/15,3,16,8032,350,101,24,29,0,53
12/15/15,3,18,542,350,93,9,10,2,21
12/15/15,3,20,8040,350,79,12,7,4,23
12/15/15,3,21,641,350,47,7,13,0,20
12/15/15,3,23,641,350,36,12,1,0,13
12/15/15,3,25,715,375,34,0,13,0,13
12/15/15,3,26,542,360,74,21,16,0,37
12/15/15,3,27,542,360,125,19,3,0,22
12/15/15,3,28,92,375,51,3,31,2,36
12/15/15,3,29,737,270,77,10,58,1,69
12/15/15,3,30,737,270,61,20,10,1,31
12/16/15,1,1,738,305,88,24,8,4,36
12/16/15,1,2,726,315,68,26,6,11,43
12/16/15,1,3,996,220,45,0,0,0,0
12/16/15,1,4,5302,220,52,0,0,0,0
12/16/15,1,5,642,370,149,8,6,2,16
12/16/15,1,6,747,370,115,1,19,2,22
12/16/15,1,8,7331,350,103,16,4,1,21
12/16/15,1,9,641,350,105,14,12,2,28
12/16/15,1,10,542,370,98,31,2,1,34
12/16/15,1,11,7652,355,109,16,10,2,28
12/16/15,1,12,7393,350,128,15,6,2,23
12/16/15,1,15,774,350,136,9,8,0,17
12/16/15,1,16,8032,350,91,24,25,1,50
12/16/15,1,18,542,350,101,12,15,1,28
12/16/15,1,20,8040,350,114,14,8,4,26
12/16/15,1,21,641,350,98,5,13,0,18
12/16/15,1,23,641,350,141,10,3,0,13
12/16/15,1,24,1001,360,19,5,4,4,13
12/16/15,1,25,715,375,77,0,20,0,20
12/16/15,1,26,542,360,94,30,15,0,45
12/16/15,1,27,542,360,119,19,7,0,26
12/16/15,1,28,92,375,43,8,42,1,51
12/16/15,1,29,737,270,57,20,12,0,32
12/16/15,1,30,737,270,2,2,1,0,3
12/16/15,2,1,738,305,78,18,8,6,32
12/16/15,2,2,726,315,95,17,13,3,33
12/16/15,2,3,996,220,43,0,0,0,0
12/16/15,2,4,5302,220,50,0,0,0,0
12/16/15,2,5,642,370,162,6,7,1,14
12/16/15,2,6,747,370,103,2,47,1,50
12/16/15,2,7,542,345,17,10,4,8,22
12/16/15,2,8,7331,350,120,14,8,5,27
12/16/15,2,9,641,350,111,11,11,2,24
12/16/15,2,10,542,370,118,29,9,0,38
12/16/15,2,11,7652,355,108,17,21,3,41
12/16/15,2,12,7393,350,121,17,9,4,30
12/16/15,2,15,774,350,95,2,15,0,17
12/16/15,2,16,8032,350,116,13,24,1,38
12/16/15,2,18,542,350,80,14,15,1,30
12/16/15,2,19,642,360,10,4,1,0,5
12/16/15,2,20,8040,350,101,19,5,5,29
12/16/15,2,21,641,350,78,6,8,0,14
12/16/15,2,23,641,350,156,4,4,0,8
12/16/15,2,24,1001,360,67,17,9,6,32
12/16/15,2,25,715,375,38,0,18,0,18
12/16/15,2,26,542,360,61,20,6,0,26
12/16/15,2,27,542,360,119,10,4,0,14
12/16/15,2,28,92,375,23,1,29,0,30
12/16/15,2,29,737,270,47,22,14,0,36
12/16/15,2,30,737,270,31,20,6,0,26
12/16/15,3,1,738,305,94,10,9,4,23
12/16/15,3,2,726,315,81,21,15,3,39
12/16/15,3,3,996,220,69,10,2,0,12
12/16/15,3,4,5302,220,41,10,5,0,15
12/16/15,3,5,642,370,40,10,1,0,11
12/16/15,3,6,747,370,104,1,15,1,17
12/16/15,3,8,7331,350,124,12,5,1,18
12/16/15,3,9,641,350,126,2,18,8,28
12/16/15,3,10,542,370,113,29,12,5,46
12/16/15,3,11,7652,355,113,18,12,3,33
12/16/15,3,12,7393,350,105,18,8,6,32
12/16/15,3,15,774,350,94,5,2,0,7
12/16/15,3,16,8032,350,105,9,24,0,33
12/16/15,3,18,542,350,60,17,4,0,21
12/16/15,3,19,642,360,73,2,10,0,12
12/16/15,3,20,8040,350,101,11,8,2,21
12/16/15,3,21,641,350,40,1,13,0,14
12/16/15,3,23,641,350,152,2,5,0,7
12/16/15,3,24,1001,360,80,23,6,4,33
12/16/15,3,25,715,375,40,1,15,0,16
12/16/15,3,26,542,360,70,22,8,0,30
12/16/15,3,27,542,360,93,11,4,0,15
12/16/15,3,28,92,375,24,1,34,4,39
12/17/15,1,1,738,305,116,18,6,2,26
12/17/15,1,2,726,315,97,25,14,2,41
12/17/15,1,3,996,220,50,14,2,0,16
12/17/15,1,4,5302,220,66,20,3,0,23
12/17/15,1,5,642,370,11,0,2,5,7
12/17/15,1,6,747,370,165,2,1,0,3
12/17/15,1,8,7331,350,96,0,0,0,0
12/17/15,1,9,641,350,122,4,16,1,21
12/17/15,1,10,435,370,112,41,2,1,44
12/17/15,1,11,7652,355,112,25,10,3,38
12/17/15,1,12,7393,350,129,13,6,1,20
12/17/15,1,13,3062,350,107,15,7,8,30
12/17/15,1,15,774,350,80,6,4,0,10
12/17/15,1,16,8032,350,102,16,70,0,86
12/17/15,1,18,542,350,125,14,6,7,27
12/17/15,1,19,642,360,120,7,7,0,14
12/17/15,1,20,8040,350,111,29,8,4,41
12/17/15,1,21,641,350,101,2,9,0,11
12/17/15,1,23,641,350,127,9,4,0,13
12/17/15,1,24,1001,360,74,15,15,4,34
12/17/15,1,25,715,375,68,1,18,0,19
12/17/15,1,26,542,360,69,20,11,0,31
12/17/15,1,27,542,360,127,15,10,0,25
12/17/15,1,28,92,375,43,7,22,0,29
12/17/15,1,29,737,270,59,22,12,0,34
12/17/15,1,30,737,270,48,20,8,0,28
12/17/15,2,2,726,315,87,22,18,1,41
12/17/15,2,3,996,220,67,13,3,0,16
12/17/15,2,4,5302,220,39,19,4,0,23
12/17/15,2,5,642,370,134,19,7,1,27
12/17/15,2,6,747,370,137,1,9,1,11
12/17/15,2,7,542,345,87,43,8,9,60
12/17/15,2,8,7331,350,118,3,0,0,3
12/17/15,2,9,641,350,87,5,31,3,39
12/17/15,2,10,435,370,125,26,11,0,37
12/17/15,2,11,7652,355,86,6,15,2,23
12/17/15,2,12,7393,350,124,24,10,2,36
12/17/15,2,13,3062,350,132,14,2,0,16
12/17/15,2,15,774,350,32,4,1,0,5
12/17/15,2,16,8032,350,98,24,24,3,51
12/17/15,2,18,542,350,107,12,13,1,26
12/17/15,2,19,642,360,139,12,2,0,14
12/17/15,2,20,8040,350,98,26,6,5,37
12/17/15,2,21,641,350,60,4,15,0,19
12/17/15,2,23,641,350,142,6,1,0,7
12/17/15,2,24,1001,360,108,14,10,8,32
12/17/15,2,25,715,375,70,0,19,0,19
12/17/15,2,26,542,360,63,20,13,0,33
12/17/15,2,27,542,360,97,16,10,0,26
12/17/15,2,28,92,375,32,12,30,2,44
12/17/15,2,29,737,270,50,20,13,0,33
12/17/15,2,30,737,270,47,19,7,0,26
12/17/15,3,1,738,305,91,12,24,8,44
12/17/15,3,2,726,315,111,34,10,1,45
12/17/15,3,3,996,220,30,5,1,0,6
12/17/15,3,4,5302,220,76,10,2,0,12
12/17/15,3,5,642,370,162,4,5,1,10
12/17/15,3,6,747,370,159,5,3,1,9
12/17/15,3,7,542,345,76,29,7,3,39
12/17/15,3,8,7331,350,141,7,6,1,14
12/17/15,3,9,641,350,138,6,14,1,21
12/17/15,3,10,435,370,132,29,14,1,44
12/17/15,3,12,7393,350,115,15,3,0,18
12/17/15,3,13,3062,350,129,17,6,0,23
12/17/15,3,16,8032,350,121,19,25,2,46
12/17/15,3,18,542,350,77,7,6,0,13
12/17/15,3,19,642,360,105,12,6,0,18
12/17/15,3,20,8040,350,73,10,9,6,25
12/17/15,3,21,641,350,63,1,10,0,11
12/17/15,3,23,641,350,94,8,3,0,11
12/17/15,3,24,1001,360,77,20,6,3,29
12/17/15,3,26,542,360,78,25,12,0,37
12/17/15,3,27,542,360,122,18,6,0,24
12/17/15,3,28,92,375,30,12,28,1,41
12/17/15,3,29,737,270,20,10,2,0,12
12/17/15,3,30,737,270,47,5,10,1,16
12/18/15,1,1,738,305,111,14,14,1,29
12/18/15,1,2,726,315,105,24,13,4,41
12/18/15,1,3,996,220,54,13,6,0,19
12/18/15,1,4,5302,220,72,10,3,0,13
12/18/15,1,5,642,370,140,20,4,0,24
12/18/15,1,7,294,345,84,43,14,8,65
12/18/15,1,8,7331,350,121,19,4,1,24
12/18/15,1,9,641,350,147,5,8,8,21
12/18/15,1,10,542,370,88,22,11,2,35
12/18/15,1,11,7652,355,53,4,27,8,39
12/18/15,1,12,7393,350,123,24,6,1,31
12/18/15,1,13,3062,350,102,29,11,2,42
12/18/15,1,16,8032,350,87,13,19,0,32
12/18/15,1,17,641,370,117,2,8,5,15
12/18/15,1,18,542,350,74,11,9,2,22
12/18/15,1,19,642,360,145,13,4,0,17
12/18/15,1,20,8040,350,96,19,13,6,38
12/18/15,1,21,641,350,113,5,13,0,18
12/18/15,1,23,641,350,105,0,5,0,5
12/18/15,1,24,1001,360,85,19,20,8,47
12/18/15,1,25,715,375,98,1,13,0,14
12/18/15,1,26,542,360,84,18,10,0,28
12/18/15,1,27,542,360,92,7,2,0,9
12/18/15,1,28,92,375,37,1,39,0,40
12/18/15,1,29,737,270,73,10,8,1,19
12/18/15,1,30,737,270,50,16,6,0,22
12/18/15,2,1,738,305,109,12,14,3,29
12/18/15,2,2,726,315,108,21,17,0,38
12/18/15,2,3,996,220,50,14,5,1,20
12/18/15,2,4,5302,220,59,15,5,0,20
12/18/15,2,5,642,370,140,2,5,1,8
12/18/15,2,7,294,345,82,52,10,1,63
12/18/15,2,8,7331,350,29,6,1,2,9
12/18/15,2,9,641,350,128,3,16,2,21
12/18/15,2,10,435,370,118,32,9,0,41
12/18/15,2,11,7652,355,114,13,18,6,37
12/18/15,2,12,7393,350,130,22,5,1,28
12/18/15,2,13,3062,350,130,8,13,0,21
12/18/15,2,16,8032,350,104,16,28,2,46
12/18/15,2,17,435,370,130,7,13,0,20
12/18/15,2,18,542,350,83,8,15,2,25
12/18/15,2,19,642,360,105,6,9,0,15
12/18/15,2,20,8040,350,92,22,10,4,36
12/18/15,2,21,641,350,57,5,8,0,13
12/18/15,2,24,1001,360,15,0,0,0,0
12/18/15,2,25,715,375,78,1,21,0,22
12/18/15,2,26,542,360,20,11,1,0,12
12/18/15,2,27,542,360,94,12,6,0,18
12/18/15,2,28,92,375,19,7,24,2,33
12/18/15,2,29,737,270,61,14,7,0,21
12/18/15,2,30,737,270,42,19,7,0,26
12/18/15,3,1,738,305,95,13,14,4,31
12/18/15,3,2,726,315,85,31,16,4,51
12/18/15,3,3,996,220,34,15,3,1,19
12/18/15,3,4,5302,220,54,10,4,0,14
12/18/15,3,5,642,370,143,15,1,0,16
12/18/15,3,7,294,345,64,87,4,11,102
12/18/15,3,9,641,350,114,11,10,8,29
12/18/15,3,10,435,370,114,23,5,1,29
12/18/15,3,11,7652,355,111,16,15,4,35
12/18/15,3,12,7393,350,55,24,3,1,28
12/18/15,3,13,3062,350,107,19,4,3,26
12/18/15,3,16,8032,350,102,14,30,2,46
12/18/15,3,18,542,350,58,7,6,3,16
12/18/15,3,19,642,360,67,1,3,0,4
12/18/15,3,20,8040,350,65,8,7,4,19
12/18/15,3,27,542,360,37,6,0,1,7
12/18/15,3,28,92,375,10,8,15,3,26
12/18/15,3,29,737,270,37,5,7,0,12
12/18/15,3,30,737,270,41,10,1,0,11
12/11/15,1,1,738,305,98,24,4,2,30
12/11/15,1,2,726,315,96,36,13,2,51
12/11/15,1,3,996,220,63,22,18,0,40
12/11/15,1,4,5302,220,40,26,4,0,30
12/11/15,1,5,642,370,133,6,7,0,13
12/11/15,1,6,747,370,132,0,8,0,8
12/11/15,1,9,641,350,82,2,5,1,8
12/11/15,1,10,435,370,73,11,2,0,13
12/11/15,1,11,7652,355,122,8,8,3,19
12/11/15,1,12,7393,350,126,14,6,1,21
12/11/15,1,14,8035,360,146,4,0,0,4
12/11/15,1,15,774,350,60,26,4,0,30
12/11/15,1,16,8032,350,80,13,15,1,29
12/11/15,1,18,542,350,130,21,10,0,31
12/11/15,1,19,642,360,125,5,2,0,7
12/11/15,1,20,8040,350,63,12,15,12,39
12/11/15,1,21,641,350,104,3,18,0,21
12/11/15,1,23,641,350,114,10,1,0,11
12/11/15,1,24,EXP1001,360,15,6,2,2,10
12/11/15,1,25,715,375,100,0,23,0,23
12/11/15,1,26,542,360,102,31,15,0,46
12/11/15,1,27,542,360,14,4,1,0,5
12/11/15,1,29,737,270,70,21,10,0,31
12/11/15,2,1,738,305,105,16,7,4,27
12/11/15,2,2,726,315,82,26,10,1,37
12/11/15,2,3,996,220,57,23,12,0,35
12/11/15,2,4,5302,220,41,32,3,0,35
12/11/15,2,5,642,370,140,3,5,0,8
12/11/15,2,6,747,370,160,4,3,2,9
12/11/15,2,7,542,345,55,44,5,0,49
12/11/15,2,9,641,350,120,6,17,4,27
12/11/15,2,11,7652,355,102,21,9,1,31
12/11/15,2,12,7393,350,129,6,8,2,16
12/11/15,2,14,8035,360,166,3,1,0,4
12/11/15,2,15,774,350,66,28,5,0,33
12/11/15,2,18,542,350,49,28,12,1,41
12/11/15,2,19,642,360,113,6,4,0,10
12/11/15,2,20,8040,350,21,7,4,3,14
12/11/15,2,21,641,350,52,2,11,0,13
12/11/15,2,22,EXP997,350,12,1,6,0,7
12/11/15,2,23,641,350,155,4,3,0,7
12/11/15,2,25,715,375,77,4,20,0,24
12/11/15,2,26,542,360,69,15,1,0,16
12/11/15,2,27,542,360,41,12,2,0,14
12/11/15,2,29,737,270,52,28,9,0,37
12/11/15,3,1,738,305,93,18,5,3,26
12/11/15,3,2,726,315,101,20,14,2,36
12/11/15,3,3,996,220,42,26,11,0,37
12/11/15,3,4,5302,220,50,30,7,0,37
12/11/15,3,5,642,370,82,3,13,1,17
12/11/15,3,6,747,370,80,7,4,1,12
12/11/15,3,7,542,345,59,39,6,2,47
12/11/15,3,9,641,350,10,1,3,0,4
12/11/15,3,11,7652,355,11,2,2,0,4
12/11/15,3,12,7393,350,79,17,6,4,27
12/11/15,3,14,8035,360,159,0,1,2,3
12/11/15,3,15,774,350,56,9,3,0,12
12/11/15,3,18,542,350,33,10,11,1,22
12/11/15,3,19,642,360,91,1,0,0,1
12/11/15,3,21,641,350,28,4,8,0,12
12/11/15,3,22,EXP997,350,7,3,6,0,9
12/11/15,3,23,641,350,55,3,3,0,6
12/11/15,3,25,715,375,39,4,10,0,14
12/11/15,3,26,542,360,25,10,3,0,13
12/11/15,3,27,542,360,42,15,1,0,16
12/11/15,3,29,737,270,42,30,7,0,37
12/21/15,1,1,738,305,128,14,7,4,25
12/21/15,1,2,726,315,107,37,12,4,53
12/21/15,1,3,996,220,32,8,6,0,14
12/21/15,1,4,5302,220,72,15,3,0,18
12/21/15,1,5,642,370,167,7,5,2,14
12/21/15,1,7,294,345,100,42,10,3,55
12/21/15,1,8,775,350,35,10,9,13,32
12/21/15,1,9,641,350,128,3,23,2,28
12/21/15,1,10,542,370,115,29,7,3,39
12/21/15,1,11,7652,355,100,19,28,7,54
12/21/15,1,13,3062,350,127,18,2,0,20
12/21/15,1,16,8032,350,109,21,22,0,43
12/21/15,1,17,641,370,113,3,8,3,14
12/21/15,1,18,542,350,111,8,15,4,27
12/21/15,1,19,642,360,135,12,8,0,20
12/21/15,1,20,8040,350,105,14,7,9,30
12/21/15,1,24,1001,360,43,5,9,1,15
12/21/15,1,25,715,375,140,2,17,0,19
12/21/15,1,26,542,360,40,13,7,0,20
12/21/15,1,27,542,360,41,6,6,0,12
12/21/15,1,28,92,375,22,13,44,0,57
12/21/15,1,29,737,270,49,22,12,0,34
12/21/15,1,30,737,270,55,18,10,0,28
12/21/15,2,1,738,305,89,10,14,1,25
12/21/15,2,2,726,315,73,22,14,1,37
12/21/15,2,3,996,220,79,15,8,1,24
12/21/15,2,4,5302,220,56,22,5,0,27
12/21/15,2,5,642,370,161,4,7,1,12
12/21/15,2,7,294,345,110,17,8,5,30
12/21/15,2,8,775,350,63,11,14,0,25
12/21/15,2,9,641,350,85,3,12,3,18
12/21/15,2,10,542,370,70,28,6,1,35
12/21/15,2,11,7652,355,56,11,20,0,31
12/21/15,2,13,3062,350,110,11,9,1,21
12/21/15,2,16,8032,350,71,16,19,0,35
12/21/15,2,17,435,370,134,16,2,0,18
12/21/15,2,18,542,350,112,19,8,0,27
12/21/15,2,19,642,360,103,10,8,0,18
12/21/15,2,20,8040,350,103,13,9,8,30
12/21/15,2,24,1001,360,94,9,18,9,36
12/21/15,2,25,715,375,77,0,18,0,18
12/21/15,2,26,542,360,57,26,8,0,34
12/21/15,2,27,542,360,23,8,0,0,8
12/21/15,2,28,92,375,9,2,22,0,24
12/21/15,2,29,737,270,48,23,10,0,33
12/21/15,2,30,737,270,51,21,12,0,33
12/21/15,3,1,738,305,121,14,8,2,24
12/21/15,3,2,726,315,110,30,8,3,41
12/21/15,3,3,996,220,62,20,2,0,22
12/21/15,3,4,5302,220,75,16,5,0,21
12/21/15,3,5,642,370,154,20,2,1,23
12/21/15,3,7,294,345,115,12,19,4,35
12/21/15,3,8,775,350,109,13,22,3,38
12/21/15,3,9,641,350,105,3,22,3,28
12/21/15,3,10,542,370,121,25,11,3,39
12/21/15,3,11,7652,355,101,20,29,9,58
12/21/15,3,12,7393,350,21,9,13,3,25
12/21/15,3,13,3062,350,129,14,7,1,22
12/21/15,3,16,8032,350,111,18,22,1,41
12/21/15,3,17,435,370,70,9,1,5,15
12/21/15,3,18,542,350,77,9,12,0,21
12/21/15,3,19,642,360,75,17,1,0,18
12/21/15,3,20,8040,350,160,21,6,4,31
12/21/15,3,24,1001,360,96,26,14,6,46
12/21/15,3,25,715,375,49,1,27,0,28
12/21/15,3,26,542,360,92,34,18,0,52
12/21/15,3,27,542,360,117,25,5,0,30
12/21/15,3,28,92,375,29,13,33,0,46
12/21/15,3,29,737,270,71,20,8,0,28
12/21/15,3,30,737,270,74,17,4,0,21
12/22/15,1,1,738,305,113,9,6,3,18
12/22/15,1,2,726,315,103,46,5,1,52
12/22/15,1,3,996,220,72,12,8,0,20
12/22/15,1,4,5302,220,71,22,3,0,25
12/22/15,1,5,642,370,156,10,7,1,18
12/22/15,1,7,294,345,15,3,3,1,7
12/22/15,1,8,775,350,111,17,16,2,35
12/22/15,1,9,641,350,137,4,11,2,17
12/22/15,1,10,542,370,85,26,16,3,45
12/22/15,1,11,7652,355,104,15,18,2,35
12/22/15,1,12,7393,350,68,32,33,5,70
12/22/15,1,13,3062,350,149,9,4,2,15
12/22/15,1,16,8032,350,81,28,28,0,56
12/22/15,1,17,641,370,126,8,6,2,16
12/22/15,1,18,542,350,93,25,5,1,31
12/22/15,1,19,642,360,134,15,7,0,22
12/22/15,1,20,8040,350,108,15,15,6,36
12/22/15,1,21,641,350,19,1,6,0,7
12/22/15,1,23,641,350,9,4,1,0,5
12/22/15,1,24,1001,360,92,19,12,2,33
12/22/15,1,26,542,360,81,28,12,0,40
12/22/15,1,27,542,360,114,29,7,0,36
12/22/15,1,28,92,375,25,4,51,0,55
12/22/15,1,29,737,270,71,21,8,0,29
12/22/15,1,30,737,270,83,15,6,0,21
12/22/15,2,1,738,305,119,13,12,5,30
12/22/15,2,2,726,315,108,15,10,3,28
12/22/15,2,3,996,220,74,13,7,0,20
12/22/15,2,4,5302,220,72,20,4,0,24
12/22/15,2,5,642,370,160,6,8,1,15
12/22/15,2,7,294,345,103,15,17,5,37
12/22/15,2,8,775,350,100,7,26,1,34
12/22/15,2,9,641,350,24,3,11,2,16
12/22/15,2,10,542,370,51,16,3,1,20
12/22/15,2,11,7652,355,115,11,12,2,25
12/22/15,2,12,7393,350,95,13,42,2,57
12/22/15,2,13,3062,350,123,18,3,1,22
12/22/15,2,16,8032,350,104,15,28,1,44
12/22/15,2,17,435,370,6,0,0,2,2
12/22/15,2,18,542,350,103,24,6,1,31
12/22/15,2,19,642,360,120,9,9,0,18
12/22/15,2,20,8040,350,101,22,14,2,38
12/22/15,2,21,641,350,63,6,21,0,27
12/22/15,2,23,641,350,123,4,9,0,13
12/22/15,2,24,1001,360,99,20,18,7,45
12/22/15,2,26,542,360,60,26,7,0,33
12/22/15,2,27,542,360,114,20,3,0,23
12/22/15,2,28,92,375,19,6,39,0,45
12/22/15,2,29,737,270,68,23,9,0,32
12/22/15,2,30,737,270,78,14,7,0,21
12/22/15,3,1,738,305,94,24,11,3,38
12/22/15,3,2,726,315,33,14,1,2,17
12/22/15,3,3,996,220,71,14,8,0,22
12/22/15,3,4,5302,220,77,19,5,0,24
12/22/15,3,5,642,370,102,7,5,3,15
12/22/15,3,7,294,345,126,21,15,4,40
12/22/15,3,8,775,350,127,11,17,7,35
12/22/15,3,11,7652,355,104,19,26,4,49
12/22/15,3,12,7393,350,101,20,48,1,69
12/22/15,3,13,3062,350,116,19,9,1,29
12/22/15,3,16,8032,350,103,16,22,0,38
12/22/15,3,17,435,370,112,7,0,3,10
12/22/15,3,18,542,350,14,11,0,0,11
12/22/15,3,19,642,360,41,16,2,0,18
12/22/15,3,20,8040,350,110,16,5,3,24
12/22/15,3,21,641,350,47,1,9,0,10
12/22/15,3,23,641,350,83,7,9,0,16
12/22/15,3,24,1001,360,87,16,12,4,32
12/22/15,3,26,542,360,85,31,6,0,37
12/22/15,3,27,542,360,78,19,7,0,26
12/22/15,3,28,92,375,16,6,30,1,37
12/22/15,3,29,737,270,77,20,8,1,29
12/22/15,3,30,737,270,88,15,2,0,17
12/23/15,1,1,738,305,123,13,7,3,23
12/23/15,1,2,726,315,28,16,2,4,22
12/23/15,1,3,996,220,80,18,9,0,27
12/23/15,1,4,5302,220,80,23,2,0,25
12/23/15,1,5,642,370,144,8,5,3,16
12/23/15,1,7,542,345,125,14,30,1,45
12/23/15,1,8,7331,350,119,12,22,4,38
12/23/15,1,10,542,370,15,12,1,8,21
12/23/15,1,11,7652,355,91,11,31,10,52
12/23/15,1,12,7393,350,114,17,34,5,56
12/23/15,1,13,642,350,129,15,10,1,26
12/23/15,1,14,8035,360,42,12,1,9,22
12/23/15,1,17,542,370,99,9,5,5,19
12/23/15,1,18,542,350,25,3,4,2,9
12/23/15,1,19,642,360,53,8,5,3,16
12/23/15,1,20,8040,350,93,5,17,0,22
12/23/15,1,23,641,350,136,9,4,0,13
12/23/15,1,24,1001,360,5,1,2,0,3
12/23/15,1,26,542,360,71,27,10,0,37
12/23/15,1,27,542,360,24,10,0,0,10
12/23/15,1,28,92,375,28,3,51,0,54
12/23/15,1,29,737,270,80,19,10,0,29
12/23/15,1,30,737,270,85,18,6,0,24
12/23/15,2,1,738,305,116,14,8,2,24
12/23/15,2,2,726,315,96,23,11,0,34
12/23/15,2,3,996,220,33,0,0,0,0
12/23/15,2,4,5302,220,49,0,0,0,0
12/23/15,2,5,642,370,170,4,3,0,7
12/23/15,2,7,542,345,94,13,28,8,49
12/23/15,2,8,7331,350,107,10,19,2,31
12/23/15,2,10,542,370,141,18,4,1,23
12/23/15,2,11,7652,355,125,13,13,2,28
12/23/15,2,12,7393,350,105,10,37,2,49
12/23/15,2,13,642,350,139,14,4,0,18
12/23/15,2,14,8035,360,140,15,6,2,23
12/23/15,2,17,542,370,152,6,1,2,9
12/23/15,2,19,642,360,38,8,7,3,18
12/23/15,2,20,8040,350,98,0,17,0,17
12/23/15,2,23,641,350,131,2,8,0,10
12/23/15,2,24,1001,360,12,1,4,4,9
12/23/15,2,26,542,360,72,26,11,0,37
12/23/15,2,27,542,360,76,24,2,0,26
12/23/15,2,28,92,375,15,2,26,1,29
12/23/15,2,29,737,270,70,18,7,0,25
12/23/15,2,30,737,270,54,20,7,1,28
12/23/15,3,1,738,305,119,28,8,0,36
12/23/15,3,2,726,315,104,40,12,1,53
12/23/15,3,4,5302,220,71,0,0,0,0
12/23/15,3,5,642,370,138,0,9,2,11
12/23/15,3,7,542,345,91,8,33,7,48
12/23/15,3,8,7331,350,98,12,20,2,34
12/23/15,3,10,542,370,139,12,4,0,16
12/23/15,3,11,7652,355,104,16,19,2,37
12/23/15,3,12,7393,350,78,33,19,3,55
12/23/15,3,13,642,350,115,17,5,3,25
12/23/15,3,14,8035,360,133,17,10,0,27
12/23/15,3,17,542,370,16,2,1,1,4
12/23/15,3,19,642,360,43,7,8,3,18
12/23/15,3,20,8040,350,93,5,17,0,22
12/23/15,3,23,641,350,33,4,1,0,5
12/23/15,3,24,1001,360,47,16,4,4,24
12/23/15,3,26,542,360,28,17,5,0,22
12/23/15,3,27,542,360,60,4,8,0,12
12/23/15,3,28,92,375,12,0,16,1,17
12/23/15,3,29,737,270,43,15,6,0,21
12/23/15,3,30,737,270,39,13,2,1,16
01/04/16,1,1,738,305,92,15,17,3,35
01/04/16,1,2,726,315,106,24,16,2,42
01/04/16,1,3,996,220,5,0,1,0,1
01/04/16,1,4,5302,220,75,21,5,0,26
01/04/16,1,5,642,370,126,18,4,1,23
01/04/16,1,7,294,345,113,12,19,4,35
01/04/16,1,8,775,350,91,9,19,5,33
01/04/16,1,10,542,370,121,16,4,1,21
01/04/16,1,11,7652,355,122,17,7,2,26
01/04/16,1,12,7393,350,80,10,39,0,49
01/04/16,1,13,3062,350,92,13,2,1,16
01/04/16,1,14,8035,360,130,9,5,0,14
01/04/16,1,17,641,370,3,10,1,0,11
01/04/16,1,19,642,360,19,1,1,0,2
01/04/16,1,20,8040,350,17,0,1,1,2
01/04/16,1,21,641,350,18,2,3,0,5
01/04/16,1,23,641,350,19,1,4,0,5
01/04/16,1,24,1001,360,19,2,1,0,3
01/04/16,1,26,542,360,15,6,2,0,8
01/04/16,1,27,542,360,22,6,0,0,6
01/04/16,1,28,92,375,10,1,8,2,11
01/04/16,1,29,737,270,19,3,1,0,4
01/04/16,1,30,737,270,18,3,2,0,5
01/04/16,2,1,738,305,108,19,15,5,39
01/04/16,2,2,726,315,92,53,15,2,70
01/04/16,2,3,996,220,79,23,5,0,28
01/04/16,2,4,5302,220,65,23,4,0,27
01/04/16,2,5,642,370,144,4,5,2,11
01/04/16,2,7,294,345,89,13,15,1,29
01/04/16,2,8,775,350,10,2,4,0,6
01/04/16,2,10,542,370,150,7,6,2,15
01/04/16,2,11,7652,355,139,2,11,2,15
01/04/16,2,12,7393,350,113,24,34,1,59
01/04/16,2,13,3062,350,57,4,5,1,10
01/04/16,2,14,8035,360,124,11,10,1,22
01/04/16,2,16,8032,350,20,1,6,8,15
01/04/16,2,17,435,370,127,14,4,0,18
01/04/16,2,19,642,360,110,10,0,0,10
01/04/16,2,20,8040,350,112,12,11,1,24
01/04/16,2,21,641,350,70,4,15,0,19
01/04/16,2,23,641,350,105,5,4,0,9
01/04/16,2,24,1001,360,108,11,16,5,32
01/04/16,2,26,542,360,68,30,5,0,35
01/04/16,2,27,542,360,94,17,4,0,21
01/04/16,2,29,737,270,76,12,4,0,16
01/04/16,2,30,737,270,62,11,3,0,14
01/04/16,3,1,738,305,114,28,5,4,37
01/04/16,3,2,726,315,102,33,11,6,50
01/04/16,3,3,996,220,64,20,4,0,24
01/04/16,3,4,5302,220,73,20,3,0,23
01/04/16,3,5,642,370,148,3,7,2,12
01/04/16,3,10,542,370,134,14,6,1,21
01/04/16,3,11,7652,355,114,27,11,2,40
01/04/16,3,12,7393,350,92,14,34,11,59
01/04/16,3,14,8035,360,100,27,7,2,36
01/04/16,3,17,435,370,23,0,2,1,3
01/04/16,3,19,642,360,74,0,2,0,2
01/04/16,3,20,8040,350,86,13,8,0,21
01/04/16,3,21,641,350,21,0,4,0,4
01/04/16,3,23,641,350,78,0,7,0,7
01/04/16,3,24,1001,360,64,5,4,5,14
01/04/16,3,26,542,360,47,28,6,0,34
01/04/16,3,27,542,360,78,4,5,0,9
01/04/16,3,29,737,270,41,6,1,0,7
01/04/16,3,30,737,270,51,9,2,0,11
01/05/16,1,1,738,305,119,21,13,2,36
01/05/16,1,2,726,315,126,19,14,0,33
01/05/16,1,3,996,220,68,12,7,0,19
01/05/16,1,4,5302,220,73,22,4,0,26
01/05/16,1,5,642,370,170,8,2,4,14
01/05/16,1,7,294,345,27,3,2,2,7
01/05/16,1,10,542,370,129,19,5,0,24
01/05/16,1,11,7652,355,136,9,10,4,23
01/05/16,1,12,641,350,99,15,39,1,55
01/05/16,1,14,3062,360,143,8,12,1,21
01/05/16,1,17,641,370,112,9,8,4,21
01/05/16,1,18,542,350,25,3,4,2,9
01/05/16,1,19,642,360,156,6,3,0,9
01/05/16,1,20,8040,350,93,9,11,5,25
01/05/16,1,21,641,350,93,0,16,0,16
01/05/16,1,22,542,350,11,3,1,0,4
01/05/16,1,23,641,350,111,13,7,0,20
01/05/16,1,24,1001,360,89,5,16,8,29
01/05/16,1,25,715,375,41,0,11,0,11
01/05/16,1,26,542,360,106,35,5,0,40
01/05/16,1,27,542,360,147,17,5,1,23
01/05/16,1,28,92,375,19,3,22,2,27
01/05/16,1,29,737,270,51,22,10,0,32
01/05/16,1,30,737,270,17,5,3,0,8
01/05/16,2,1,738,305,119,15,10,2,27
01/05/16,2,2,726,315,118,16,9,4,29
01/05/16,2,3,996,220,72,15,8,0,23
01/05/16,2,4,5302,220,77,18,3,0,21
01/05/16,2,5,642,370,175,3,2,0,5
01/05/16,2,7,294,345,136,17,10,1,28
01/05/16,2,11,7652,355,99,15,13,1,29
01/05/16,2,12,641,350,67,7,30,0,37
01/05/16,2,14,3062,360,132,12,12,0,24
01/05/16,2,17,641,370,31,4,8,0,12
01/05/16,2,19,642,360,120,13,2,0,15
01/05/16,2,20,8040,350,97,6,17,7,30
01/05/16,2,21,641,350,86,0,13,0,13
01/05/16,2,22,542,350,71,13,8,0,21
01/05/16,2,23,641,350,81,7,7,0,14
01/05/16,2,24,1001,360,86,6,12,25,43
01/05/16,2,25,715,375,78,0,16,0,16
01/05/16,2,26,542,360,43,19,15,0,34
01/05/16,2,27,542,360,64,10,6,0,16
01/05/16,2,28,92,375,15,0,20,0,20
01/05/16,2,29,737,270,56,25,8,0,33
01/05/16,2,30,737,270,38,28,10,0,38
01/05/16,3,1,738,305,72,13,8,4,25
01/05/16,3,2,726,315,98,28,10,7,45
01/05/16,3,3,996,220,68,19,9,0,28
01/05/16,3,4,5302,220,70,15,4,0,19
01/05/16,3,5,642,370,132,22,6,2,30
01/05/16,3,7,294,345,130,13,4,5,22
01/05/16,3,14,3062,360,141,3,6,4,13
01/05/16,3,16,8040,350,70,20,16,15,51
01/05/16,3,19,642,360,115,13,4,0,17
01/05/16,3,20,8040,350,132,10,8,3,21
01/05/16,3,21,641,350,73,2,15,0,17
01/05/16,3,22,542,350,92,9,13,0,22
01/05/16,3,23,641,350,115,4,10,0,14
01/05/16,3,24,1001,360,104,7,8,9,24
01/05/16,3,25,715,375,90,2,18,0,20
01/05/16,3,26,542,360,77,45,8,0,53
01/05/16,3,27,542,360,109,16,8,0,24
01/05/16,3,28,92,375,21,6,41,12,59
01/05/16,3,29,737,270,76,17,7,0,24
01/05/16,3,30,737,270,52,21,9,0,30
01/06/16,1,1,738,305,97,18,6,6,30
01/06/16,1,2,726,315,128,12,9,2,23
01/06/16,1,3,996,220,28,6,2,0,8
01/06/16,1,4,5302,220,59,21,6,0,27
01/06/16,1,5,642,370,138,23,2,1,26
01/06/16,1,7,294,345,129,18,13,4,35
01/06/16,1,8,775,350,1,0,1,1,2
01/06/16,1,10,542,370,129,19,5,0,24
01/06/16,1,11,7652,355,84,23,5,10,38
01/06/16,1,14,3062,360,152,11,10,0,21
01/06/16,1,16,8040,350,106,14,24,1,39
01/06/16,1,19,642,360,145,5,5,0,10
01/06/16,1,20,8040,350,116,19,6,3,28
01/06/16,1,21,641,350,114,1,24,0,25
01/06/16,1,22,542,350,113,14,8,0,22
01/06/16,1,23,641,350,142,14,5,0,19
01/06/16,1,25,715,375,112,2,19,0,21
01/06/16,1,26,542,360,92,45,13,0,58
01/06/16,1,27,542,360,118,20,19,0,39
01/06/16,1,29,737,270,55,20,4,0,24
01/06/16,1,30,737,270,41,23,5,0,28
01/06/16,2,1,738,305,99,27,8,3,38
01/06/16,2,2,726,315,114,16,12,2,30
01/06/16,2,4,5302,220,60,20,5,0,25
01/06/16,2,5,642,370,99,0,3,1,4
01/06/16,2,7,294,345,127,11,18,2,31
01/06/16,2,8,775,350,121,11,12,1,24
01/06/16,2,9,641,350,24,3,11,2,16
01/06/16,2,10,542,370,3,0,0,1,1
01/06/16,2,11,7652,355,124,18,19,2,39
01/06/16,2,14,3062,360,140,17,6,2,25
01/06/16,2,16,8040,350,103,10,22,0,32
01/06/16,2,19,642,360,117,4,5,0,9
01/06/16,2,20,8040,350,87,13,8,2,23
01/06/16,2,21,641,350,60,2,17,0,19
01/06/16,2,22,542,350,97,9,8,0,17
01/06/16,2,23,641,350,119,5,7,0,12
01/06/16,2,24,7705,360,25,7,3,32,42
01/06/16,2,25,715,375,108,2,20,0,22
01/06/16,2,26,542,360,46,14,11,0,25
01/06/16,2,27,542,360,98,17,6,0,23
01/06/16,2,29,737,270,64,21,3,0,24
01/06/16,2,30,737,270,56,19,7,0,26
01/06/16,3,1,738,305,102,33,10,8,51
01/06/16,3,2,726,315,134,22,16,4,42
01/06/16,3,3,996,220,8,2,1,0,3
01/06/16,3,4,5302,220,75,17,5,0,22
01/06/16,3,7,294,345,111,13,28,7,48
01/06/16,3,8,775,350,68,17,11,10,38
01/06/16,3,11,7652,355,131,20,9,8,37
01/06/16,3,14,3062,360,141,12,11,1,24
01/06/16,3,16,8040,350,105,11,26,5,42
01/06/16,3,19,642,360,86,2,9,0,11
01/06/16,3,20,8040,350,81,4,9,0,13
01/06/16,3,21,641,350,63,3,13,0,16
01/06/16,3,22,542,350,62,17,9,0,26
01/06/16,3,23,641,350,70,4,6,0,10
01/06/16,3,24,7705,360,77,28,6,9,43
01/06/16,3,25,715,375,61,0,14,0,14
01/06/16,3,26,542,360,39,30,3,0,33
01/06/16,3,27,542,360,66,16,4,0,20
01/06/16,3,29,737,270,65,25,4,1,30
01/06/16,3,30,737,270,29,27,6,0,33
01/07/16,1,1,738,305,104,26,14,3,43
01/07/16,1,2,726,315,118,26,12,2,40
01/07/16,1,3,996,220,66,18,10,0,28
01/07/16,1,4,5302,220,59,26,5,0,31
01/07/16,1,7,294,345,78,8,12,0,20
01/07/16,1,8,775,350,109,25,7,1,33
01/07/16,1,11,7652,355,88,28,9,2,39
01/07/16,1,12,1000,350,43,18,28,11,57
01/07/16,1,14,3062,360,113,11,6,5,22
01/07/16,1,16,8040,350,124,16,22,2,40
01/07/16,1,19,642,360,139,6,4,0,10
01/07/16,1,20,8040,350,90,13,11,2,26
01/07/16,1,21,641,350,107,2,18,0,20
01/07/16,1,22,542,350,90,14,19,0,33
01/07/16,1,23,641,350,40,2,6,0,8
01/07/16,1,24,7705,360,121,22,6,9,37
01/07/16,1,25,715,375,91,0,26,0,26
01/07/16,1,26,542,360,95,40,5,0,45
01/07/16,1,27,542,360,69,46,2,0,48
01/07/16,1,29,737,270,52,21,6,0,27
01/07/16,1,30,737,270,67,18,9,0,27
01/07/16,2,1,738,305,109,26,11,3,40
01/07/16,2,2,726,315,113,22,8,4,34
01/07/16,2,3,996,220,57,19,9,0,28
01/07/16,2,4,5302,220,44,27,3,0,30
01/07/16,2,8,775,350,90,17,7,4,28
01/07/16,2,11,7652,355,106,33,5,2,40
01/07/16,2,12,1000,350,54,39,40,3,82
01/07/16,2,14,3062,360,149,5,6,0,11
01/07/16,2,16,8040,350,97,11,33,0,44
01/07/16,2,19,642,360,135,8,5,0,13
01/07/16,2,20,8040,350,117,26,3,2,31
01/07/16,2,21,641,350,66,15,9,0,24
01/07/16,2,22,542,350,100,12,7,0,19
01/07/16,2,24,7705,360,99,12,10,13,35
01/07/16,2,25,715,375,66,1,15,0,16
01/07/16,2,26,542,360,51,19,10,0,29
01/07/16,2,27,542,360,79,24,1,0,25
01/07/16,2,29,737,270,46,23,8,0,31
01/07/16,2,30,737,270,52,20,10,0,30
01/07/16,3,1,738,305,102,37,7,3,47
01/07/16,3,2,726,315,129,25,11,2,38
01/07/16,3,3,996,220,68,20,6,0,26
01/07/16,3,4,5302,220,63,21,4,0,25
01/07/16,3,8,775,350,126,14,11,1,26
01/07/16,3,11,7652,355,137,21,13,5,39
01/07/16,3,12,1000,350,67,19,40,8,67
01/07/16,3,14,3062,360,144,11,9,1,21
01/07/16,3,16,8040,350,113,11,26,2,39
01/07/16,3,19,642,360,141,8,6,0,14
01/07/16,3,20,8040,350,106,20,10,4,34
01/07/16,3,21,641,350,60,2,18,0,20
01/07/16,3,22,542,350,102,15,12,0,27
01/07/16,3,24,7705,360,88,14,6,4,24
01/07/16,3,25,715,375,70,0,17,0,17
01/07/16,3,26,542,360,76,39,4,0,43
01/07/16,3,27,542,360,101,29,4,0,33
01/07/16,3,29,737,270,31,12,4,0,16
01/07/16,3,30,737,270,94,13,5,0,18
01/08/16,1,1,738,305,108,22,8,4,34
01/08/16,1,2,726,315,117,24,15,1,40
01/08/16,1,3,996,220,61,18,8,0,26
01/08/16,1,4,5302,220,79,15,3,0,18
01/08/16,1,7,294,345,11,0,2,0,2
01/08/16,1,8,775,350,116,11,12,2,25
01/08/16,1,10,542,370,6,5,7,3,15
01/08/16,1,11,7652,355,101,20,18,2,40
01/08/16,1,12,1000,350,94,27,24,1,52
01/08/16,1,14,3062,360,49,3,2,1,6
01/08/16,1,16,8040,350,117,17,23,3,43
01/08/16,1,18,542,350,58,13,8,2,23
01/08/16,1,19,642,360,106,12,7,0,19
01/08/16,1,20,8040,350,107,20,14,1,35
01/08/16,1,21,641,350,103,6,112,0,118
01/08/16,1,22,542,350,114,15,7,0,22
01/08/16,1,24,7705,360,123,16,7,10,33
01/08/16,1,25,715,375,114,2,25,0,27
01/08/16,1,26,542,360,85,31,10,0,41
01/08/16,1,28,92,375,3,0,6,1,7
01/08/16,1,29,737,270,61,18,5,0,23
01/08/16,1,30,737,270,70,12,5,0,17
01/08/16,2,1,738,305,105,16,11,3,30
01/08/16,2,2,726,315,105,18,12,2,32
01/08/16,2,3,996,220,67,12,9,0,21
01/08/16,2,4,5302,220,70,18,2,0,20
01/08/16,2,7,294,345,100,17,21,1,39
01/08/16,2,8,775,350,118,12,14,0,26
01/08/16,2,10,542,370,63,10,20,2,32
01/08/16,2,11,7652,355,125,22,5,3,30
01/08/16,2,12,1000,350,87,20,14,1,35
01/08/16,2,16,8040,350,120,9,22,0,31
01/08/16,2,18,542,350,77,11,11,0,22
01/08/16,2,19,642,360,115,8,3,0,11
01/08/16,2,20,8040,350,4,0,0,2,2
01/08/16,2,21,641,350,90,4,13,0,17
01/08/16,2,22,542,350,64,10,16,0,26
01/08/16,2,25,715,375,43,93,2,10,105
01/08/16,2,26,542,360,46,12,2,0,14
01/08/16,2,28,92,375,19,2,32,0,34
01/08/16,2,29,737,270,18,5,2,0,7
01/08/16,2,30,737,270,65,10,3,0,13
01/08/16,3,1,738,305,79,20,7,8,35
01/08/16,3,2,726,315,111,24,45,2,71
01/08/16,3,3,996,220,70,13,7,0,20
01/08/16,3,4,5302,220,40,21,5,0,26
01/08/16,3,7,294,345,96,28,30,8,66
01/08/16,3,8,775,350,110,22,9,2,33
01/08/16,3,10,542,370,96,22,25,1,48
01/08/16,3,11,7652,355,124,28,8,4,40
01/08/16,3,12,1000,350,59,10,21,10,41
01/08/16,3,16,8040,350,113,9,29,4,42
01/08/16,3,18,542,350,75,13,0,0,13
01/08/16,3,19,642,360,20,2,1,0,3
01/08/16,3,20,8040,350,8,4,3,2,9
01/08/16,3,21,641,350,4,0,1,0,1
01/08/16,3,22,542,350,86,12,7,0,19
01/08/16,3,25,715,375,34,0,2,0,2
01/08/16,3,26,542,360,78,27,7,0,34
01/08/16,3,27,542,360,65,21,3,0,24
01/08/16,3,28,92,375,10,1,33,0,34
01/08/16,3,29,737,270,55,17,4,0,21
01/08/16,3,30,737,270,85,8,2,0,10
01/11/16,1,1,738,305,81,24,6,7,37
01/11/16,1,2,726,315,103,9,13,1,23
01/11/16,1,3,996,220,62,18,9,0,27
01/11/16,1,4,5302,220,73,24,3,0,27
01/11/16,1,7,293,345,83,33,23,2,58
01/11/16,1,8,775,350,129,8,8,2,18
01/11/16,1,10,542,370,73,9,26,1,36
01/11/16,1,11,7652,355,124,23,9,3,35
01/11/16,1,12,1000,350,71,28,26,10,64
01/11/16,1,15,775,350,32,4,1,0,5
01/11/16,1,16,8040,350,110,7,20,3,30
01/11/16,1,18,542,350,90,11,17,0,28
01/11/16,1,20,8040,350,101,18,14,7,39
01/11/16,1,22,542,350,59,7,12,0,19
01/11/16,1,24,7705,360,18,2,5,0,7
01/11/16,1,25,715,375,75,2,17,0,19
01/11/16,1,26,542,360,66,23,7,0,30
01/11/16,1,27,542,360,118,23,2,0,25
01/11/16,1,28,92,375,23,1,40,0,41
01/11/16,1,29,737,270,21,8,7,0,15
01/11/16,1,30,737,270,56,19,15,0,34
01/11/16,2,1,738,305,109,19,18,4,41
01/11/16,2,2,726,315,78,28,5,4,37
01/11/16,2,3,996,220,15,2,1,0,3
01/11/16,2,4,5302,220,72,23,4,0,27
01/11/16,2,5,642,370,182,0,0,1,1
01/11/16,2,7,293,345,110,14,27,2,43
01/11/16,2,8,775,350,135,9,8,2,19
01/11/16,2,10,542,370,96,7,22,1,30
01/11/16,2,11,7652,355,133,18,12,3,33
01/11/16,2,12,1000,350,87,19,22,4,45
01/11/16,2,15,775,350,111,14,8,0,22
01/11/16,2,18,542,350,73,15,7,2,24
01/11/16,2,20,8040,350,96,16,13,7,36
01/11/16,2,22,542,350,75,10,20,0,30
01/11/16,2,25,715,375,72,24,1,0,25
01/11/16,2,26,542,360,8,1,2,0,3
01/11/16,2,27,542,360,90,18,12,0,30
01/11/16,2,28,92,375,43,0,70,0,70
01/11/16,2,30,737,270,56,24,14,0,38
01/11/16,3,1,738,305,93,36,11,10,57
01/11/16,3,2,726,315,111,11,19,1,31
01/11/16,3,3,996,220,46,13,3,0,16
01/11/16,3,4,5302,220,77,21,5,0,26
01/11/16,3,5,642,370,173,2,3,2,7
01/11/16,3,7,293,345,112,25,21,3,49
01/11/16,3,8,775,350,114,13,14,3,30
01/11/16,3,10,542,370,135,18,20,1,39
01/11/16,3,11,7652,355,133,21,5,1,27
01/11/16,3,12,1000,350,57,23,25,12,60
01/11/16,3,15,755,350,96,11,5,0,16
01/11/16,3,20,8040,350,74,11,11,10,32
01/11/16,3,22,542,350,127,10,12,0,22
01/11/16,3,25,715,375,23,0,6,0,6
01/11/16,3,26,542,360,31,5,3,0,8
01/11/16,3,27,542,360,117,30,6,0,36
01/11/16,3,28,92,375,42,2,65,0,67
01/11/16,3,29,737,270,50,14,6,0,20
01/11/16,3,30,737,270,61,21,13,0,34
01/12/16,1,1,738,305,96,19,6,5,30
01/12/16,1,2,726,315,100,18,14,2,34
01/12/16,1,3,996,220,77,10,8,0,18
01/12/16,1,4,5302,220,74,22,3,0,25
01/12/16,1,5,642,370,160,10,0,3,13
01/12/16,1,7,293,345,97,30,0,25,55
01/12/16,1,8,775,350,131,9,13,1,23
01/12/16,1,10,542,370,115,11,19,0,30
01/12/16,1,11,7652,355,130,31,11,3,45
01/12/16,1,12,1000,350,91,10,30,8,48
01/12/16,1,15,755,350,123,8,11,0,19
01/12/16,1,16,8040,350,45,6,24,4,34
01/12/16,1,20,8040,350,99,27,11,8,46
01/12/16,1,25,715,375,160,6,10,0,16
01/12/16,1,26,542,360,40,10,10,0,20
01/12/16,1,27,542,360,112,34,17,0,51
01/12/16,1,28,92,375,43,3,79,3,85
01/12/16,1,29,737,270,72,21,6,0,27
01/12/16,1,30,737,270,83,18,4,0,22
01/12/16,2,1,738,305,95,13,13,1,27
01/12/16,2,2,726,315,23,5,3,0,8
01/12/16,2,3,996,220,71,11,7,0,18
01/12/16,2,4,5302,220,63,20,4,0,24
01/12/16,2,5,642,370,172,1,3,2,6
01/12/16,2,7,293,345,125,10,21,1,32
01/12/16,2,8,775,350,137,11,10,0,21
01/12/16,2,10,542,370,140,6,9,1,16
01/12/16,2,11,7652,355,121,37,9,4,50
01/12/16,2,12,1000,350,101,18,18,4,40
01/12/16,2,15,755,350,120,8,4,0,12
01/12/16,2,16,8040,350,138,12,19,0,31
01/12/16,2,20,8040,350,96,21,12,4,37
01/12/16,2,24,7705,360,85,10,13,7,30
01/12/16,2,25,715,375,87,4,16,0,20
01/12/16,2,27,542,360,109,15,7,0,22
01/12/16,2,28,92,375,46,19,47,1,67
01/12/16,2,29,737,270,41,27,10,1,38
01/12/16,2,30,737,270,120,12,6,0,18
01/12/16,3,1,738,305,110,30,6,2,38
01/12/16,3,2,726,315,14,9,0,2,11
01/12/16,3,3,996,220,75,9,6,1,16
01/12/16,3,4,5302,220,62,19,5,0,24
01/12/16,3,5,642,370,165,1,3,4,8
01/12/16,3,7,293,345,35,7,18,2,27
01/12/16,3,8,775,350,138,12,9,4,25
01/12/16,3,10,542,370,124,12,20,2,34
01/12/16,3,11,7652,355,97,22,26,1,49
01/12/16,3,12,1000,350,67,15,23,7,45
01/12/16,3,15,755,350,79,4,2,0,6
01/12/16,3,16,8040,350,121,11,23,4,38
01/12/16,3,20,8040,350,44,19,4,2,25
01/12/16,3,24,7705,360,54,8,5,5,18
01/12/16,3,25,715,375,48,0,4,0,4
01/12/16,3,27,542,360,61,10,6,0,16
01/12/16,3,28,92,375,25,4,45,3,52
01/12/16,3,29,737,270,49,24,8,2,34
01/12/16,3,30,737,270,130,10,4,0,14
01/13/16,1,1,738,305,109,30,6,3,39
01/13/16,1,2,726,315,120,24,6,0,30
01/13/16,1,3,996,220,83,15,10,0,25
01/13/16,1,4,5302,220,69,24,3,0,27
01/13/16,1,5,642,370,157,5,4,1,10
01/13/16,1,8,775,350,138,15,2,5,22
01/13/16,1,10,542,370,108,19,13,2,34
01/13/16,1,11,7652,355,43,2,2,2,6
01/13/16,1,12,1000,350,92,10,25,5,40
01/13/16,1,15,755,350,126,8,9,0,17
01/13/16,1,16,8040,350,95,19,19,4,42
01/13/16,1,17,641,370,7,0,2,4,6
01/13/16,1,20,8040,350,105,41,11,9,61
01/13/16,1,24,7705,360,121,8,22,6,36
01/13/16,1,25,715,375,116,5,15,0,20
01/13/16,1,27,542,360,145,28,5,0,33
01/13/16,1,28,92,375,47,11,62,4,77
01/13/16,1,29,737,270,74,25,18,0,43
01/13/16,1,30,737,270,88,26,12,0,38
01/13/16,2,1,738,305,102,27,10,3,40
01/13/16,2,2,726,315,120,21,8,2,31
01/13/16,2,3,996,220,75,0,0,0,0
01/13/16,2,4,5302,220,54,0,0,0,0
01/13/16,2,5,642,370,189,0,5,1,6
01/13/16,2,7,293,345,41,6,23,10,39
01/13/16,2,8,775,350,70,13,10,1,24
01/13/16,2,10,542,370,92,18,15,0,33
01/13/16,2,12,1000,350,74,19,15,7,41
01/13/16,2,15,755,350,131,4,7,0,11
01/13/16,2,16,8040,350,122,8,14,2,24
01/13/16,2,17,641,370,150,0,3,3,6
01/13/16,2,18,542,350,31,9,12,3,24
01/13/16,2,20,8040,350,81,23,14,4,41
01/13/16,2,24,7705,360,120,7,15,10,32
01/13/16,2,25,715,375,111,2,13,0,15
01/13/16,2,26,542,360,33,14,13,0,27
01/13/16,2,27,542,360,100,7,5,0,12
01/13/16,2,28,92,375,33,9,49,1,59
01/13/16,2,29,737,270,32,27,16,1,44
01/13/16,2,30,737,270,70,20,11,1,32
01/13/16,3,1,738,305,107,32,9,3,44
01/13/16,3,2,726,315,130,11,7,2,20
01/13/16,3,3,996,220,39,0,0,0,0
01/13/16,3,4,5302,220,37,0,0,0,0
01/13/16,3,5,642,370,177,2,2,1,5
01/13/16,3,7,293,345,97,26,35,7,68
01/13/16,3,8,775,350,17,6,1,0,7
01/13/16,3,10,542,370,122,18,21,2,41
01/13/16,3,12,1000,350,24,3,23,7,33
01/13/16,3,15,755,350,104,7,4,0,11
01/13/16,3,16,8040,350,121,10,15,2,27
01/13/16,3,17,641,370,9,0,1,1,2
01/13/16,3,18,542,350,18,4,13,2,19
01/13/16,3,20,8040,350,43,18,10,5,33
01/13/16,3,24,7705,360,76,7,12,2,21
01/13/16,3,25,715,375,6,2,1,0,3
01/13/16,3,26,542,360,42,21,11,0,32
01/13/16,3,27,542,360,61,14,7,0,21
01/13/16,3,28,92,375,39,7,38,2,47
01/13/16,3,29,737,270,63,22,14,6,42
01/13/16,3,30,737,270,36,0,0,0,0
01/14/16,1,1,738,305,107,26,14,0,40
01/14/16,1,2,726,315,131,13,6,1,20
01/14/16,1,3,996,220,67,15,8,0,23
01/14/16,1,4,5302,220,75,21,3,0,24
01/14/16,1,5,642,370,181,4,1,0,5
01/14/16,1,7,293,345,113,14,16,2,32
01/14/16,1,8,775,350,84,8,11,2,21
01/14/16,1,10,542,370,101,4,17,5,26
01/14/16,1,12,1000,350,34,3,19,10,32
01/14/16,1,15,755,350,42,1,7,0,8
01/14/16,1,16,8040,350,95,5,3,3,11
01/14/16,1,17,641,370,161,0,3,3,6
01/14/16,1,20,8040,350,92,36,10,1,47
01/14/16,1,22,542,350,2,0,0,0,0
01/14/16,1,24,7705,360,32,6,10,3,19
01/14/16,1,25,715,375,133,3,15,0,18
01/14/16,1,26,542,360,65,26,17,0,43
01/14/16,1,27,542,360,113,29,5,0,34
01/14/16,1,28,92,375,38,7,38,1,46
01/14/16,1,29,737,270,78,10,9,0,19
01/14/16,1,30,737,270,72,12,10,0,22
01/14/16,2,1,738,305,114,25,11,2,38
01/14/16,2,2,726,315,111,12,5,7,24
01/14/16,2,3,996,220,72,14,6,0,20
01/14/16,2,4,5302,220,66,22,5,0,27
01/14/16,2,5,642,370,181,4,1,0,5
01/14/16,2,7,293,345,113,14,12,1,27
01/14/16,2,10,542,370,125,14,18,1,33
01/14/16,2,11,7742,355,71,1,13,4,18
01/14/16,2,12,1000,350,104,4,29,1,34
01/14/16,2,15,755,350,119,5,10,0,15
01/14/16,2,16,8040,350,134,7,20,3,30
01/14/16,2,17,641,370,157,2,5,2,9
01/14/16,2,18,542,350,2,1,1,2,4
01/14/16,2,20,8040,350,87,20,15,6,41
01/14/16,2,22,542,350,59,3,13,0,16
01/14/16,2,26,542,360,56,18,4,0,22
01/14/16,2,27,542,360,98,15,7,0,22
01/14/16,2,28,92,375,33,5,34,2,41
01/14/16,2,29,737,270,34,21,6,0,27
01/14/16,2,30,737,270,38,20,5,0,25
01/14/16,3,1,738,305,94,30,14,1,45
01/14/16,3,2,726,315,120,30,2,3,35
01/14/16,3,3,996,220,70,15,5,0,20
01/14/16,3,4,5302,220,52,21,7,0,28
01/14/16,3,7,293,345,97,27,17,6,50
01/14/16,3,10,542,370,137,15,14,1,30
01/14/16,3,12,1000,350,83,21,24,18,63
01/14/16,3,13,8030,350,23,1,6,3,10
01/14/16,3,15,755,350,111,5,4,0,9
01/14/16,3,16,8040,350,123,12,11,2,25
01/14/16,3,17,641,370,104,1,4,4,9
01/14/16,3,18,542,350,43,21,5,1,27
01/14/16,3,20,8040,350,56,13,6,2,21
01/14/16,3,22,542,350,103,8,13,0,21
01/14/16,3,26,542,360,77,14,17,0,31
01/14/16,3,27,542,360,93,18,10,0,28
01/14/16,3,28,92,375,33,2,23,2,27
01/14/16,3,29,737,270,72,18,2,0,20
01/14/16,3,30,737,270,84,10,4,0,14
01/15/16,1,1,738,305,88,35,9,4,48
01/15/16,1,2,726,315,126,19,3,2,24
01/15/16,1,3,996,220,82,10,10,0,20
01/15/16,1,4,5302,220,58,28,3,0,31
01/15/16,1,7,293,345,94,26,18,7,51
01/15/16,1,8,775,350,23,3,0,0,3
01/15/16,1,10,542,370,96,23,12,1,36
01/15/16,1,11,7742,355,72,7,9,4,20
01/15/16,1,12,1000,350,74,8,28,3,39
01/15/16,1,13,8030,350,136,9,7,3,19
01/15/16,1,15,755,350,80,7,3,0,10
01/15/16,1,16,8040,350,29,2,4,2,8
01/15/16,1,17,641,370,161,7,8,3,18
01/15/16,1,18,542,350,22,10,9,0,19
01/15/16,1,20,8040,350,106,38,9,4,51
01/15/16,1,22,542,350,120,6,14,0,20
01/15/16,1,24,7705,360,34,5,2,0,7
01/15/16,1,26,542,360,67,13,32,0,45
01/15/16,1,27,542,360,64,8,7,0,15
01/15/16,1,29,737,270,66,23,9,0,32
01/15/16,1,30,737,270,75,18,10,0,28
01/15/16,2,1,738,305,110,22,11,2,35
01/15/16,2,2,726,315,119,16,4,1,21
01/15/16,2,3,996,220,57,20,11,0,31
01/15/16,2,4,5302,220,23,32,7,0,39
01/15/16,2,7,293,345,55,13,7,3,23
01/15/16,2,8,775,350,118,26,5,2,33
01/15/16,2,10,542,370,90,22,14,3,39
01/15/16,2,12,1000,350,81,4,25,15,44
01/15/16,2,13,8030,350,65,12,1,1,14
01/15/16,2,15,755,350,110,4,11,0,15
01/15/16,2,17,641,370,180,1,2,2,5
01/15/16,2,20,8040,350,86,11,19,9,39
01/15/16,2,22,542,350,84,8,10,0,18
01/15/16,2,24,7705,360,29,5,4,3,12
01/15/16,2,26,542,360,71,8,21,0,29
01/15/16,2,27,542,360,114,10,3,0,13
01/15/16,2,29,737,270,71,24,7,0,31
01/15/16,2,30,737,270,60,19,9,0,28
01/15/16,3,1,738,305,107,30,8,1,39
01/15/16,3,2,726,315,116,22,3,3,28
01/15/16,3,3,996,220,71,19,4,0,23
01/15/16,3,4,5302,220,31,35,4,1,40
01/15/16,3,7,293,345,4,1,2,0,3
01/15/16,3,8,775,350,111,24,6,2,32
01/15/16,3,10,542,370,115,18,23,3,44
01/15/16,3,12,1000,350,86,13,28,8,49
01/15/16,3,13,8030,350,121,19,3,2,24
01/15/16,3,15,755,350,191,10,7,0,17
01/15/16,3,17,641,370,148,1,6,1,8
01/15/16,3,20,8040,350,63,7,16,10,33
01/15/16,3,22,542,350,5,1,1,0,2
01/15/16,3,26,542,360,79,7,24,0,31
01/15/16,3,27,542,360,108,18,6,0,24
01/15/16,3,29,737,270,65,22,5,0,27
01/15/16,3,30,737,270,70,17,6,1,24
01/18/16,1,1,738,305,78,31,8,5,44
01/18/16,1,2,726,315,74,16,1,1,18
01/18/16,1,4,5302,220,50,20,2,0,22
01/18/16,1,5,8038,370,125,16,13,6,35
01/18/16,1,6,747,370,25,1,7,2,10
01/18/16,1,8,775,350,80,14,11,4,29
01/18/16,1,10,542,370,94,26,12,0,38
01/18/16,1,12,1000,350,83,8,20,5,33
01/18/16,1,13,8030,350,141,6,6,0,12
01/18/16,1,15,755,350,110,4,10,0,14
01/18/16,1,16,8040,350,20,2,2,0,4
01/18/16,1,17,641,370,166,0,0,2,2
01/18/16,1,20,8040,350,118,16,14,11,41
01/18/16,1,22,542,350,120,6,14,0,20
01/18/16,1,23,641,350,40,2,6,0,8
01/18/16,1,26,542,360,85,12,24,0,36
01/18/16,1,27,542,360,116,24,2,0,26
01/18/16,1,29,737,270,70,14,6,0,20
01/18/16,1,30,737,270,28,0,0,0,0
01/18/16,2,1,738,305,117,31,8,1,40
01/18/16,2,2,726,315,86,12,27,4,43
01/18/16,2,4,5302,220,51,21,3,0,24
01/18/16,2,5,8038,370,161,7,2,5,14
01/18/16,2,6,747,370,141,7,9,9,25
01/18/16,2,8,775,350,120,18,7,6,31
01/18/16,2,10,542,370,126,19,12,0,31
01/18/16,2,12,1000,350,41,1,12,4,17
01/18/16,2,13,8030,350,135,7,6,0,13
01/18/16,2,15,755,350,120,15,7,0,22
01/18/16,2,16,8040,350,7,0,1,0,1
01/18/16,2,17,641,370,145,1,8,6,15
01/18/16,2,20,8040,350,97,16,18,4,38
01/18/16,2,22,542,350,84,8,10,0,18
01/18/16,2,23,641,350,119,5,7,0,12
01/18/16,2,26,542,360,67,16,27,0,43
01/18/16,2,27,542,360,114,10,3,0,13
01/18/16,2,29,737,270,55,16,4,0,20
01/18/16,3,1,738,305,99,44,11,4,59
01/18/16,3,2,726,315,131,13,9,2,24
01/18/16,3,3,996,220,88,6,12,0,18
01/18/16,3,4,5302,220,69,19,4,0,23
01/18/16,3,5,8038,370,159,18,5,4,27
01/18/16,3,6,747,370,151,10,7,6,23
01/18/16,3,7,293,345,81,19,38,9,66
01/18/16,3,8,775,350,104,18,11,6,35
01/18/16,3,10,542,370,122,22,12,2,36
01/18/16,3,12,1000,350,72,6,29,8,43
01/18/16,3,13,8030,350,123,3,8,13,24
01/18/16,3,15,755,350,97,23,3,0,26
01/18/16,3,17,641,370,4,0,1,1,2
01/18/16,3,20,8040,350,99,25,12,8,45
01/18/16,3,22,542,350,5,1,1,0,2
01/18/16,3,24,7705,360,94,13,7,4,24
01/18/16,3,26,542,360,87,13,26,0,39
01/18/16,3,27,542,360,108,18,6,0,24
01/18/16,3,29,737,270,71,13,2,0,15
01/19/16,1,1,738,305,68,45,8,1,54
01/19/16,1,2,726,315,111,16,7,0,23
01/19/16,1,3,996,220,70,21,10,0,31
01/19/16,1,4,5302,220,72,18,3,0,21
01/19/16,1,5,8038,370,152,9,15,2,26
01/19/16,1,6,747,370,120,3,9,9,21
01/19/16,1,7,293,345,90,14,14,0,28
01/19/16,1,8,775,350,99,13,10,1,24
01/19/16,1,10,542,370,104,18,9,0,27
01/19/16,1,12,1000,350,83,11,23,0,34
01/19/16,1,13,8030,350,154,4,8,1,13
01/19/16,1,15,755,350,55,4,1,0,5
01/19/16,1,20,8040,350,128,29,17,9,55
01/19/16,1,24,7705,360,123,17,9,11,37
01/19/16,1,26,542,360,98,29,29,0,58
01/19/16,1,28,92,375,93,7,1,11,19
01/19/16,1,29,737,270,80,26,10,0,36
01/19/16,2,1,738,305,59,46,7,7,60
01/19/16,2,2,726,315,132,15,1,2,18
01/19/16,2,3,996,220,58,28,12,0,40
01/19/16,2,4,5302,220,65,19,2,0,21
01/19/16,2,5,8038,370,174,16,1,0,17
01/19/16,2,6,747,370,110,6,20,4,30
01/19/16,2,7,293,345,99,14,23,4,41
01/19/16,2,8,775,350,104,21,9,5,35
01/19/16,2,10,542,370,109,18,13,1,32
01/19/16,2,12,1000,350,83,5,29,7,41
01/19/16,2,13,8030,350,137,7,0,1,8
01/19/16,2,15,755,350,150,9,11,0,20
01/19/16,2,20,8040,350,115,14,10,7,31
01/19/16,2,22,542,350,39,24,6,0,30
01/19/16,2,24,7705,360,104,10,11,11,32
01/19/16,2,26,542,360,58,13,20,0,33
01/19/16,2,28,92,375,134,10,4,0,14
01/19/16,2,29,737,270,62,20,6,0,26
01/19/16,3,1,738,305,90,76,15,1,92
01/19/16,3,2,726,315,120,17,5,4,26
01/19/16,3,3,996,220,71,21,10,0,31
01/19/16,3,4,5302,220,69,18,6,1,25
01/19/16,3,5,8038,370,176,10,3,1,14
01/19/16,3,6,747,370,124,2,23,6,31
01/19/16,3,7,293,345,111,10,28,4,42
01/19/16,3,8,775,350,119,26,8,2,36
01/19/16,3,10,542,370,108,35,13,3,51
01/19/16,3,12,1000,350,83,17,34,8,59
01/19/16,3,13,8030,350,133,2,8,1,11
01/19/16,3,15,755,350,29,4,1,0,5
01/19/16,3,20,8040,350,60,6,3,10,19
01/19/16,3,22,542,350,48,32,9,0,41
01/19/16,3,24,7705,360,94,10,7,6,23
01/19/16,3,26,542,360,74,15,16,0,31
01/19/16,3,28,92,375,100,9,3,6,18
01/19/16,3,29,737,270,56,0,0,0,0
01/20/16,1,1,738,305,75,55,10,2,67
01/20/16,1,2,726,315,121,22,1,0,23
01/20/16,1,3,996,220,75,10,6,0,16
01/20/16,1,4,5302,220,69,23,3,0,26
01/20/16,1,5,8038,370,110,5,4,2,11
01/20/16,1,6,747,370,112,10,9,6,25
01/20/16,1,7,293,345,85,7,19,2,28
01/20/16,1,8,775,350,73,22,4,5,31
01/20/16,1,10,542,370,91,19,9,2,30
01/20/16,1,12,1000,350,57,14,18,3,35
01/20/16,1,13,8030,350,151,2,6,6,14
01/20/16,1,19,642,360,14,1,8,0,9
01/20/16,1,20,8040,350,114,23,15,8,46
01/20/16,1,22,542,350,92,42,13,0,55
01/20/16,1,24,7705,360,126,14,7,6,27
01/20/16,1,26,542,360,125,26,16,0,42
01/20/16,1,28,92,375,138,31,3,4,38
01/20/16,1,29,737,270,76,21,10,0,31
01/20/16,2,1,738,305,96,21,15,2,38
01/20/16,2,2,726,315,134,16,2,2,20
01/20/16,2,3,996,220,63,14,8,1,23
01/20/16,2,4,5302,220,58,24,4,0,28
01/20/16,2,6,747,370,128,15,12,6,33
01/20/16,2,7,293,345,91,8,29,4,41
01/20/16,2,8,775,350,82,22,7,0,29
01/20/16,2,10,542,370,94,22,16,1,39
01/20/16,2,13,8030,350,142,7,7,0,14
01/20/16,2,15,755,350,150,9,11,0,20
01/20/16,2,19,642,360,102,0,23,0,23
01/20/16,2,20,8040,350,32,5,4,5,14
01/20/16,2,22,542,350,39,24,6,0,30
01/20/16,2,24,7705,360,6,0,2,3,5
01/20/16,2,26,542,360,117,15,12,0,27
01/20/16,2,28,92,375,130,24,2,1,27
01/20/16,2,29,737,270,60,22,7,0,29
01/20/16,3,1,738,305,121,10,13,5,28
01/20/16,3,2,726,315,125,22,3,3,28
01/20/16,3,3,996,220,68,13,7,0,20
01/20/16,3,4,5302,220,72,21,6,0,27
01/20/16,3,6,747,370,143,4,8,4,16
01/20/16,3,7,293,345,93,45,22,3,70
01/20/16,3,10,542,370,130,23,16,1,40
01/20/16,3,13,8030,350,140,7,3,4,14
01/20/16,3,15,755,350,47,4,5,0,9
01/20/16,3,19,642,360,14,8,1,0,9
01/20/16,3,21,775,350,4,0,1,0,1
01/20/16,3,22,542,350,140,74,24,0,98
01/20/16,3,24,7705,360,55,6,4,6,16
01/20/16,3,26,542,360,63,6,10,0,16
01/20/16,3,28,92,375,69,9,3,4,16
01/20/16,3,29,737,270,49,20,8,1,29
01/21/16,1,1,738,305,105,25,17,3,45
01/21/16,1,2,726,315,84,24,2,2,28
01/21/16,1,3,996,220,33,5,3,0,8
01/21/16,1,4,5302,220,66,26,5,0,31
01/21/16,1,5,8038,400,37,0,1,3,4
01/21/16,1,6,747,370,146,16,10,7,33
01/21/16,1,7,293,345,103,33,22,5,60
01/21/16,1,10,542,370,118,37,8,4,49
01/21/16,1,11,7742,355,36,10,27,3,40
01/21/16,1,13,8030,400,159,2,8,0,10
01/21/16,1,15,755,350,109,12,3,0,15
01/21/16,1,19,642,360,162,1,5,0,6
01/21/16,1,21,775,350,116,32,10,0,42
01/21/16,1,22,542,350,76,42,12,0,54
01/21/16,1,24,7705,360,60,8,5,4,17
01/21/16,1,26,542,360,124,25,15,0,40
01/21/16,1,28,92,375,129,11,6,1,18
01/21/16,1,29,737,270,70,27,3,0,30
01/21/16,2,1,738,305,117,9,14,4,27
01/21/16,2,2,726,315,81,20,2,0,22
01/21/16,2,3,996,220,29,6,2,0,8
01/21/16,2,4,5302,220,73,22,3,0,25
01/21/16,2,5,8038,400,138,26,0,1,27
01/21/16,2,6,747,370,140,12,9,5,26
01/21/16,2,7,293,345,6,1,6,1,8
01/21/16,2,10,542,370,134,22,9,1,32
01/21/16,2,11,7742,355,79,20,43,0,63
01/21/16,2,13,8030,400,117,5,13,3,21
01/21/16,2,15,755,350,105,18,5,0,23
01/21/16,2,19,642,360,164,1,3,0,4
01/21/16,2,21,775,350,77,2,6,0,8
01/21/16,2,22,542,350,69,26,15,0,41
01/21/16,2,24,7705,360,116,13,10,7,30
01/21/16,2,26,542,360,99,12,13,0,25
01/21/16,2,28,92,375,136,11,3,2,16
01/21/16,2,29,737,270,50,22,10,0,32
01/21/16,2,30,729,270,15,33,2,0,35
01/21/16,3,1,738,305,105,19,21,0,40
01/21/16,3,2,726,315,48,20,4,3,27
01/21/16,3,3,996,220,72,12,8,0,20
01/21/16,3,4,5302,220,65,20,4,0,24
01/21/16,3,5,8038,400,161,9,0,2,11
01/21/16,3,6,747,370,145,15,8,10,33
01/21/16,3,10,542,370,118,32,11,0,43
01/21/16,3,11,7742,355,85,17,40,3,60
01/21/16,3,13,8030,400,132,3,9,5,17
01/21/16,3,15,755,350,27,5,4,0,9
01/21/16,3,19,642,360,64,0,0,0,0
01/21/16,3,21,775,350,25,6,2,0,8
01/21/16,3,22,542,350,17,6,5,0,11
01/21/16,3,24,7705,360,11,8,0,1,9
01/21/16,3,26,542,360,44,13,1,0,14
01/21/16,3,28,92,375,54,5,0,3,8
01/21/16,3,29,737,270,31,10,7,0,17
01/21/16,3,30,729,270,22,25,2,0,27
01/22/16,1,1,738,305,116,12,17,2,31
01/22/16,1,2,726,315,104,31,2,2,35
01/22/16,1,3,996,220,72,12,10,0,22
01/22/16,1,4,5302,220,52,23,5,0,28
01/22/16,1,5,8038,400,167,9,1,1,11
01/22/16,1,6,747,370,145,17,5,9,31
01/22/16,1,7,293,345,99,23,16,6,45
01/22/16,1,10,542,370,147,11,11,0,22
01/22/16,1,11,7742,355,92,26,34,2,62
01/22/16,1,13,8030,400,159,0,8,0,8
01/22/16,1,15,755,350,124,11,15,0,26
01/22/16,1,16,8040,350,42,8,27,9,44
01/22/16,1,19,642,360,172,1,3,0,4
01/22/16,1,21,775,350,92,27,12,0,39
01/22/16,1,22,542,350,104,22,23,0,45
01/22/16,1,26,542,360,127,25,15,0,40
01/22/16,1,30,729,270,55,18,4,0,22
01/22/16,2,1,738,305,134,8,9,4,21
01/22/16,2,2,726,315,126,35,2,2,39
01/22/16,2,3,996,220,77,10,9,0,19
01/22/16,2,4,5302,220,49,21,3,0,24
01/22/16,2,5,8038,400,179,3,0,3,6
01/22/16,2,6,747,370,151,18,8,2,28
01/22/16,2,7,293,345,126,7,23,5,35
01/22/16,2,10,542,370,37,6,13,2,21
01/22/16,2,11,7742,355,117,11,37,1,49
01/22/16,2,13,8030,400,134,6,10,1,17
01/22/16,2,15,755,350,124,5,7,0,12
01/22/16,2,19,642,360,157,1,3,0,4
01/22/16,2,21,775,350,86,20,5,0,25
01/22/16,2,22,542,350,87,18,17,0,35
01/22/16,2,23,642,350,19,12,0,0,12
01/22/16,2,26,542,360,49,11,6,0,17
01/22/16,2,27,542,360,92,23,14,0,37
01/22/16,2,30,729,270,70,24,5,0,29
01/22/16,3,1,738,305,117,27,15,2,44
01/22/16,3,2,726,315,121,30,5,1,36
01/22/16,3,3,996,220,80,9,11,0,20
01/22/16,3,5,8038,400,176,1,0,2,3
01/22/16,3,6,747,370,131,19,13,6,38
01/22/16,3,7,293,345,107,4,30,3,37
01/22/16,3,11,7742,355,104,11,45,2,58
01/22/16,3,13,8030,400,134,2,14,0,16
01/22/16,3,15,755,350,139,11,10,0,21
01/22/16,3,19,642,360,156,2,3,0,5
01/22/16,3,21,775,350,37,14,7,0,21
01/22/16,3,22,542,350,56,11,18,0,29
01/22/16,3,23,642,350,21,12,1,0,13
01/22/16,3,27,542,360,83,29,6,0,35
01/22/16,3,30,729,270,98,17,4,0,21
01/25/16,1,1,738,305,114,14,8,16,38
01/25/16,1,2,726,315,118,32,1,2,35
01/25/16,1,3,996,220,81,10,8,0,18
01/25/16,1,5,8038,400,159,4,0,2,6
01/25/16,1,6,747,370,103,7,5,7,19
01/25/16,1,7,293,345,118,33,23,4,60
01/25/16,1,11,294,355,82,15,35,4,54
01/25/16,1,12,92,350,55,10,18,0,28
01/25/16,1,13,8030,400,136,1,9,4,14
01/25/16,1,15,755,350,162,16,8,0,24
01/25/16,1,19,642,360,146,2,5,0,7
01/25/16,1,21,775,350,94,41,8,0,49
01/25/16,1,22,542,350,91,23,1,0,24
01/25/16,1,27,542,360,82,33,4,0,37
01/25/16,1,30,729,270,57,26,3,0,29
01/25/16,2,1,738,305,127,9,12,2,23
01/25/16,2,2,726,315,118,30,4,2,36
01/25/16,2,3,996,220,75,15,9,0,24
01/25/16,2,4,5302,220,45,15,3,0,18
01/25/16,2,5,8038,400,167,11,0,1,12
01/25/16,2,6,747,370,132,33,4,10,47
01/25/16,2,7,293,345,104,14,20,3,37
01/25/16,2,12,92,350,98,28,27,0,55
01/25/16,2,13,8030,400,144,7,2,2,11
01/25/16,2,15,755,350,129,15,2,0,17
01/25/16,2,18,542,350,91,13,30,3,46
01/25/16,2,19,642,360,149,2,5,0,7
01/25/16,2,21,775,350,88,32,0,0,32
01/25/16,2,22,542,350,89,14,16,0,30
01/25/16,2,23,642,350,140,3,3,0,6
01/25/16,2,26,542,360,71,14,2,0,16
01/25/16,2,27,542,360,100,27,6,0,33
01/25/16,2,30,729,270,53,21,5,0,26
01/25/16,3,1,738,305,121,12,13,1,26
01/25/16,3,2,726,315,125,35,2,2,39
01/25/16,3,3,996,220,10,0,0,0,0
01/25/16,3,4,5302,220,63,0,0,0,0
01/25/16,3,6,747,370,130,24,14,5,43
01/25/16,3,7,293,345,110,29,16,6,51
01/25/16,3,11,294,355,98,19,23,9,51
01/25/16,3,12,92,350,111,27,32,1,60
01/25/16,3,13,8030,400,145,7,12,1,20
01/25/16,3,18,542,350,66,11,23,1,35
01/25/16,3,19,642,360,38,19,5,0,24
01/25/16,3,21,775,350,63,16,6,0,22
01/25/16,3,22,542,350,84,21,14,0,35
01/25/16,3,23,642,350,72,7,6,0,13
01/25/16,3,26,542,360,91,10,1,0,11
01/25/16,3,27,542,360,82,34,6,0,40
01/25/16,3,30,729,270,67,23,7,0,30
01/26/16,1,1,738,305,70,11,6,3,20
01/26/16,1,2,726,315,125,32,5,0,37
01/26/16,1,3,996,220,42,15,5,0,20
01/26/16,1,4,5302,220,56,21,4,0,25
01/26/16,1,6,747,370,147,16,10,7,33
01/26/16,1,7,293,345,77,21,21,3,45
01/26/16,1,11,294,355,123,9,32,2,43
01/26/16,1,12,92,350,111,55,16,2,73
01/26/16,1,13,8030,400,152,7,3,1,11
01/26/16,1,18,542,350,102,14,26,0,40
01/26/16,1,19,642,360,155,11,4,0,15
01/26/16,1,21,775,350,68,20,9,0,29
01/26/16,1,22,542,350,85,24,17,0,41
01/26/16,1,23,642,350,117,28,5,0,33
01/26/16,1,26,542,360,133,18,12,0,30
01/26/16,1,27,542,360,66,32,5,0,37
01/26/16,1,30,729,270,76,21,5,0,26
01/26/16,2,1,738,305,63,4,10,3,17
01/26/16,2,2,726,315,120,24,5,2,31
01/26/16,2,3,996,220,59,27,8,0,35
01/26/16,2,4,5302,220,70,18,3,0,21
01/26/16,2,6,747,370,144,5,11,0,16
01/26/16,2,7,294,345,50,6,12,16,34
01/26/16,2,11,294,355,116,3,45,2,50
01/26/16,2,12,92,350,94,55,18,0,73
01/26/16,2,13,8030,400,124,9,10,0,19
01/26/16,2,18,542,350,88,24,18,0,42
01/26/16,2,19,642,360,113,7,3,0,10
01/26/16,2,21,775,350,88,22,7,0,29
01/26/16,2,22,542,350,67,28,8,0,36
01/26/16,2,23,642,350,135,12,1,0,13
01/26/16,2,26,542,360,127,22,4,0,26
01/26/16,2,27,542,360,62,35,4,0,39
01/26/16,2,28,7393,375,109,12,10,0,22
01/26/16,2,30,729,270,62,23,2,0,25
01/26/16,3,1,738,305,10,0,0,0,0
01/26/16,3,2,726,315,121,35,6,1,42
01/26/16,3,3,996,220,67,22,7,0,29
01/26/16,3,4,5302,220,72,19,3,0,22
01/26/16,3,6,747,370,143,13,13,9,35
01/26/16,3,7,294,345,110,8,21,6,35
01/26/16,3,11,294,355,121,17,32,5,54
01/26/16,3,12,92,350,84,73,24,10,107
01/26/16,3,13,8030,400,17,0,3,2,5
01/26/16,3,16,8040,350,112,14,18,2,34
01/26/16,3,18,542,350,61,50,6,2,58
01/26/16,3,19,642,360,38,3,7,0,10
01/26/16,3,20,8040,350,41,9,16,7,32
01/26/16,3,21,775,350,32,11,8,0,19
01/26/16,3,22,542,350,95,16,17,0,33
01/26/16,3,23,642,350,113,7,5,0,12
01/26/16,3,26,542,360,117,18,19,0,37
01/26/16,3,27,542,360,70,29,17,0,46
01/26/16,3,28,7393,375,93,20,3,4,27
01/26/16,3,30,729,270,71,20,3,0,23
01/27/16,1,1,738,305,49,12,8,2,22
01/27/16,1,2,726,315,69,51,2,2,55
01/27/16,1,3,996,220,75,15,8,0,23
01/27/16,1,4,5302,220,62,24,3,0,27
01/27/16,1,6,747,370,138,13,14,7,34
01/27/16,1,7,294,345,114,41,17,6,64
01/27/16,1,11,294,355,109,30,20,4,54
01/27/16,1,12,92,350,24,4,7,0,11
01/27/16,1,16,8040,350,106,33,18,1,52
01/27/16,1,18,542,350,93,12,21,1,34
01/27/16,1,20,8040,350,64,24,7,7,38
01/27/16,1,21,775,350,68,22,6,0,28
01/27/16,1,22,542,350,75,28,15,0,43
01/27/16,1,23,642,350,150,4,8,0,12
01/27/16,1,26,542,360,113,21,4,0,25
01/27/16,1,27,542,360,88,31,6,0,37
01/27/16,1,30,729,270,66,29,10,0,39
01/27/16,2,1,738,305,113,15,6,2,23
01/27/16,2,2,726,315,74,41,3,4,48
01/27/16,2,3,996,220,77,16,6,0,22
01/27/16,2,4,5302,220,61,27,3,0,30
01/27/16,2,6,747,370,141,6,3,3,12
01/27/16,2,7,294,345,126,12,14,2,28
01/27/16,2,9,642,350,50,21,8,6,35
01/27/16,2,10,542,370,31,1,5,3,9
01/27/16,2,11,294,355,96,18,24,0,42
01/27/16,2,16,8040,350,85,29,15,1,45
01/27/16,2,18,542,350,70,19,12,0,31
01/27/16,2,20,8040,350,98,22,11,8,41
01/27/16,2,21,775,350,43,6,5,0,11
01/27/16,2,22,542,350,77,20,12,0,32
01/27/16,2,23,642,350,106,1,5,0,6
01/27/16,2,26,542,360,89,26,0,0,26
01/27/16,2,27,542,360,75,20,6,0,26
01/27/16,2,28,7393,375,73,33,4,2,39
01/27/16,2,30,729,270,48,30,12,0,42
01/27/16,3,1,738,305,116,17,10,2,29
01/27/16,3,2,726,315,115,38,5,3,46
01/27/16,3,3,996,220,28,17,4,0,21
01/27/16,3,4,5302,220,71,25,4,1,30
01/27/16,3,6,747,370,74,3,10,7,20
01/27/16,3,7,294,345,100,13,20,26,59
01/27/16,3,9,642,350,114,38,7,9,54
01/27/16,3,10,542,370,146,15,8,2,25
01/27/16,3,11,294,355,72,8,12,1,21
01/27/16,3,13,8030,400,37,1,3,8,12
01/27/16,3,16,8040,350,53,9,5,4,18
01/27/16,3,18,542,350,43,9,8,1,18
01/27/16,3,20,8040,350,77,11,13,8,32
01/27/16,3,21,775,350,32,11,8,0,19
01/27/16,3,22,542,350,44,4,6,0,10
01/27/16,3,23,642,350,49,11,3,0,14
01/27/16,3,26,542,360,88,20,3,0,23
01/27/16,3,27,542,360,109,22,9,0,31
01/27/16,3,28,7393,375,46,29,4,3,36
01/27/16,3,30,729,270,74,31,11,0,42
01/28/16,1,1,738,305,114,22,3,3,28
01/28/16,1,2,726,315,112,41,7,1,49
01/28/16,1,3,996,220,70,12,10,0,22
01/28/16,1,4,5302,220,52,28,3,0,31
01/28/16,1,7,294,345,133,17,20,5,42
01/28/16,1,9,642,350,127,1,12,15,28
01/28/16,1,10,542,370,140,8,12,1,21
01/28/16,1,13,8030,400,148,1,9,0,10
01/28/16,1,16,8040,350,87,38,11,4,53
01/28/16,1,18,542,350,71,40,15,1,56
01/28/16,1,19,642,360,20,7,2,0,9
01/28/16,1,20,8040,350,95,33,11,6,50
01/28/16,1,22,542,350,97,12,11,0,23
01/28/16,1,23,642,350,95,4,7,0,11
01/28/16,1,24,7705,360,70,5,6,6,17
01/28/16,1,26,542,360,109,24,5,0,29
01/28/16,1,27,542,360,104,39,7,0,46
01/28/16,1,28,7393,375,100,41,4,4,49
01/28/16,1,30,729,270,70,26,10,0,36
01/28/16,2,1,738,305,125,16,6,0,22
01/28/16,2,2,726,315,108,17,5,6,28
01/28/16,2,3,996,220,17,3,0,0,3
01/28/16,2,4,5302,220,54,31,3,0,34
01/28/16,2,7,294,345,125,19,17,3,39
01/28/16,2,8,285,350,94,19,7,8,34
01/28/16,2,9,642,350,130,12,10,6,28
01/28/16,2,10,542,370,122,19,4,1,24
01/28/16,2,11,294,355,89,12,7,7,26
01/28/16,2,13,8030,400,150,3,5,1,9
01/28/16,2,14,490,360,15,18,3,5,26
01/28/16,2,16,8040,350,96,31,19,1,51
01/28/16,2,18,542,350,28,57,6,0,63
01/28/16,2,19,642,360,82,9,4,0,13
01/28/16,2,20,8040,350,98,13,10,8,31
01/28/16,2,22,542,350,65,21,5,0,26
01/28/16,2,23,642,350,117,10,2,0,12
01/28/16,2,24,7705,360,116,10,7,6,23
01/28/16,2,26,542,360,50,19,3,0,22
01/28/16,2,27,542,360,57,17,5,0,22
01/28/16,2,28,7393,375,95,30,3,1,34
01/28/16,2,30,729,270,67,28,8,0,36
01/28/16,3,1,738,305,116,18,14,4,36
01/28/16,3,2,726,315,96,29,5,4,38
01/28/16,3,3,996,220,65,14,6,0,20
01/28/16,3,4,5302,220,74,22,4,0,26
01/28/16,3,7,294,345,1,0,0,0,0
01/28/16,3,8,285,350,111,41,7,2,50
01/28/16,3,9,642,350,132,3,9,13,25
01/28/16,3,10,542,370,115,35,2,1,38
01/28/16,3,11,294,355,28,4,4,0,8
01/28/16,3,13,8030,400,148,1,8,0,9
01/28/16,3,14,490,360,6,3,0,2,5
01/28/16,3,16,8040,350,92,53,6,3,62
01/28/16,3,18,542,350,33,64,4,0,68
01/28/16,3,19,642,360,106,8,7,0,15
01/28/16,3,20,8040,350,74,76,9,3,88
01/28/16,3,22,542,350,84,15,11,0,26
01/28/16,3,23,642,350,86,12,9,0,21
01/28/16,3,24,7705,360,71,11,7,5,23
01/28/16,3,26,542,360,103,22,11,0,33
01/28/16,3,27,542,360,98,20,5,0,25
01/28/16,3,28,7393,375,39,19,5,2,26
01/28/16,3,30,729,270,90,17,10,0,27
01/29/16,1,1,738,305,117,21,3,2,26
01/29/16,1,2,726,315,16,4,1,3,8
01/29/16,1,3,996,220,69,21,10,0,31
01/29/16,1,4,5302,220,70,31,0,0,31
01/29/16,1,7,294,345,32,11,4,3,18
01/29/16,1,8,285,350,127,21,5,5,31
01/29/16,1,9,642,350,120,2,6,15,23
01/29/16,1,10,542,370,154,18,2,0,20
01/29/16,1,11,293,355,2,2,0,2,4
01/29/16,1,13,8030,400,155,1,7,1,9
01/29/16,1,14,490,360,89,34,10,1,45
01/29/16,1,16,8040,350,105,38,19,10,67
01/29/16,1,18,542,350,125,16,15,0,31
01/29/16,1,19,642,360,157,11,11,0,22
01/29/16,1,20,8040,350,111,19,16,10,45
01/29/16,1,22,542,350,11,6,1,0,7
01/29/16,1,23,642,350,157,6,6,0,12
01/29/16,1,26,542,360,104,21,10,0,31
01/29/16,1,27,542,360,103,29,14,0,43
01/29/16,1,28,7393,375,5,1,0,4,5
01/29/16,1,30,729,270,94,15,6,0,21
01/29/16,2,1,738,305,108,15,10,5,30
01/29/16,2,2,726,315,94,22,5,2,29
01/29/16,2,3,996,220,53,8,11,0,19
01/29/16,2,4,5302,220,55,30,4,0,34
01/29/16,2,7,294,345,71,20,12,0,32
01/29/16,2,8,285,350,129,9,7,10,26
01/29/16,2,9,642,350,123,8,9,9,26
01/29/16,2,10,542,370,133,19,4,1,24
01/29/16,2,11,293,355,101,15,21,2,38
01/29/16,2,13,8030,400,150,1,8,1,10
01/29/16,2,14,490,360,96,42,8,1,51
01/29/16,2,16,8040,350,95,32,13,3,48
01/29/16,2,18,542,350,88,17,11,0,28
01/29/16,2,19,642,360,96,15,8,0,23
01/29/16,2,20,8040,350,72,23,19,2,44
01/29/16,2,21,775,350,34,6,5,10,21
01/29/16,2,23,642,350,138,9,0,0,9
01/29/16,2,26,542,360,76,17,12,0,29
01/29/16,2,27,542,360,80,22,5,0,27
01/29/16,2,28,7393,375,99,20,8,7,35
01/29/16,2,30,729,270,64,10,3,0,13
01/29/16,3,1,738,305,105,15,11,4,30
01/29/16,3,2,726,315,118,28,0,3,31
01/29/16,3,3,996,220,75,23,10,0,33
01/29/16,3,4,5302,220,63,25,4,0,29
01/29/16,3,7,294,345,82,29,8,2,39
01/29/16,3,8,285,350,93,12,9,1,22
01/29/16,3,9,642,350,72,11,6,10,27
01/29/16,3,10,542,370,132,9,10,2,21
01/29/16,3,11,293,355,29,6,0,2,8
01/29/16,3,13,8030,400,57,0,5,0,5
01/29/16,3,14,490,360,29,22,0,0,22
01/29/16,3,16,8040,350,17,7,6,1,14
01/29/16,3,18,542,350,58,9,14,1,24
01/29/16,3,19,642,360,67,9,4,0,13
01/29/16,3,20,8040,350,59,21,2,3,26
01/29/16,3,21,775,350,10,3,3,0,6
01/29/16,3,23,642,350,68,3,2,0,5
01/29/16,3,26,542,360,71,10,4,0,14
01/29/16,3,27,542,360,52,12,3,0,15
01/29/16,3,28,7393,375,57,26,5,7,38
01/29/16,3,30,729,270,33,9,4,0,13
02/01/16,1,1,738,305,121,8,5,3,16
02/01/16,1,2,726,315,109,37,0,6,43
02/01/16,1,3,996,220,74,10,8,0,18
02/01/16,1,4,5302,220,52,28,5,0,33
02/01/16,1,7,294,345,96,7,2,0,9
02/01/16,1,8,285,350,134,10,6,0,16
02/01/16,1,9,642,350,124,5,15,10,30
02/01/16,1,10,542,370,132,19,9,2,30
02/01/16,1,12,7652,350,31,5,15,19,39
02/01/16,1,13,8030,400,138,0,14,2,16
02/01/16,1,14,490,360,119,34,7,0,41
02/01/16,1,16,8040,350,99,37,17,3,57
02/01/16,1,18,542,350,91,7,31,2,40
02/01/16,1,19,642,360,110,36,9,0,45
02/01/16,1,20,8040,350,94,26,10,16,52
02/01/16,1,21,775,350,53,22,13,11,46
02/01/16,1,26,542,360,86,15,8,0,23
02/01/16,1,27,542,360,76,22,5,0,27
02/01/16,1,28,7393,375,66,22,9,8,39
02/01/16,1,30,729,270,42,26,8,0,34
02/01/16,2,1,738,305,121,8,8,3,19
02/01/16,2,2,726,315,125,19,2,2,23
02/01/16,2,3,996,220,75,8,6,0,14
02/01/16,2,4,5302,220,59,23,3,0,26
02/01/16,2,7,294,345,96,24,9,2,35
02/01/16,2,8,285,350,96,13,4,3,20
02/01/16,2,9,642,350,124,3,16,5,24
02/01/16,2,10,542,370,116,31,8,1,40
02/01/16,2,12,7652,350,116,20,14,6,40
02/01/16,2,13,8030,400,134,2,6,1,9
02/01/16,2,14,490,360,81,39,6,1,46
02/01/16,2,16,8040,350,116,39,9,2,50
02/01/16,2,18,542,350,106,14,18,0,32
02/01/16,2,19,642,360,84,34,9,0,43
02/01/16,2,20,8040,350,103,15,13,9,37
02/01/16,2,21,775,350,67,14,12,19,45
02/01/16,2,26,542,360,117,33,6,0,39
02/01/16,2,27,542,360,118,17,11,0,28
02/01/16,3,1,738,305,95,13,1,2,16
02/01/16,3,2,726,315,107,25,3,2,30
02/01/16,3,3,996,220,65,10,5,0,15
02/01/16,3,4,5302,220,71,20,4,0,24
02/01/16,3,7,294,345,127,26,9,2,37
02/01/16,3,8,285,350,13,2,1,2,5
02/01/16,3,9,642,350,121,6,20,8,34
02/01/16,3,10,542,370,125,26,16,2,44
02/01/16,3,12,7652,350,127,5,19,3,27
02/01/16,3,13,8030,400,152,4,1,1,6
02/01/16,3,14,490,360,126,34,8,1,43
02/01/16,3,16,8040,350,112,24,28,2,54
02/01/16,3,18,542,350,90,25,9,1,35
02/01/16,3,19,642,360,79,10,8,0,18
02/01/16,3,20,8040,350,85,26,10,5,41
02/01/16,3,21,775,350,35,4,10,0,14
02/01/16,3,26,542,360,77,15,5,0,20
02/01/16,3,27,542,360,50,10,5,0,15
02/02/16,1,1,738,305,79,8,5,5,18
02/02/16,1,2,726,315,131,18,6,2,26
02/02/16,1,3,996,220,21,3,2,0,5
02/02/16,1,7,294,345,119,16,21,6,43
02/02/16,1,9,642,350,131,4,21,4,29
02/02/16,1,10,542,370,115,21,8,1,30
02/02/16,1,12,7652,350,145,5,16,1,22
02/02/16,1,13,8030,400,150,1,5,2,8
02/02/16,1,14,490,360,121,52,4,1,57
02/02/16,1,16,8040,350,94,30,20,4,54
02/02/16,1,18,542,350,135,18,12,4,34
02/02/16,1,19,642,360,129,17,16,0,33
02/02/16,1,20,8040,350,110,22,14,5,41
02/02/16,1,21,775,350,42,5,10,3,18
02/02/16,1,26,542,360,120,27,9,0,36
02/02/16,1,27,542,360,28,4,2,0,6
02/02/16,2,1,738,305,134,8,5,5,18
02/02/16,2,2,726,315,116,17,7,5,29
02/02/16,2,3,996,220,71,10,8,0,18
02/02/16,2,4,5302,220,21,7,0,0,7
02/02/16,2,7,294,345,71,10,5,2,17
02/02/16,2,9,642,350,124,7,16,6,29
02/02/16,2,10,542,370,139,22,5,1,28
02/02/16,2,11,7652,355,3,10,3,9,22
02/02/16,2,12,7652,350,153,5,5,5,15
02/02/16,2,13,8030,400,108,7,5,1,13
02/02/16,2,14,490,360,96,57,10,0,67
02/02/16,2,18,542,350,126,12,21,0,33
02/02/16,2,19,642,360,103,10,13,0,23
02/02/16,2,20,8040,350,110,23,19,5,47
02/02/16,2,21,775,350,71,13,17,0,30
02/02/16,2,22,542,350,60,12,12,0,24
02/02/16,2,26,542,360,120,16,6,0,22
02/02/16,2,28,7393,375,48,18,2,5,25
02/02/16,3,1,738,305,115,23,7,3,33
02/02/16,3,2,726,315,120,27,6,3,36
02/02/16,3,3,996,220,74,11,7,0,18
02/02/16,3,4,5302,220,67,20,4,0,24
02/02/16,3,9,642,350,122,23,17,9,49
02/02/16,3,10,542,370,63,14,2,0,16
02/02/16,3,11,7652,355,111,76,11,1,88
02/02/16,3,12,7652,350,142,11,4,2,17
02/02/16,3,13,8030,400,15,0,2,2,4
02/02/16,3,14,490,360,113,64,5,1,70
02/02/16,3,18,542,350,100,7,16,0,23
02/02/16,3,19,642,360,87,13,11,0,24
02/02/16,3,20,8040,350,82,23,6,11,40
02/02/16,3,21,775,350,80,10,17,0,27
02/02/16,3,22,542,350,73,29,11,0,40
02/02/16,3,26,542,360,103,25,2,0,27
02/02/16,3,28,7393,375,93,41,1,5,47
02/03/16,1,1,738,305,113,26,7,3,36
02/03/16,1,2,726,315,137,14,3,3,20
02/03/16,1,3,996,220,75,12,6,0,18
02/03/16,1,4,5302,220,46,27,3,0,30
02/03/16,1,11,7652,355,123,15,17,11,43
02/03/16,1,12,7652,350,150,10,6,5,21
02/03/16,1,14,490,360,146,38,6,2,46
02/03/16,1,15,755,350,14,3,5,0,8
02/03/16,1,16,8040,350,78,9,5,6,20
02/03/16,1,18,542,350,135,9,18,1,28
02/03/16,1,19,642,360,108,20,13,0,33
02/03/16,1,20,8040,350,55,15,14,13,42
02/03/16,1,21,775,350,69,17,27,0,44
02/03/16,1,22,542,350,87,22,12,0,34
02/03/16,1,26,542,360,132,33,5,0,38
02/03/16,1,28,7393,375,106,43,3,14,60
02/03/16,2,1,738,305,125,14,7,2,23
02/03/16,2,2,726,315,135,18,1,1,20
02/03/16,2,3,996,220,80,15,3,0,18
02/03/16,2,4,5302,220,64,22,2,0,24
02/03/16,2,11,7652,355,145,13,11,5,29
02/03/16,2,12,7652,350,152,7,7,4,18
02/03/16,2,13,8030,400,24,1,2,2,5
02/03/16,2,14,490,360,142,22,5,0,27
02/03/16,2,15,755,350,74,6,42,0,48
02/03/16,2,16,8040,350,133,13,14,1,28
02/03/16,2,18,542,350,114,16,15,0,31
02/03/16,2,19,642,360,135,14,9,0,23
02/03/16,2,20,8040,350,124,15,11,7,33
02/03/16,2,21,775,350,76,14,23,0,37
02/03/16,2,22,542,350,83,20,13,0,33
02/03/16,2,25,7697,375,52,7,1,0,8
02/03/16,2,26,542,360,104,37,5,0,42
02/03/16,2,28,7393,375,103,41,3,9,53
02/03/16,3,1,738,305,117,16,11,2,29
02/03/16,3,2,726,315,131,15,5,2,22
02/03/16,3,3,996,220,80,0,0,0,0
02/03/16,3,4,5302,220,62,0,0,0,0
02/03/16,3,11,7652,355,133,10,18,1,29
02/03/16,3,12,7652,350,121,18,13,2,33
02/03/16,3,13,8030,400,145,2,5,4,11
02/03/16,3,14,490,360,124,20,11,0,31
02/03/16,3,15,755,350,17,3,11,0,14
02/03/16,3,16,8040,350,106,14,24,1,39
02/03/16,3,18,542,350,96,21,13,1,35
02/03/16,3,19,642,360,92,8,8,0,16
02/03/16,3,20,8040,350,69,30,8,5,43
02/03/16,3,21,775,350,61,9,12,0,21
02/03/16,3,22,542,350,77,19,7,0,26
02/03/16,3,25,7697,375,64,9,12,0,21
02/03/16,3,26,542,360,113,25,5,0,30
02/03/16,3,28,7393,375,78,41,6,6,53
02/04/16,1,1,738,305,119,15,9,3,27
02/04/16,1,2,726,315,125,28,0,4,32
02/04/16,1,3,996,220,77,12,8,0,20
02/04/16,1,4,5302,220,64,23,4,0,27
02/04/16,1,11,7652,355,117,36,15,4,55
02/04/16,1,12,7652,350,152,11,3,2,16
02/04/16,1,13,8030,400,151,1,7,2,10
02/04/16,1,14,490,360,137,26,7,0,33
02/04/16,1,16,8040,350,130,17,14,2,33
02/04/16,1,18,542,350,135,7,16,1,24
02/04/16,1,19,642,360,115,5,19,0,24
02/04/16,1,20,8040,350,96,9,16,3,28
02/04/16,1,21,775,350,61,4,20,0,24
02/04/16,1,22,542,350,101,14,11,0,25
02/04/16,1,25,7697,375,111,34,4,0,38
02/04/16,1,26,542,360,106,15,9,0,24
02/04/16,1,28,7393,375,110,19,11,13,43
02/04/16,2,1,738,305,133,10,6,4,20
02/04/16,2,2,726,315,128,19,7,2,28
02/04/16,2,4,5302,220,70,21,2,0,23
02/04/16,2,8,285,350,74,11,4,0,15
02/04/16,2,10,542,370,76,32,13,1,46
02/04/16,2,11,7652,355,145,11,9,2,22
02/04/16,2,12,7652,350,154,9,9,3,21
02/04/16,2,13,8030,400,159,1,4,1,6
02/04/16,2,14,490,360,111,37,6,1,44
02/04/16,2,15,755,350,67,5,20,0,25
02/04/16,2,16,8040,350,109,16,7,1,24
02/04/16,2,18,542,350,94,4,19,0,23
02/04/16,2,19,642,360,117,6,11,0,17
02/04/16,2,20,8040,350,120,12,12,5,29
02/04/16,2,21,775,350,70,15,12,0,27
02/04/16,2,22,542,350,55,12,12,0,24
02/04/16,2,24,1001,360,46,13,4,9,26
02/04/16,2,25,7697,375,78,23,6,0,29
02/04/16,2,26,542,360,79,27,4,0,31
02/04/16,2,28,7393,375,78,29,17,7,53
02/04/16,3,1,738,305,120,16,9,2,27
02/04/16,3,2,726,315,126,42,1,1,44
02/04/16,3,3,996,220,74,13,2,0,15
02/04/16,3,4,5302,220,75,20,3,0,23
02/04/16,3,8,285,350,135,7,9,2,18
02/04/16,3,10,542,370,119,33,20,0,53
02/04/16,3,11,7652,355,143,14,13,4,31
02/04/16,3,12,7652,350,128,8,10,4,22
02/04/16,3,13,8030,400,116,2,6,12,20
02/04/16,3,14,490,360,124,41,16,1,58
02/04/16,3,15,755,350,17,4,7,0,11
02/04/16,3,16,8040,350,107,31,10,6,47
02/04/16,3,18,542,350,105,4,9,0,13
02/04/16,3,19,642,360,87,5,10,0,15
02/04/16,3,20,8040,350,76,17,9,2,28
02/04/16,3,21,775,350,33,19,4,0,23
02/04/16,3,22,542,350,59,12,8,0,20
02/04/16,3,24,1001,360,67,21,1,3,25
02/04/16,3,25,7697,375,59,32,1,0,33
02/04/16,3,26,542,360,66,22,7,0,29
02/04/16,3,28,7393,375,80,21,3,4,28
02/05/16,1,1,738,305,109,16,11,0,27
02/05/16,1,2,726,315,51,54,0,9,63
02/05/16,1,3,996,220,76,16,3,0,19
02/05/16,1,4,5302,220,60,17,2,0,19
02/05/16,1,7,294,345,19,1,1,2,4
02/05/16,1,8,285,350,24,3,3,1,7
02/05/16,1,10,542,370,66,48,8,1,57
02/05/16,1,11,7652,355,143,14,13,3,30
02/05/16,1,12,7652,350,98,12,14,7,33
02/05/16,1,13,8030,400,151,2,2,3,7
02/05/16,1,14,490,360,126,43,12,2,57
02/05/16,1,15,755,350,92,13,19,0,32
02/05/16,1,16,8040,350,107,20,10,6,36
02/05/16,1,18,542,350,124,12,11,0,23
02/05/16,1,19,642,360,138,15,9,0,24
02/05/16,1,20,8040,350,29,6,5,3,14
02/05/16,1,21,775,350,39,15,9,0,24
02/05/16,1,22,542,350,77,14,8,0,22
02/05/16,1,24,1001,360,127,11,3,12,26
02/05/16,1,25,7697,375,72,50,1,0,51
02/05/16,1,26,542,360,10,2,1,0,3
02/05/16,1,27,774,360,15,2,2,0,4
02/05/16,1,28,7393,375,107,24,9,17,50
02/05/16,2,1,738,305,91,32,6,3,41
02/05/16,2,2,726,315,96,28,9,1,38
02/05/16,2,3,996,220,75,14,4,0,18
02/05/16,2,4,5302,220,58,20,3,0,23
02/05/16,2,7,294,345,71,10,5,2,17
02/05/16,2,10,542,370,105,28,14,0,42
02/05/16,2,11,7652,355,135,11,16,2,29
02/05/16,2,12,7652,350,96,50,9,3,62
02/05/16,2,13,8030,400,153,0,2,0,2
02/05/16,2,14,490,360,111,30,6,3,39
02/05/16,2,15,755,350,74,15,31,0,46
02/05/16,2,16,8040,350,118,21,10,2,33
02/05/16,2,18,542,350,97,10,5,1,16
02/05/16,2,19,642,360,123,11,16,0,27
02/05/16,2,20,8040,350,14,4,2,6,12
02/05/16,2,22,542,350,97,12,19,0,31
02/05/16,2,24,1001,360,127,5,10,10,25
02/05/16,2,25,7697,375,88,44,4,0,48
02/05/16,2,27,774,360,131,9,15,0,24
02/05/16,2,28,7393,375,61,14,3,5,22
02/05/16,3,1,738,305,116,23,7,3,33
02/05/16,3,2,726,315,108,27,3,1,31
02/05/16,3,3,996,220,79,12,2,0,14
02/05/16,3,4,5302,220,63,18,4,0,22
02/05/16,3,7,294,345,21,1,4,1,6
02/05/16,3,10,542,370,128,20,22,2,44
02/05/16,3,11,7652,355,131,13,17,2,32
02/05/16,3,13,8030,400,145,6,3,1,10
02/05/16,3,14,490,360,106,41,9,2,52
02/05/16,3,15,755,350,35,5,17,0,22
02/05/16,3,16,8040,350,105,27,21,1,49
02/05/16,3,19,642,360,108,10,4,0,14
02/05/16,3,20,8040,350,114,12,11,3,26
02/05/16,3,22,542,350,94,5,21,0,26
02/05/16,3,24,1001,360,132,19,2,7,28
02/05/16,3,25,7697,375,77,32,4,0,36
02/05/16,3,27,774,360,111,8,12,0,20
02/08/16,1,1,738,305,103,23,4,4,31
02/08/16,1,2,726,315,80,39,3,4,46
02/08/16,1,3,996,220,79,10,6,0,16
02/08/16,1,4,5302,220,60,21,3,0,24
02/08/16,1,7,294,345,20,6,2,4,12
02/08/16,1,9,7740,350,15,3,15,2,20
02/08/16,1,10,542,370,107,27,14,0,41
02/08/16,1,11,7652,355,125,16,17,4,37
02/08/16,1,13,8030,400,124,1,11,8,20
02/08/16,1,15,755,350,66,15,24,0,39
02/08/16,1,16,8040,350,102,34,18,9,61
02/08/16,1,19,642,360,104,16,10,0,26
02/08/16,1,20,8040,350,125,23,16,3,42
02/08/16,1,22,542,350,9,13,18,0,31
02/08/16,1,25,7697,375,69,40,6,0,46
02/08/16,1,27,774,360,113,10,16,0,26
02/08/16,2,1,738,305,117,11,5,6,22
02/08/16,2,2,726,315,117,33,5,2,40
02/08/16,2,3,996,220,83,9,8,0,17
02/08/16,2,4,5302,220,63,24,2,0,26
02/08/16,2,7,294,345,122,26,18,2,46
02/08/16,2,9,7740,350,99,7,15,5,27
02/08/16,2,10,542,370,131,19,15,1,35
02/08/16,2,11,7652,355,137,20,7,2,29
02/08/16,2,13,8030,400,144,3,11,1,15
02/08/16,2,15,755,350,76,4,29,0,33
02/08/16,2,16,8040,350,107,30,14,0,44
02/08/16,2,17,641,370,85,12,2,5,19
02/08/16,2,19,642,360,122,3,19,0,22
02/08/16,2,20,8040,350,118,22,15,3,40
02/08/16,2,22,542,350,79,13,14,0,27
02/08/16,2,25,7697,375,66,50,4,0,54
02/08/16,2,27,774,360,91,9,15,0,24
02/08/16,3,1,738,305,133,18,0,1,19
02/08/16,3,2,726,315,126,22,2,4,28
02/08/16,3,3,996,220,18,0,0,0,0
02/08/16,3,4,5302,220,73,0,0,0,0
02/08/16,3,7,294,345,107,29,9,1,39
02/08/16,3,9,7740,350,128,5,22,5,32
02/08/16,3,10,542,370,119,15,15,2,32
02/08/16,3,11,7652,355,128,8,17,2,27
02/08/16,3,12,7652,350,94,15,15,7,37
02/08/16,3,13,8030,400,159,0,7,1,8
02/08/16,3,15,755,350,35,9,12,0,21
02/08/16,3,16,8040,350,97,29,22,2,53
02/08/16,3,17,641,370,99,4,4,3,11
02/08/16,3,19,642,360,79,15,7,0,22
02/08/16,3,20,8040,350,77,38,6,1,45
02/08/16,3,22,542,350,79,9,13,0,22
02/08/16,3,25,7697,375,23,21,3,0,24
02/08/16,3,27,774,360,51,3,9,0,12
02/09/16,1,1,738,305,112,15,8,2,25
02/09/16,1,2,726,315,118,16,2,1,19
02/09/16,1,3,996,220,28,6,3,0,9
02/09/16,1,4,5302,220,37,10,0,0,10
02/09/16,1,7,294,345,110,25,10,3,38
02/09/16,1,9,7740,350,120,5,15,2,22
02/09/16,1,10,542,370,120,16,16,1,33
02/09/16,1,12,7652,350,95,0,0,0,0
02/09/16,1,15,755,350,56,7,29,0,36
02/09/16,1,16,8040,350,104,22,18,9,49
02/09/16,1,17,641,370,143,13,11,3,27
02/09/16,1,20,8040,350,104,39,10,4,53
02/09/16,1,21,775,350,51,13,7,0,20
02/09/16,1,22,542,350,110,2,12,0,14
02/09/16,1,25,7697,375,75,65,4,0,69
02/09/16,1,27,774,360,131,2,23,0,25
02/09/16,2,1,738,305,122,12,5,2,19
02/09/16,2,2,726,315,131,15,0,4,19
02/09/16,2,3,996,220,56,28,15,0,43
02/09/16,2,7,294,345,55,5,7,3,15
02/09/16,2,8,285,350,73,11,11,5,27
02/09/16,2,9,7740,350,111,6,18,3,27
02/09/16,2,10,542,370,147,6,13,0,19
02/09/16,2,12,7652,350,121,0,0,0,0
02/09/16,2,14,490,360,4,64,1,1,66
02/09/16,2,15,755,350,75,13,33,0,46
02/09/16,2,16,8040,350,128,16,16,1,33
02/09/16,2,17,641,370,128,4,13,1,18
02/09/16,2,20,8040,350,106,25,11,3,39
02/09/16,2,22,542,350,122,8,13,0,21
02/09/16,2,25,7697,375,87,32,6,0,38
02/09/16,2,27,774,360,136,1,12,0,13
02/09/16,3,1,738,305,124,19,4,3,26
02/09/16,3,2,726,315,121,29,8,3,40
02/09/16,3,3,996,220,52,0,0,0,0
02/09/16,3,7,294,345,93,26,10,3,39
02/09/16,3,8,285,350,119,11,8,1,20
02/09/16,3,9,7740,350,111,10,17,6,33
02/09/16,3,10,542,370,139,14,8,1,23
02/09/16,3,12,7652,350,42,1,4,2,7
02/09/16,3,15,755,350,61,7,31,0,38
02/09/16,3,16,8040,350,96,14,17,0,31
02/09/16,3,17,641,370,110,6,15,1,22
02/09/16,3,20,8040,350,95,21,12,3,36
02/09/16,3,22,542,350,100,9,14,0,23
02/09/16,3,25,7697,375,81,43,4,0,47
02/09/16,3,27,774,360,109,5,16,0,21
02/10/16,1,1,738,305,126,14,6,4,24
02/10/16,1,2,726,315,55,27,2,5,34
02/10/16,1,3,996,220,47,20,15,0,35
02/10/16,1,7,294,345,111,16,23,4,43
02/10/16,1,8,7331,350,143,11,6,2,19
02/10/16,1,9,7740,350,124,9,24,3,36
02/10/16,1,10,542,370,119,13,13,2,28
02/10/16,1,12,7652,350,31,6,6,1,13
02/10/16,1,14,7745,360,54,22,4,2,28
02/10/16,1,16,8040,350,105,24,11,6,41
02/10/16,1,17,641,370,138,4,13,2,19
02/10/16,1,18,542,350,99,12,30,4,46
02/10/16,1,20,8040,350,120,26,10,3,39
02/10/16,1,22,542,350,129,23,18,0,41
02/10/16,1,25,7697,375,87,60,2,0,62
02/10/16,1,27,774,360,138,6,14,0,20
02/10/16,2,1,738,305,115,12,3,3,18
02/10/16,2,2,726,315,135,14,2,1,17
02/10/16,2,3,996,220,62,21,13,0,34
02/10/16,2,4,5302,220,48,20,2,0,22
02/10/16,2,8,7331,350,124,14,7,2,23
02/10/16,2,10,542,370,133,14,3,0,17
02/10/16,2,14,7745,360,82,24,14,2,40
02/10/16,2,15,775,350,82,13,21,0,34
02/10/16,2,16,8040,350,84,24,17,1,42
02/10/16,2,17,641,370,150,14,9,2,25
02/10/16,2,18,542,350,79,15,34,1,50
02/10/16,2,20,8040,350,117,25,8,1,34
02/10/16,2,22,542,350,87,20,14,0,34
02/10/16,2,25,7697,375,50,36,1,0,37
02/10/16,2,26,747,360,79,27,4,0,31
02/10/16,2,27,774,360,103,9,13,0,22
02/10/16,3,1,738,305,113,13,11,2,26
02/10/16,3,2,726,315,86,16,5,2,23
02/10/16,3,3,996,220,64,20,12,1,33
02/10/16,3,4,5302,220,63,23,5,0,28
02/10/16,3,6,3062,370,47,12,7,11,30
02/10/16,3,8,7331,350,143,17,4,1,22
02/10/16,3,10,542,370,123,30,13,0,43
02/10/16,3,14,7745,360,116,20,8,3,31
02/10/16,3,15,775,350,65,11,28,0,39
02/10/16,3,16,8040,350,86,48,11,0,59
02/10/16,3,17,641,370,136,5,3,1,9
02/10/16,3,18,542,350,75,11,23,0,34
02/10/16,3,20,8040,350,86,36,10,2,48
02/10/16,3,22,542,350,41,10,9,0,19
02/10/16,3,26,747,360,33,29,7,0,36
02/10/16,3,27,774,360,101,11,5,0,16
02/11/16,1,1,738,305,123,13,3,3,19
02/11/16,1,3,996,220,52,14,3,0,17
02/11/16,1,4,5302,220,73,17,4,0,21
02/11/16,1,6,3062,370,121,9,13,13,35
02/11/16,1,8,7331,350,78,9,10,3,22
02/11/16,1,10,542,370,23,9,6,0,15
02/11/16,1,14,7745,360,146,17,6,4,27
02/11/16,1,15,775,350,107,22,17,0,39
02/11/16,1,16,8040,350,81,31,20,5,56
02/11/16,1,17,641,370,118,8,20,6,34
02/11/16,1,18,542,350,99,19,34,0,53
02/11/16,1,20,8040,350,105,45,8,3,56
02/11/16,1,21,775,350,65,15,9,0,24
02/11/16,1,23,308,350,1,0,0,6,6
02/11/16,1,26,747,360,141,10,11,0,21
02/11/16,1,27,774,360,144,12,15,0,27
02/11/16,2,1,738,305,125,14,6,5,25
02/11/16,2,4,5302,220,67,20,3,1,24
02/11/16,2,6,3062,370,130,18,20,11,49
02/11/16,2,8,7331,350,131,12,17,2,31
02/11/16,2,14,7745,360,132,21,9,2,32
02/11/16,2,15,775,350,69,4,27,0,31
02/11/16,2,17,641,370,110,2,26,0,28
02/11/16,2,18,542,350,98,18,20,4,42
02/11/16,2,20,8040,350,88,60,5,0,65
02/11/16,2,21,775,350,16,3,4,0,7
02/11/16,2,23,308,350,39,26,3,0,29
02/11/16,2,26,747,360,117,4,11,0,15
02/11/16,2,27,774,360,4,7,6,0,13
02/11/16,3,1,738,305,126,14,3,1,18
02/11/16,3,2,726,315,52,9,10,2,21
02/11/16,3,3,996,220,78,17,4,0,21
02/11/16,3,4,5302,220,60,21,4,1,26
02/11/16,3,6,3062,370,102,33,18,12,63
02/11/16,3,7,294,345,38,5,10,2,17
02/11/16,3,8,7331,350,125,15,8,0,23
02/11/16,3,14,7745,360,131,9,5,2,16
02/11/16,3,15,775,350,76,7,21,0,28
02/11/16,3,17,641,370,113,3,19,4,26
02/11/16,3,18,542,350,75,14,19,0,33
02/11/16,3,20,8040,350,59,32,7,3,42
02/11/16,3,23,308,350,47,28,1,6,35
02/11/16,3,26,747,360,89,7,15,0,22
02/12/16,1,1,738,305,122,18,3,2,23
02/12/16,1,2,726,315,90,12,13,6,31
02/12/16,1,3,996,220,82,8,4,0,12
02/12/16,1,4,5302,220,57,21,3,0,24
02/12/16,1,6,3062,370,118,30,18,15,63
02/12/16,1,7,294,345,110,22,18,1,41
02/12/16,1,8,7331,350,132,16,10,4,30
02/12/16,1,9,7740,350,12,3,7,4,14
02/12/16,1,12,7652,350,65,9,14,3,26
02/12/16,1,15,775,350,66,26,28,0,54
02/12/16,1,18,542,350,112,6,22,0,28
02/12/16,1,19,642,360,36,10,3,0,13
02/12/16,1,20,8040,350,107,38,9,7,54
02/12/16,1,23,308,350,113,41,3,0,44
02/12/16,1,26,747,360,137,7,10,0,17
02/12/16,1,28,293,375,51,9,9,12,30
02/12/16,1,29,737,270,41,23,2,0,25
02/12/16,2,1,738,305,130,6,10,3,19
02/12/16,2,2,726,315,115,14,10,2,26
02/12/16,2,3,996,220,82,6,5,0,11
02/12/16,2,4,5302,220,59,22,2,0,24
02/12/16,2,6,3062,370,116,6,25,9,40
02/12/16,2,7,294,345,92,15,9,1,25
02/12/16,2,8,7331,350,97,17,5,0,22
02/12/16,2,9,7740,350,92,6,16,12,34
02/12/16,2,12,7652,350,97,27,14,4,45
02/12/16,2,15,775,350,56,7,17,0,24
02/12/16,2,18,542,350,91,8,22,2,32
02/12/16,2,19,642,360,107,13,7,0,20
02/12/16,2,20,8040,350,105,20,16,1,37
02/12/16,2,23,308,350,99,33,4,0,37
02/12/16,2,26,747,360,97,11,12,0,23
02/12/16,2,28,293,375,87,16,13,18,47
02/12/16,2,29,737,270,19,25,3,0,28
02/12/16,3,1,738,305,90,3,2,1,6
02/12/16,3,2,726,315,122,17,15,1,33
02/12/16,3,3,996,220,73,10,2,0,12
02/12/16,3,4,5302,220,68,19,2,0,21
02/12/16,3,6,3062,370,133,7,21,12,40
02/12/16,3,7,294,345,126,16,10,3,29
02/12/16,3,9,7740,350,123,4,26,1,31
02/12/16,3,12,7652,350,117,6,16,2,24
02/12/16,3,15,775,350,75,5,27,0,32
02/12/16,3,18,542,350,97,6,14,0,20
02/12/16,3,19,642,360,71,15,21,0,36
02/12/16,3,20,8040,350,91,32,16,2,50
02/12/16,3,23,308,350,11,0,6,0,6
02/12/16,3,26,747,360,122,3,10,0,13
02/12/16,3,28,293,375,71,31,7,6,44
02/16/16,1,1,738,305,36,10,6,3,19
02/16/16,1,2,726,315,119,16,10,4,30
02/16/16,1,3,996,220,66,18,10,0,28
02/16/16,1,4,5302,220,48,23,2,0,25
02/16/16,1,6,3062,370,77,4,17,7,28
02/16/16,1,7,294,345,113,20,19,2,41
02/16/16,1,9,7740,350,105,9,12,4,25
02/16/16,1,11,7652,355,70,68,15,7,90
02/16/16,1,12,7652,350,112,32,13,5,50
02/16/16,1,15,775,350,67,2,37,0,39
02/16/16,1,16,8032,350,68,9,10,7,26
02/16/16,1,18,542,350,101,24,17,5,46
02/16/16,1,19,642,360,98,14,16,0,30
02/16/16,1,20,8040,350,65,47,13,6,66
02/16/16,1,21,775,350,16,3,2,0,5
02/16/16,1,26,747,360,144,7,5,0,12
02/16/16,1,28,293,375,40,79,9,8,96
02/16/16,1,29,737,270,40,25,6,0,31
02/16/16,2,1,738,305,103,23,11,2,36
02/16/16,2,2,726,315,124,21,12,4,37
02/16/16,2,3,996,220,55,26,8,0,34
02/16/16,2,4,5302,220,47,21,5,0,26
02/16/16,2,6,3062,370,132,3,19,6,28
02/16/16,2,7,294,345,119,25,18,1,44
02/16/16,2,9,7740,350,119,11,11,5,27
02/16/16,2,11,7652,355,105,7,12,4,23
02/16/16,2,12,7652,350,86,8,28,8,44
02/16/16,2,15,775,350,58,5,30,0,35
02/16/16,2,16,8032,350,103,31,8,0,39
02/16/16,2,18,542,350,97,19,18,0,37
02/16/16,2,19,642,360,118,8,15,0,23
02/16/16,2,20,8040,350,81,38,10,2,50
02/16/16,2,21,775,350,20,5,7,0,12
02/16/16,2,24,1001,360,37,4,11,8,23
02/16/16,2,26,747,360,143,11,2,0,13
02/16/16,2,28,293,375,67,58,8,4,70
02/16/16,2,29,737,270,37,26,6,0,32
02/16/16,3,1,738,305,108,35,3,0,38
02/16/16,3,2,726,315,99,25,20,2,47
02/16/16,3,3,996,220,43,10,2,0,12
02/16/16,3,4,5302,220,48,10,0,0,10
02/16/16,3,6,3062,370,114,4,18,12,34
02/16/16,3,7,294,345,119,20,15,1,36
02/16/16,3,9,7740,350,101,5,22,3,30
02/16/16,3,11,7652,355,109,14,8,1,23
02/16/16,3,12,7652,350,113,25,16,4,45
02/16/16,3,15,775,350,37,7,13,0,20
02/16/16,3,16,8032,350,79,22,3,1,26
02/16/16,3,18,542,350,73,8,10,0,18
02/16/16,3,19,642,360,58,12,8,0,20
02/16/16,3,20,8040,350,63,20,11,1,32
02/16/16,3,24,1001,360,54,8,13,1,22
02/16/16,3,26,747,360,101,0,12,0,12
02/17/16,1,1,738,305,90,24,6,4,34
02/17/16,1,2,726,315,99,21,13,4,38
02/17/16,1,3,996,200,40,39,10,0,49
02/17/16,1,4,5302,200,20,55,2,0,57
02/17/16,1,6,3062,370,80,1,14,7,22
02/17/16,1,7,294,345,109,18,14,3,35
02/17/16,1,8,7331,350,42,5,4,0,9
02/17/16,1,9,7740,350,96,8,14,10,32
02/17/16,1,10,747,380,55,1,8,4,13
02/17/16,1,11,7652,355,110,14,9,3,26
02/17/16,1,12,7652,350,107,17,17,3,37
02/17/16,1,16,8032,350,126,19,8,1,28
02/17/16,1,18,542,350,136,4,16,0,20
02/17/16,1,19,642,360,95,23,7,0,30
02/17/16,1,20,8040,350,130,18,15,3,36
02/17/16,1,22,542,350,10,1,1,0,2
02/17/16,1,24,1001,360,119,11,29,8,48
02/17/16,1,25,497,375,28,1,5,0,6
02/17/16,1,26,747,360,123,4,6,0,10
02/17/16,1,28,293,375,112,28,13,9,50
02/17/16,1,29,737,270,10,30,10,0,40
02/17/16,2,1,738,305,57,32,2,4,38
02/17/16,2,2,726,315,103,18,16,2,36
02/17/16,2,3,996,200,73,25,8,0,33
02/17/16,2,4,5302,200,30,63,3,0,66
02/17/16,2,6,3062,370,129,2,24,6,32
02/17/16,2,7,294,345,117,9,14,3,26
02/17/16,2,8,7331,350,100,10,7,1,18
02/17/16,2,9,7740,350,103,13,13,3,29
02/17/16,2,10,747,380,155,2,4,2,8
02/17/16,2,11,7652,355,134,11,8,1,20
02/17/16,2,12,7652,350,98,19,20,5,44
02/17/16,2,15,775,350,36,10,20,0,30
02/17/16,2,16,8032,350,100,23,8,1,32
02/17/16,2,18,542,350,111,9,18,2,29
02/17/16,2,19,642,360,80,21,12,0,33
02/17/16,2,20,8040,350,19,4,2,0,6
02/17/16,2,21,775,350,46,1,12,0,13
02/17/16,2,22,542,350,89,18,5,0,23
02/17/16,2,23,308,350,36,20,2,0,22
02/17/16,2,24,1001,360,98,6,25,10,41
02/17/16,2,25,497,375,130,10,5,0,15
02/17/16,2,26,747,360,155,4,4,0,8
02/17/16,2,28,293,375,61,3,9,2,14
02/17/16,2,29,737,270,21,33,8,0,41
02/17/16,3,1,738,305,9,5,1,2,8
02/17/16,3,2,726,315,118,15,17,2,34
02/17/16,3,3,996,200,72,21,0,0,21
02/17/16,3,4,5302,200,63,50,0,0,50
02/17/16,3,6,3062,370,127,2,26,10,38
02/17/16,3,8,7331,350,16,1,2,1,4
02/17/16,3,9,7740,350,20,0,0,0,0
02/17/16,3,10,747,380,171,3,1,2,6
02/17/16,3,11,7652,355,132,16,16,2,34
02/17/16,3,12,7652,350,136,14,14,2,30
02/17/16,3,15,775,350,43,1,28,0,29
02/17/16,3,16,8032,350,95,10,12,0,22
02/17/16,3,18,542,350,105,4,16,1,21
02/17/16,3,19,642,360,73,16,8,0,24
02/17/16,3,20,8040,350,57,12,10,5,27
02/17/16,3,21,775,350,45,11,10,0,21
02/17/16,3,22,542,350,76,19,6,0,25
02/17/16,3,23,308,350,34,20,4,0,24
02/17/16,3,24,1001,360,38,8,11,2,21
02/17/16,3,25,497,375,114,8,3,0,11
02/17/16,3,26,747,360,133,7,4,0,11
02/18/16,1,1,738,305,89,32,7,1,40
02/18/16,1,2,726,315,122,20,12,6,38
02/18/16,1,3,996,200,77,15,8,0,23
02/18/16,1,4,5302,200,63,28,2,0,30
02/18/16,1,6,3062,370,138,3,16,8,27
02/18/16,1,9,7740,350,9,1,1,3,5
02/18/16,1,10,747,380,166,3,2,1,6
02/18/16,1,11,7652,355,122,24,16,5,45
02/18/16,1,12,7652,350,134,20,12,5,37
02/18/16,1,13,3062,400,15,2,2,6,10
02/18/16,1,15,775,350,47,10,25,0,35
02/18/16,1,16,8032,350,110,42,7,0,49
02/18/16,1,18,542,350,107,11,18,0,29
02/18/16,1,19,642,360,100,36,10,0,46
02/18/16,1,20,8040,350,94,25,14,6,45
02/18/16,1,21,775,350,40,21,6,0,27
02/18/16,1,22,542,350,102,21,12,0,33
02/18/16,1,23,308,350,75,54,2,0,56
02/18/16,1,24,1001,360,94,17,22,7,46
02/18/16,1,25,497,375,142,4,6,0,10
02/18/16,1,26,747,360,147,5,8,0,13
02/18/16,1,28,293,375,49,8,4,4,16
02/18/16,1,29,737,270,43,20,3,0,23
02/18/16,2,1,738,305,98,33,10,3,46
02/18/16,2,2,726,315,97,18,12,3,33
02/18/16,2,3,996,200,72,17,6,0,23
02/18/16,2,4,5302,200,42,20,0,0,20
02/18/16,2,5,776,400,92,6,34,1,41
02/18/16,2,6,3062,370,132,11,17,9,37
02/18/16,2,9,7740,350,105,12,12,5,29
02/18/16,2,10,747,380,170,3,7,0,10
02/18/16,2,11,7652,355,136,11,15,3,29
02/18/16,2,12,7652,350,121,16,17,2,35
02/18/16,2,13,3062,400,103,6,17,1,24
02/18/16,2,15,775,350,42,9,20,0,29
02/18/16,2,16,8032,350,128,22,7,4,33
02/18/16,2,18,542,350,99,7,14,0,21
02/18/16,2,19,642,360,92,17,8,0,25
02/18/16,2,20,8040,350,78,12,30,7,49
02/18/16,2,21,775,350,67,14,10,0,24
02/18/16,2,22,542,350,77,7,9,0,16
02/18/16,2,23,308,350,15,9,0,0,9
02/18/16,2,24,1001,360,84,12,24,5,41
02/18/16,2,25,497,375,154,3,1,0,4
02/18/16,2,26,747,360,139,2,6,0,8
02/18/16,2,28,293,375,110,10,10,8,28
02/18/16,2,29,737,270,41,25,5,0,30
02/18/16,3,1,738,305,84,47,3,3,53
02/18/16,3,2,726,315,101,30,15,5,50
02/18/16,3,3,996,200,82,16,7,0,23
02/18/16,3,5,776,400,97,3,44,1,48
02/18/16,3,6,3062,370,120,4,26,12,42
02/18/16,3,9,7740,350,135,20,13,2,35
02/18/16,3,10,747,380,169,5,4,1,10
02/18/16,3,11,7652,355,60,7,20,2,29
02/18/16,3,12,7652,350,110,10,16,1,27
02/18/16,3,13,3062,400,114,6,20,2,28
02/18/16,3,15,775,350,19,2,11,0,13
02/18/16,3,16,8032,350,96,19,6,0,25
02/18/16,3,18,542,350,65,4,14,2,20
02/18/16,3,19,642,360,64,17,8,0,25
02/18/16,3,20,8040,350,93,15,9,2,26
02/18/16,3,21,775,350,37,16,12,0,28
02/18/16,3,22,542,350,27,11,1,0,12
02/18/16,3,24,1001,360,9,0,5,2,7
02/18/16,3,25,497,375,98,5,6,0,11
02/18/16,3,26,747,360,104,4,8,0,12
02/18/16,3,28,293,375,64,11,4,9,24
02/18/16,3,29,737,270,32,24,5,0,29
02/19/16,1,1,738,305,69,63,7,1,71
02/19/16,1,2,726,315,123,21,9,0,30
02/19/16,1,3,996,200,70,19,10,0,29
02/19/16,1,6,3062,370,108,6,10,9,25
02/19/16,1,9,7740,350,86,16,27,4,47
02/19/16,1,10,542,380,167,2,6,0,8
02/19/16,1,11,7652,355,118,14,19,2,35
02/19/16,1,12,7652,350,86,19,20,2,41
02/19/16,1,13,8030,400,103,10,21,2,33
02/19/16,1,16,8040,350,115,16,3,2,21
02/19/16,1,19,642,360,113,28,15,0,43
02/19/16,1,20,8040,350,88,14,9,3,26
02/19/16,1,21,775,350,68,16,15,0,31
02/19/16,1,22,542,350,97,27,18,0,45
02/19/16,1,25,7697,375,175,3,4,0,7
02/19/16,1,26,747,360,176,3,7,0,10
02/19/16,1,27,774,360,9,1,1,0,2
02/19/16,1,28,293,375,110,13,8,3,24
02/19/16,1,29,737,270,35,30,6,0,36
02/19/16,2,1,738,305,61,75,3,2,80
02/19/16,2,2,726,315,124,13,14,4,31
02/19/16,2,3,996,200,10,0,0,0,0
02/19/16,2,6,3062,370,50,4,10,3,17
02/19/16,2,9,7740,350,115,32,9,5,46
02/19/16,2,10,542,380,155,2,6,2,10
02/19/16,2,11,7652,355,119,18,15,3,36
02/19/16,2,12,7652,350,28,19,12,2,33
02/19/16,2,13,8030,400,113,5,22,0,27
02/19/16,2,16,8040,350,113,23,10,1,34
02/19/16,2,19,642,360,77,34,5,0,39
02/19/16,2,20,8040,350,130,19,3,2,24
02/19/16,2,21,775,350,68,4,31,0,35
02/19/16,2,22,542,350,73,11,13,0,24
02/19/16,2,25,7697,375,159,3,2,0,5
02/19/16,2,26,747,360,156,6,2,0,8
02/19/16,2,27,774,360,63,15,5,0,20
02/19/16,2,28,293,375,35,2,3,2,7
02/19/16,2,29,737,270,30,0,0,0,0
02/19/16,3,1,738,305,102,33,3,2,38
02/19/16,3,2,726,315,107,15,8,5,28
02/19/16,3,3,996,200,68,0,0,0,0
02/19/16,3,4,5302,200,40,0,0,0,0
02/19/16,3,6,3062,370,29,2,1,7,10
02/19/16,3,9,7740,350,93,40,12,3,55
02/19/16,3,10,542,380,174,2,5,0,7
02/19/16,3,11,7652,355,122,13,23,7,43
02/19/16,3,12,7652,350,109,50,14,3,67
02/19/16,3,13,8030,400,118,13,23,0,36
02/19/16,3,16,8040,350,96,13,7,1,21
02/19/16,3,19,642,360,16,18,1,0,19
02/19/16,3,20,8040,350,61,13,4,0,17
02/19/16,3,21,775,350,25,5,14,0,19
02/19/16,3,22,542,350,74,4,10,0,14
02/19/16,3,25,7697,375,144,6,1,0,7
02/19/16,3,26,747,360,121,6,4,0,10
02/19/16,3,27,774,360,63,10,8,0,18
02/19/16,3,29,737,270,25,0,0,0,0
02/22/16,1,1,738,305,115,27,4,6,37
02/22/16,1,2,726,315,123,14,10,2,26
02/22/16,1,3,996,200,71,18,6,0,24
02/22/16,1,4,5302,200,52,26,10,0,36
02/22/16,1,6,3062,370,150,11,4,6,21
02/22/16,1,9,7740,350,125,15,17,4,36
02/22/16,1,10,542,380,170,2,4,0,6
02/22/16,1,11,7652,355,131,21,16,5,42
02/22/16,1,13,8030,400,118,7,17,1,25
02/22/16,1,14,642,360,3,0,0,0,0
02/22/16,1,15,775,350,34,2,20,0,22
02/22/16,1,16,8040,350,128,30,4,0,34
02/22/16,1,19,642,360,89,33,10,0,43
02/22/16,1,20,8040,350,106,24,8,6,38
02/22/16,1,21,775,350,61,7,28,0,35
02/22/16,1,22,542,350,138,13,8,0,21
02/22/16,1,24,exp,360,3,2,2,0,4
02/22/16,1,25,7697,375,126,6,5,0,11
02/22/16,1,26,747,360,131,5,6,0,11
02/22/16,1,27,542,360,71,15,13,0,28
02/22/16,1,28,293,375,4,0,0,0,0
02/22/16,1,29,737,270,74,18,6,0,24
02/22/16,2,1,738,305,99,33,8,2,43
02/22/16,2,2,726,315,94,29,19,3,51
02/22/16,2,3,996,200,72,19,6,0,25
02/22/16,2,4,5302,200,43,28,8,0,36
02/22/16,2,5,776,400,105,6,31,0,37
02/22/16,2,6,3062,370,148,18,1,4,23
02/22/16,2,9,7740,350,103,20,17,3,40
02/22/16,2,10,542,380,172,1,3,1,5
02/22/16,2,11,7652,355,115,7,25,4,36
02/22/16,2,13,8030,400,103,9,15,3,27
02/22/16,2,14,642,360,146,5,4,3,12
02/22/16,2,15,775,350,96,9,11,0,20
02/22/16,2,16,8040,350,36,6,3,1,10
02/22/16,2,19,642,360,68,39,2,0,41
02/22/16,2,20,8040,350,76,29,8,3,40
02/22/16,2,21,775,350,42,19,8,0,27
02/22/16,2,22,542,350,93,8,10,0,18
02/22/16,2,24,exp,360,17,3,1,3,7
02/22/16,2,25,7697,375,110,8,5,0,13
02/22/16,2,26,747,360,149,4,1,0,5
02/22/16,2,27,542,360,69,24,0,0,24
02/22/16,2,28,293,375,95,15,8,12,35
02/22/16,2,29,737,270,51,22,5,0,27
02/22/16,3,1,738,305,83,24,6,3,33
02/22/16,3,2,726,315,69,34,6,0,40
02/22/16,3,3,996,200,51,21,4,0,25
02/22/16,3,4,5302,200,32,22,7,0,29
02/22/16,3,5,776,400,60,1,17,1,19
02/22/16,3,6,3062,370,98,9,5,6,20
02/22/16,3,10,542,380,118,2,9,0,11
02/22/16,3,11,7652,355,25,5,45,10,60
02/22/16,3,13,8030,400,68,1,8,0,9
02/22/16,3,14,642,360,63,3,3,6,12
02/22/16,3,15,775,350,48,3,9,0,12
02/22/16,3,18,542,350,16,3,5,6,14
02/22/16,3,19,642,360,62,18,0,0,18
02/22/16,3,20,8040,350,68,19,4,9,32
02/22/16,3,21,775,350,14,19,6,0,25
02/22/16,3,22,542,350,64,3,5,0,8
02/22/16,3,25,7697,375,103,3,1,0,4
02/22/16,3,26,747,360,106,2,5,0,7
02/22/16,3,27,542,360,48,16,4,0,20
02/22/16,3,28,293,375,59,16,4,9,29
02/22/16,3,29,737,270,44,20,4,1,25
02/23/16,1,1,738,305,116,26,6,4,36
02/23/16,1,2,726,315,113,27,14,2,43
02/23/16,1,3,996,220,76,12,5,0,17
02/23/16,1,4,5302,220,58,23,12,0,35
02/23/16,1,5,776,400,115,13,35,1,49
02/23/16,1,6,3062,370,151,5,3,10,18
02/23/16,1,8,exp,350,22,7,2,7,16
02/23/16,1,9,7740,350,63,5,2,4,11
02/23/16,1,10,542,370,167,1,5,0,6
02/23/16,1,11,7652,355,132,11,22,10,43
02/23/16,1,13,8030,400,105,9,23,5,37
02/23/16,1,14,642,360,149,6,9,1,16
02/23/16,1,15,775,350,110,8,19,0,27
02/23/16,1,16,8032,350,29,9,19,6,34
02/23/16,1,17,641,370,3,4,1,7,12
02/23/16,1,18,542,350,108,12,19,3,34
02/23/16,1,19,642,360,89,27,9,0,36
02/23/16,1,20,8040,350,104,22,9,5,36
02/23/16,1,21,775,350,36,26,12,0,38
02/23/16,1,22,542,350,131,9,11,0,20
02/23/16,1,25,7697,375,153,6,5,0,11
02/23/16,1,26,747,360,140,4,9,0,13
02/23/16,1,27,542,360,83,20,10,0,30
02/23/16,1,28,293,375,113,16,4,7,27
02/23/16,1,29,737,270,61,29,5,0,34
02/23/16,2,1,738,305,106,20,5,7,32
02/23/16,2,2,726,315,123,11,10,3,24
02/23/16,2,3,996,220,55,16,6,0,22
02/23/16,2,4,5302,220,22,10,3,0,13
02/23/16,2,5,776,400,107,9,28,0,37
02/23/16,2,6,3062,370,114,17,4,10,31
02/23/16,2,9,7740,350,127,7,15,4,26
02/23/16,2,10,542,370,141,2,8,0,10
02/23/16,2,11,7652,355,51,3,13,1,17
02/23/16,2,13,8030,400,97,0,16,7,23
02/23/16,2,14,642,360,132,17,6,1,24
02/23/16,2,15,775,350,72,3,19,0,22
02/23/16,2,16,8032,350,46,33,31,0,64
02/23/16,2,17,542,370,19,53,1,2,56
02/23/16,2,18,542,350,82,8,17,0,25
02/23/16,2,19,642,360,92,13,9,0,22
02/23/16,2,20,8040,350,105,28,4,3,35
02/23/16,2,21,775,350,28,11,11,0,22
02/23/16,2,22,542,350,73,10,12,0,22
02/23/16,2,25,7697,375,146,0,7,0,7
02/23/16,2,26,747,360,124,5,4,0,9
02/23/16,2,27,542,360,61,12,8,0,20
02/23/16,2,28,293,375,111,24,8,8,40
02/23/16,2,29,737,270,84,14,3,0,17
02/23/16,3,1,738,305,82,25,5,5,35
02/23/16,3,2,726,315,58,9,12,0,21
02/23/16,3,3,996,220,45,17,5,1,23
02/23/16,3,5,776,400,87,0,23,1,24
02/23/16,3,6,3062,370,9,1,1,6,8
02/23/16,3,9,7740,350,86,7,10,3,20
02/23/16,3,10,542,370,111,3,11,0,14
02/23/16,3,13,8030,400,102,4,14,0,18
02/23/16,3,14,642,360,114,1,4,4,9
02/23/16,3,15,775,350,87,3,10,0,13
02/23/16,3,16,8032,350,21,39,21,1,61
02/23/16,3,17,542,370,103,15,10,1,26
02/23/16,3,18,542,350,67,2,21,1,24
02/23/16,3,19,642,360,95,17,5,0,22
02/23/16,3,20,8040,350,90,13,10,6,29
02/23/16,3,21,775,350,38,19,10,0,29
02/23/16,3,22,542,350,43,7,11,0,18
02/23/16,3,25,7697,375,132,3,6,0,9
02/23/16,3,26,747,360,149,4,5,0,9
02/23/16,3,27,542,360,87,12,11,0,23
02/23/16,3,28,293,375,97,20,5,1,26
02/23/16,3,29,737,270,92,19,4,0,23
02/24/16,1,1,738,305,80,30,5,6,41
02/24/16,1,2,726,315,96,28,9,10,47
02/24/16,1,3,996,200,29,5,0,0,5
02/24/16,1,4,5302,200,16,2,1,0,3
02/24/16,1,5,776,400,116,9,27,1,37
02/24/16,1,6,3062,370,149,10,6,4,20
02/24/16,1,7,294,345,94,24,13,0,37
02/24/16,1,8,exp,350,25,8,1,4,13
02/24/16,1,9,7740,350,117,4,17,10,31
02/24/16,1,10,542,380,173,0,9,0,9
02/24/16,1,13,8032,400,119,8,20,1,29
02/24/16,1,14,642,360,137,4,10,3,17
02/24/16,1,15,775,350,118,9,15,0,24
02/24/16,1,16,8040,350,60,33,38,0,71
02/24/16,1,17,542,370,92,7,19,7,33
02/24/16,1,18,542,350,97,7,24,0,31
02/24/16,1,19,642,360,97,7,9,0,16
02/24/16,1,20,8040,350,120,27,6,6,39
02/24/16,1,21,775,350,58,23,20,0,43
02/24/16,1,22,542,350,110,6,11,0,17
02/24/16,1,24,7675,360,25,3,2,4,9
02/24/16,1,25,7697,375,155,11,3,0,14
02/24/16,1,26,747,360,148,4,10,0,14
02/24/16,1,27,542,360,122,22,6,4,32
02/24/16,1,28,293,375,100,19,13,0,32
02/24/16,1,29,737,270,94,15,3,0,18
02/24/16,2,1,738,305,27,6,2,4,12
02/24/16,2,2,726,315,96,30,11,5,46
02/24/16,2,3,996,200,61,20,8,0,28
02/24/16,2,4,5302,200,52,23,12,0,35
02/24/16,2,5,776,400,118,1,28,2,31
02/24/16,2,6,3062,370,149,13,3,7,23
02/24/16,2,7,294,345,9,3,6,1,10
02/24/16,2,9,7740,350,126,11,14,3,28
02/24/16,2,10,542,380,176,1,1,2,4
02/24/16,2,13,8032,400,102,12,18,2,32
02/24/16,2,14,642,360,158,5,3,0,8
02/24/16,2,15,775,350,73,7,12,0,19
02/24/16,2,16,8040,350,62,15,49,0,64
02/24/16,2,17,542,370,85,7,19,0,26
02/24/16,2,18,542,350,82,5,16,1,22
02/24/16,2,19,642,360,127,13,4,0,17
02/24/16,2,20,8040,350,129,16,6,3,25
02/24/16,2,21,775,350,31,20,12,0,32
02/24/16,2,22,542,350,65,6,14,0,20
02/24/16,2,24,7675,360,112,23,1,6,30
02/24/16,2,25,7697,375,145,9,0,0,9
02/24/16,2,26,747,360,149,1,6,1,8
02/24/16,2,27,542,360,108,18,3,2,23
02/24/16,2,28,293,375,46,5,14,0,19
02/24/16,2,29,737,270,82,18,4,0,22
02/24/16,3,1,738,305,77,21,4,0,25
02/24/16,3,2,726,315,49,23,4,3,30
02/24/16,3,3,996,200,38,30,10,0,40
02/24/16,3,4,5302,200,28,25,11,0,36
02/24/16,3,5,776,400,63,3,20,0,23
02/24/16,3,6,3062,370,86,2,6,2,10
02/24/16,3,7,293,345,7,0,5,5,10
02/24/16,3,9,7740,350,61,17,4,5,26
02/24/16,3,10,542,380,112,2,7,1,10
02/24/16,3,13,8032,400,75,11,11,1,23
02/24/16,3,14,642,360,122,0,4,5,9
02/24/16,3,15,775,350,83,7,5,0,12
02/24/16,3,16,8040,350,20,8,14,0,22
02/24/16,3,17,542,370,40,13,13,2,28
02/24/16,3,18,542,350,54,6,11,1,18
02/24/16,3,19,642,360,78,12,4,0,16
02/24/16,3,20,8040,350,79,17,11,5,33
02/24/16,3,21,775,350,31,9,16,0,25
02/24/16,3,22,542,350,49,3,11,0,14
02/24/16,3,24,7675,360,105,18,3,4,25
02/24/16,3,25,7697,375,135,6,1,0,7
02/24/16,3,26,747,360,109,1,8,0,9
02/24/16,3,27,542,360,64,12,14,0,26
02/24/16,3,28,293,375,80,43,5,11,59
02/24/16,3,29,737,270,54,20,6,0,26
02/25/16,1,1,738,305,106,18,3,2,23
02/25/16,1,2,726,315,83,40,7,3,50
02/25/16,1,3,996,200,47,22,23,0,45
02/25/16,1,4,996,200,43,20,26,0,46
02/25/16,1,5,776,400,113,5,25,1,31
02/25/16,1,6,3062,370,144,7,6,6,19
02/25/16,1,7,293,345,121,13,15,3,31
02/25/16,1,9,7740,350,103,25,8,7,40
02/25/16,1,10,747,380,158,0,7,1,8
02/25/16,1,11,7652,355,111,6,4,5,15
02/25/16,1,12,7652,350,5,1,4,5,10
02/25/16,1,13,8032,400,98,5,18,3,26
02/25/16,1,14,642,360,146,6,5,2,13
02/25/16,1,15,775,350,110,12,9,0,21
02/25/16,1,16,8040,350,72,20,30,0,50
02/25/16,1,17,542,370,97,19,10,3,32
02/25/16,1,18,542,350,8,7,20,2,29
02/25/16,1,19,642,360,158,13,2,0,15
02/25/16,1,20,8040,350,117,33,3,0,36
02/25/16,1,21,775,350,55,14,18,0,32
02/25/16,1,22,542,350,84,7,18,0,25
02/25/16,1,24,7675,360,132,12,4,4,20
02/25/16,1,25,7697,375,154,7,2,0,9
02/25/16,1,26,747,360,150,1,5,0,6
02/25/16,1,27,542,360,77,17,4,0,21
02/25/16,1,28,293,375,135,13,11,3,27
02/25/16,1,29,737,270,101,10,2,0,12
02/25/16,2,1,738,305,111,14,7,4,25
02/25/16,2,2,726,315,113,7,13,1,21
02/25/16,2,3,996,200,48,19,15,1,35
02/25/16,2,4,996,200,44,18,21,0,39
02/25/16,2,5,776,400,81,4,35,0,39
02/25/16,2,6,3062,370,128,13,7,3,23
02/25/16,2,7,293,345,102,33,13,1,47
02/25/16,2,9,7740,350,91,21,8,0,29
02/25/16,2,10,747,380,165,0,4,1,5
02/25/16,2,11,7652,355,128,14,8,4,26
02/25/16,2,12,7652,350,61,33,17,0,50
02/25/16,2,13,8032,400,89,6,25,0,31
02/25/16,2,14,642,360,142,4,8,0,12
02/25/16,2,15,775,350,81,3,14,0,17
02/25/16,2,16,8040,350,41,40,17,0,57
02/25/16,2,17,542,370,53,12,13,0,25
02/25/16,2,18,542,350,63,14,12,0,26
02/25/16,2,19,642,360,134,6,4,0,10
02/25/16,2,20,8040,350,96,24,9,4,37
02/25/16,2,21,775,350,30,21,7,0,28
02/25/16,2,22,542,350,64,1,12,0,13
02/25/16,2,24,7675,360,111,15,2,5,22
02/25/16,2,25,7697,375,146,4,1,0,5
02/25/16,2,26,747,360,133,3,5,0,8
02/25/16,2,27,542,360,49,13,8,0,21
02/25/16,2,28,293,375,125,14,6,1,21
02/25/16,2,29,737,270,97,8,1,0,9
02/25/16,3,1,738,305,77,19,7,2,28
02/25/16,3,2,726,315,36,40,8,2,50
02/25/16,3,3,996,200,37,41,5,0,46
02/25/16,3,4,996,200,44,14,12,0,26
02/25/16,3,5,776,400,77,0,27,0,27
02/25/16,3,6,3062,370,85,21,3,6,30
02/25/16,3,7,293,345,33,21,14,2,37
02/25/16,3,10,747,380,122,2,3,0,5
02/25/16,3,11,7652,355,108,13,8,1,22
02/25/16,3,12,7652,350,54,13,7,1,21
02/25/16,3,13,8032,400,95,0,8,2,10
02/25/16,3,14,642,360,87,3,7,4,14
02/25/16,3,15,775,350,66,4,7,0,11
02/25/16,3,16,8040,350,29,7,21,1,29
02/25/16,3,17,542,370,51,12,16,3,31
02/25/16,3,18,542,350,90,8,11,0,19
02/25/16,3,19,642,360,106,10,2,0,12
02/25/16,3,20,8040,350,96,13,7,0,20
02/25/16,3,21,775,350,33,14,11,0,25
02/25/16,3,22,542,350,49,7,13,0,20
02/25/16,3,23,542,350,10,9,5,0,14
02/25/16,3,24,7675,360,127,10,4,4,18
02/25/16,3,25,7697,375,116,8,4,0,12
02/25/16,3,26,747,360,160,1,5,0,6
02/25/16,3,27,542,360,70,21,4,0,25
02/25/16,3,28,293,375,64,0,9,1,10
02/25/16,3,29,737,270,95,7,2,0,9
02/26/16,1,1,738,305,76,22,5,2,29
02/26/16,1,2,726,315,78,42,4,7,53
02/26/16,1,3,996,200,51,22,15,0,37
02/26/16,1,4,996,200,42,22,23,0,45
02/26/16,1,5,776,400,89,3,31,0,34
02/26/16,1,6,3062,370,134,18,6,3,27
02/26/16,1,7,293,345,98,35,12,3,50
02/26/16,1,8,exp,350,16,4,2,3,9
02/26/16,1,10,747,380,166,2,4,0,6
02/26/16,1,11,7652,355,82,21,15,1,37
02/26/16,1,12,7652,350,93,16,25,6,47
02/26/16,1,13,8032,400,85,2,29,1,32
02/26/16,1,14,642,360,133,7,8,4,19
02/26/16,1,15,775,350,97,12,14,0,26
02/26/16,1,16,8032,350,58,27,24,1,52
02/26/16,1,17,542,370,79,11,37,6,54
02/26/16,1,18,542,350,80,14,20,1,35
02/26/16,1,19,642,360,100,10,7,0,17
02/26/16,1,20,8040,350,126,38,1,1,40
02/26/16,1,21,775,350,37,13,10,0,23
02/26/16,1,22,542,350,109,8,6,0,14
02/26/16,1,23,542,350,42,14,8,0,22
02/26/16,1,24,7675,360,91,12,2,8,22
02/26/16,1,25,7697,375,134,17,0,0,17
02/26/16,1,26,747,360,150,0,5,0,5
02/26/16,1,27,542,360,66,14,7,0,21
02/26/16,1,28,293,375,56,20,6,4,30
02/26/16,2,2,726,315,109,13,15,3,31
02/26/16,2,3,996,200,44,23,16,0,39
02/26/16,2,4,996,200,60,18,21,0,39
02/26/16,2,5,776,400,109,3,20,1,24
02/26/16,2,6,3062,370,133,14,5,7,26
02/26/16,2,7,293,345,117,14,19,3,36
02/26/16,2,10,747,380,87,3,20,0,23
02/26/16,2,11,7652,355,90,48,11,5,64
02/26/16,2,12,7652,350,112,21,19,3,43
02/26/16,2,13,8032,400,92,12,26,0,38
02/26/16,2,14,642,360,140,6,8,2,16
02/26/16,2,15,775,350,78,7,8,0,15
02/26/16,2,16,8032,350,86,13,37,1,51
02/26/16,2,17,542,370,58,24,17,2,43
02/26/16,2,18,542,350,71,14,12,1,27
02/26/16,2,19,642,360,80,11,6,0,17
02/26/16,2,20,8040,350,90,18,1,7,26
02/26/16,2,21,775,350,23,8,19,0,27
02/26/16,2,22,542,350,4,3,0,0,3
02/26/16,2,23,542,350,89,22,5,0,27
02/26/16,2,25,7697,375,120,1,5,0,6
02/26/16,2,26,747,360,114,3,5,0,8
02/26/16,2,27,542,360,40,10,9,0,19
02/26/16,2,28,293,375,100,22,6,1,29
02/26/16,3,1,738,305,32,19,14,5,38
02/26/16,3,2,726,315,70,15,12,3,30
02/26/16,3,3,996,200,35,28,9,0,37
02/26/16,3,4,996,200,24,20,6,0,26
02/26/16,3,5,776,400,52,0,24,0,24
02/26/16,3,6,3062,370,84,9,1,7,17
02/26/16,3,7,293,345,66,11,14,0,25
02/26/16,3,11,7652,355,87,18,2,0,20
02/26/16,3,12,7652,350,82,13,7,2,22
02/26/16,3,13,8032,400,35,4,20,20,44
02/26/16,3,14,642,360,62,2,6,1,9
02/26/16,3,15,775,350,37,7,6,0,13
02/26/16,3,16,8032,350,24,4,14,2,20
02/26/16,3,17,542,370,65,10,10,2,22
02/26/16,3,18,542,350,20,4,10,2,16
02/26/16,3,19,642,360,51,7,5,0,12
02/26/16,3,21,775,350,24,10,10,0,20
02/26/16,3,23,542,350,75,13,5,0,18
02/26/16,3,25,7697,375,90,5,0,0,5
02/26/16,3,27,542,360,59,14,6,0,20
02/26/16,3,28,293,375,71,11,6,5,22
02/29/16,1,1,738,305,71,32,20,2,54
02/29/16,1,2,726,315,92,16,17,9,42
02/29/16,1,3,996,200,50,22,16,0,38
02/29/16,1,4,996,200,3,2,1,0,3
02/29/16,1,5,776,400,102,3,29,0,32
02/29/16,1,6,3062,370,120,10,11,7,28
02/29/16,1,7,293,345,117,22,16,4,42
02/29/16,1,11,7652,355,132,8,5,0,13
02/29/16,1,12,7652,350,62,23,17,9,49
02/29/16,1,13,3062,400,43,4,9,2,15
02/29/16,1,14,642,360,106,9,9,0,18
02/29/16,1,15,775,350,110,15,9,0,24
02/29/16,1,16,8032,350,59,20,28,2,50
02/29/16,1,17,542,370,97,14,21,4,39
02/29/16,1,18,542,350,54,4,21,0,25
02/29/16,1,19,642,360,83,17,10,0,27
02/29/16,1,21,775,350,43,18,14,0,32
02/29/16,1,22,542,350,62,12,10,0,22
02/29/16,1,23,542,350,86,12,7,0,19
02/29/16,1,24,7675,360,5,2,1,7,10
02/29/16,1,25,497,375,133,6,0,0,6
02/29/16,1,27,542,360,64,11,10,0,21
02/29/16,1,28,293,375,81,12,14,3,29
02/29/16,2,1,738,305,76,42,24,2,68
02/29/16,2,2,726,315,85,18,9,2,29
02/29/16,2,3,996,200,54,24,10,0,34
02/29/16,2,4,996,200,45,26,15,0,41
02/29/16,2,5,776,400,120,1,34,0,35
02/29/16,2,6,3062,370,72,0,5,2,7
02/29/16,2,7,293,345,73,20,15,8,43
02/29/16,2,10,747,380,41,0,6,6,12
02/29/16,2,11,7652,355,140,6,9,0,15
02/29/16,2,12,7652,350,111,13,23,2,38
02/29/16,2,14,642,360,134,5,6,2,13
02/29/16,2,15,775,350,93,14,8,0,22
02/29/16,2,16,8032,350,82,8,43,0,51
02/29/16,2,17,542,370,68,19,16,0,35
02/29/16,2,18,542,350,72,2,23,0,25
02/29/16,2,19,642,360,92,14,10,0,24
02/29/16,2,21,775,350,41,17,17,0,34
02/29/16,2,22,542,350,66,29,7,0,36
02/29/16,2,23,542,350,72,21,6,0,27
02/29/16,2,24,7675,360,110,18,7,3,28
02/29/16,2,27,542,360,65,17,8,0,25
02/29/16,2,28,293,375,26,5,3,5,13
02/29/16,3,1,738,305,40,31,14,2,47
02/29/16,3,2,726,315,89,19,10,1,30
02/29/16,3,3,996,200,14,7,2,0,9
02/29/16,3,4,996,200,34,20,5,0,25
02/29/16,3,5,776,400,49,3,24,0,27
02/29/16,3,6,3062,370,29,1,3,3,7
02/29/16,3,10,747,380,174,3,0,0,3
02/29/16,3,11,7652,355,102,12,9,0,21
02/29/16,3,12,7652,350,83,9,18,4,31
02/29/16,3,13,3062,400,15,6,15,5,26
02/29/16,3,14,642,360,138,0,2,0,2
02/29/16,3,15,775,350,74,7,11,0,18
02/29/16,3,16,8032,350,50,9,4,1,14
02/29/16,3,17,542,370,29,17,18,2,37
02/29/16,3,18,542,350,18,3,21,1,25
02/29/16,3,19,642,360,49,22,6,0,28
02/29/16,3,21,775,350,37,16,10,0,26
02/29/16,3,22,542,350,45,8,9,0,17
02/29/16,3,23,542,350,49,9,9,0,18
02/29/16,3,24,7675,360,111,7,7,6,20
02/29/16,3,27,542,360,60,12,8,0,20
02/29/16,3,28,293,375,93,19,11,4,34
03/01/16,1,1,738,305,67,32,14,2,48
03/01/16,1,2,726,315,97,29,10,3,42
03/01/16,1,3,996,200,43,21,15,0,36
03/01/16,1,4,996,200,33,17,10,0,27
03/01/16,1,5,776,400,93,6,23,0,29
03/01/16,1,6,3062,370,137,5,8,6,19
03/01/16,1,7,293,345,27,13,1,8,22
03/01/16,1,10,747,380,174,5,1,1,7
03/01/16,1,11,7652,355,122,5,14,1,20
03/01/16,1,12,7652,350,113,15,17,7,39
03/01/16,1,13,3062,400,50,12,32,1,45
03/01/16,1,14,642,360,136,8,3,1,12
03/01/16,1,15,775,350,100,7,17,0,24
03/01/16,1,16,8032,350,79,14,32,0,46
03/01/16,1,17,542,370,43,43,5,0,48
03/01/16,1,18,542,350,46,1,19,1,21
03/01/16,1,19,642,360,104,13,8,0,21
03/01/16,1,22,542,350,80,12,12,0,24
03/01/16,1,23,542,350,62,46,3,0,49
03/01/16,1,24,7675,360,124,16,4,9,29
03/01/16,1,26,747,360,27,0,9,0,9
03/01/16,1,27,542,360,89,26,12,0,38
03/01/16,1,28,293,375,90,19,9,6,34
03/01/16,2,1,738,305,81,36,23,0,59
03/01/16,2,2,726,315,126,4,12,1,17
03/01/16,2,3,996,200,58,25,18,0,43
03/01/16,2,4,996,200,12,6,3,0,9
03/01/16,2,5,776,400,84,1,21,1,23
03/01/16,2,6,3062,370,136,2,8,7,17
03/01/16,2,7,293,345,108,7,6,2,15
03/01/16,2,9,8038,350,40,1,10,16,27
03/01/16,2,10,747,380,170,7,5,2,14
03/01/16,2,11,7652,355,131,7,19,2,28
03/01/16,2,12,7652,350,93,11,23,3,37
03/01/16,2,13,3062,400,76,8,28,0,36
03/01/16,2,14,642,360,146,7,6,1,14
03/01/16,2,15,775,350,79,11,9,0,20
03/01/16,2,16,8032,350,81,16,33,0,49
03/01/16,2,17,542,370,75,7,15,4,26
03/01/16,2,18,542,350,65,6,22,2,30
03/01/16,2,19,642,360,85,12,6,0,18
03/01/16,2,21,775,350,48,17,11,0,28
03/01/16,2,22,542,350,66,11,13,0,24
03/01/16,2,23,542,350,78,26,5,0,31
03/01/16,2,24,7675,360,133,11,7,7,25
03/01/16,2,26,747,360,113,2,11,0,13
03/01/16,2,27,542,360,62,6,11,0,17
03/01/16,2,28,293,375,87,12,10,1,23
03/01/16,3,1,738,305,58,2,18,8,28
03/01/16,3,2,726,315,95,10,12,4,26
03/01/16,3,3,996,200,48,23,18,0,41
03/01/16,3,4,996,200,29,14,4,0,18
03/01/16,3,6,3062,370,80,6,11,7,24
03/01/16,3,7,293,345,112,11,7,1,19
03/01/16,3,9,8038,350,128,1,4,1,6
03/01/16,3,10,747,380,152,2,9,0,11
03/01/16,3,11,7652,355,85,4,17,0,21
03/01/16,3,12,7652,350,54,26,10,1,37
03/01/16,3,13,3062,400,38,7,19,0,26
03/01/16,3,14,642,360,133,7,4,1,12
03/01/16,3,15,775,350,67,6,8,0,14
03/01/16,3,16,8032,350,43,19,20,0,39
03/01/16,3,17,542,370,51,10,11,2,23
03/01/16,3,18,542,350,71,14,15,1,30
03/01/16,3,19,642,360,55,8,11,0,19
03/01/16,3,21,775,350,52,12,9,0,21
03/01/16,3,22,542,350,97,5,13,0,18
03/01/16,3,23,542,350,62,18,9,0,27
03/01/16,3,24,7675,360,93,8,10,4,22
03/01/16,3,26,747,360,147,3,8,0,11
03/01/16,3,27,542,360,8,0,8,0,8
03/01/16,3,28,293,375,68,16,7,8,31
03/02/16,1,1,738,305,61,31,20,0,51
03/02/16,1,2,726,315,67,11,11,3,25
03/02/16,1,3,996,200,55,25,15,0,40
03/02/16,1,4,996,200,36,29,12,0,41
03/02/16,1,5,8030,400,51,4,4,0,8
03/02/16,1,6,3062,370,126,4,9,6,19
03/02/16,1,7,293,345,132,10,6,2,18
03/02/16,1,9,8038,350,159,0,3,1,4
03/02/16,1,10,747,380,149,3,1,3,7
03/02/16,1,11,7652,355,104,7,21,4,32
03/02/16,1,12,7652,350,109,18,12,5,35
03/02/16,1,13,3062,400,94,15,28,2,45
03/02/16,1,14,642,360,137,3,6,0,9
03/02/16,1,15,775,350,90,12,10,0,22
03/02/16,1,16,8032,350,56,22,31,2,55
03/02/16,1,17,542,370,81,18,19,3,40
03/02/16,1,18,542,350,97,12,19,1,32
03/02/16,1,19,642,360,97,12,11,0,23
03/02/16,1,21,775,350,73,8,16,0,24
03/02/16,1,22,542,350,67,5,17,0,22
03/02/16,1,23,542,350,108,13,9,0,22
03/02/16,1,24,7675,360,113,15,3,7,25
03/02/16,1,26,747,360,128,7,8,0,15
03/02/16,1,27,542,360,112,16,6,0,22
03/02/16,2,1,738,305,54,49,23,1,73
03/02/16,2,2,726,315,120,7,15,4,26
03/02/16,2,3,996,200,57,26,14,0,40
03/02/16,2,4,996,200,40,8,12,1,21
03/02/16,2,5,8030,400,89,1,7,2,10
03/02/16,2,6,3062,370,129,27,4,10,41
03/02/16,2,7,293,345,146,8,4,2,14
03/02/16,2,9,8038,350,165,1,0,2,3
03/02/16,2,10,747,380,167,6,2,0,8
03/02/16,2,11,7652,355,146,9,5,1,15
03/02/16,2,12,7652,350,87,32,15,3,50
03/02/16,2,13,3062,400,66,9,21,0,30
03/02/16,2,14,642,360,146,1,2,0,3
03/02/16,2,15,775,350,79,10,14,0,24
03/02/16,2,16,8032,350,70,20,28,1,49
03/02/16,2,17,542,370,80,11,20,2,33
03/02/16,2,18,542,350,80,18,24,1,43
03/02/16,2,19,642,360,76,22,4,0,26
03/02/16,2,21,775,350,40,23,7,0,30
03/02/16,2,22,542,350,76,8,14,0,22
03/02/16,2,23,542,350,95,22,6,0,28
03/02/16,2,24,7675,360,92,17,4,0,21
03/02/16,2,26,747,360,135,7,5,0,12
03/02/16,2,27,542,360,93,10,9,0,19
03/02/16,3,1,738,305,30,34,13,5,52
03/02/16,3,2,726,315,80,14,9,2,25
03/02/16,3,3,996,200,24,19,7,0,26
03/02/16,3,4,996,200,42,25,6,0,31
03/02/16,3,5,8030,400,138,0,7,1,8
03/02/16,3,6,3062,370,92,20,3,13,36
03/02/16,3,7,293,345,95,16,7,1,24
03/02/16,3,9,8038,350,115,2,9,3,14
03/02/16,3,10,747,380,157,4,2,1,7
03/02/16,3,11,7652,355,125,14,1,1,16
03/02/16,3,12,7652,350,59,12,26,5,43
03/02/16,3,13,3062,400,61,7,26,0,33
03/02/16,3,14,642,360,123,8,8,1,17
03/02/16,3,15,775,350,88,2,12,0,14
03/02/16,3,16,8032,350,31,21,21,0,42
03/02/16,3,17,542,370,87,9,12,1,22
03/02/16,3,18,542,350,71,13,31,1,45
03/02/16,3,19,642,360,38,8,11,0,19
03/02/16,3,20,8040,350,31,22,8,3,33
03/02/16,3,21,775,350,48,9,12,1,22
03/02/16,3,22,542,350,78,14,7,0,21
03/02/16,3,23,542,350,35,0,38,0,38
03/02/16,3,24,7675,360,132,11,4,6,21
03/02/16,3,26,747,360,112,10,6,0,16
03/03/16,1,1,738,305,86,31,24,5,60
03/03/16,1,2,726,315,115,17,15,4,36
03/03/16,1,4,996,200,60,21,12,0,33
03/03/16,1,5,8030,400,158,2,4,1,7
03/03/16,1,6,3062,370,80,9,5,9,23
03/03/16,1,7,293,345,133,13,10,4,27
03/03/16,1,9,8038,350,167,0,1,0,1
03/03/16,1,10,747,380,169,6,1,1,8
03/03/16,1,11,7652,355,141,8,11,2,21
03/03/16,1,12,7652,350,89,9,19,4,32
03/03/16,1,13,3062,400,94,4,33,4,41
03/03/16,1,14,642,360,143,2,10,1,13
03/03/16,1,15,775,350,14,2,2,0,4
03/03/16,1,16,8032,350,77,26,38,3,67
03/03/16,1,17,542,370,95,16,21,2,39
03/03/16,1,18,542,350,84,18,24,3,45
03/03/16,1,20,8040,350,113,22,5,4,31
03/03/16,1,21,775,350,59,34,12,0,46
03/03/16,1,22,542,350,68,8,18,0,26
03/03/16,1,23,542,350,76,26,5,0,31
03/03/16,1,24,7675,360,122,11,4,4,19
03/03/16,1,26,747,360,125,10,12,0,22
03/03/16,1,27,542,360,85,18,5,0,23
03/03/16,2,1,738,305,117,6,17,2,25
03/03/16,2,2,726,315,128,15,13,0,28
03/03/16,2,4,996,200,36,9,8,0,17
03/03/16,2,5,8030,400,162,1,1,0,2
03/03/16,2,6,3062,370,128,21,8,11,40
03/03/16,2,7,293,345,131,8,9,3,20
03/03/16,2,8,exp,350,30,4,13,13,30
03/03/16,2,9,8038,350,166,0,3,1,4
03/03/16,2,10,747,380,165,4,3,0,7
03/03/16,2,11,7652,355,157,3,4,3,10
03/03/16,2,12,7652,350,120,18,20,3,41
03/03/16,2,13,3062,400,86,11,33,1,45
03/03/16,2,14,642,360,157,4,6,0,10
03/03/16,2,16,8032,350,74,29,32,0,61
03/03/16,2,17,542,370,63,26,16,0,42
03/03/16,2,18,542,350,90,9,23,2,34
03/03/16,2,20,8040,350,72,15,15,1,31
03/03/16,2,21,775,350,79,9,23,0,32
03/03/16,2,22,542,350,108,14,13,0,27
03/03/16,2,23,542,350,76,29,3,0,32
03/03/16,2,26,747,360,143,2,4,0,6
03/03/16,2,27,542,360,119,10,4,0,14
03/03/16,3,1,738,305,72,6,22,4,32
03/03/16,3,2,726,315,79,19,10,3,32
03/03/16,3,4,996,200,32,21,2,0,23
03/03/16,3,5,8030,400,134,6,0,2,8
03/03/16,3,6,3062,370,90,10,11,5,26
03/03/16,3,7,293,345,99,4,13,3,20
03/03/16,3,9,8038,350,163,1,0,2,3
03/03/16,3,10,747,380,119,20,4,1,25
03/03/16,3,11,7652,355,126,3,4,1,8
03/03/16,3,12,7652,350,106,10,13,1,24
03/03/16,3,13,3062,400,61,21,18,0,39
03/03/16,3,14,642,360,99,7,12,3,22
03/03/16,3,16,8032,350,37,19,24,0,43
03/03/16,3,17,542,370,90,10,16,3,29
03/03/16,3,18,542,350,40,9,14,3,26
03/03/16,3,20,8040,350,78,7,15,2,24
03/03/16,3,21,775,350,53,12,14,0,26
03/03/16,3,22,542,350,45,5,5,0,10
03/03/16,3,23,542,350,81,15,6,0,21
03/03/16,3,26,747,360,92,1,7,0,8
03/03/16,3,27,542,360,86,6,6,0,12
03/04/16,1,1,738,305,105,18,20,4,42
03/04/16,1,2,726,315,130,10,10,2,22
03/04/16,1,4,996,200,52,23,20,0,43
03/04/16,1,5,8030,400,151,1,6,1,8
03/04/16,1,6,3062,370,111,14,3,7,24
03/04/16,1,7,293,345,121,11,8,3,22
03/04/16,1,9,7740,350,169,0,1,1,2
03/04/16,1,10,747,380,170,5,5,1,11
03/04/16,1,11,7652,355,114,14,8,4,26
03/04/16,1,12,7652,350,122,21,15,5,41
03/04/16,1,13,3062,400,98,21,30,2,53
03/04/16,1,14,642,360,143,6,9,0,15
03/04/16,1,15,775,350,60,10,8,0,18
03/04/16,1,16,8032,350,77,26,35,0,61
03/04/16,1,17,542,370,20,2,10,2,14
03/04/16,1,18,542,350,2,0,0,7,7
03/04/16,1,20,8040,350,99,12,17,5,34
03/04/16,1,21,775,350,78,33,17,0,50
03/04/16,1,22,542,350,107,15,15,0,30
03/04/16,1,23,542,350,87,21,14,0,35
03/04/16,1,25,542,375,43,13,8,0,21
03/04/16,1,26,747,360,167,3,4,0,7
03/04/16,1,27,542,360,146,13,8,0,21
03/04/16,1,28,294,375,129,8,7,2,17
03/04/16,2,1,738,305,102,5,28,3,36
03/04/16,2,2,726,315,113,19,14,4,37
03/04/16,2,4,996,200,50,21,19,0,40
03/04/16,2,5,8030,400,128,2,4,1,7
03/04/16,2,6,3062,370,120,14,8,7,29
03/04/16,2,9,7740,350,158,1,2,1,4
03/04/16,2,10,747,380,170,8,2,0,10
03/04/16,2,11,7652,355,144,8,7,2,17
03/04/16,2,12,7652,350,108,15,14,4,33
03/04/16,2,13,3062,400,55,19,28,3,50
03/04/16,2,14,642,360,116,7,12,5,24
03/04/16,2,15,775,350,112,16,9,0,25
03/04/16,2,16,8032,350,72,15,36,1,52
03/04/16,2,17,542,370,40,9,17,4,30
03/04/16,2,18,542,350,41,7,16,4,27
03/04/16,2,20,8040,350,102,13,12,2,27
03/04/16,2,21,775,350,51,24,16,0,40
03/04/16,2,22,542,350,93,6,15,0,21
03/04/16,2,23,542,350,53,15,10,0,25
03/04/16,2,24,exp,360,9,2,2,4,8
03/04/16,2,25,542,375,120,15,2,0,17
03/04/16,2,26,747,360,157,2, ,0,2
03/04/16,2,27,542,360,120,12,6,0,18
03/04/16,2,28,294,375,130,19,5,1,25
03/04/16,3,1,738,305,13,1,0,2,3
03/04/16,3,2,726,315,119,0,7,4,11
03/04/16,3,4,996,200,41, , , ,0
03/04/16,3,5,8030,400,152,5,6,0,11
03/04/16,3,6,3062,370,134,27,10,15,52
03/04/16,3,9,7740,350,169,0,0,1,1
03/04/16,3,10,747,380,179,1,1,1,3
03/04/16,3,11,7652,355,146,19,8,2,29
03/04/16,3,12,7652,350,144,14,16,1,31
03/04/16,3,13,3062,400,98,14,44,2,60
03/04/16,3,14,642,360,156,4,6,1,11
03/04/16,3,15,775,350,83,18,13,0,31
03/04/16,3,16,8032,350,46,36,36,4,76
03/04/16,3,17,542,370,62,28,12,0,40
03/04/16,3,18,542,350,95,6,15,0,21
03/04/16,3,20,8040,350,90,19,11,2,32
03/04/16,3,21,775,350,45,17,8,0,25
03/04/16,3,22,542,350,72,7,9,0,16
03/04/16,3,23,542,350,58,27,3,0,30
03/04/16,3,25,542,375,103,20,4,0,24
03/04/16,3,26,747,360,61,0,17,0,17
03/04/16,3,27,542,360,88,12,15,0,27
03/04/16,3,28,294,375,95,12,7,4,23
03/07/16,1,1,738,305,78,8,16,3,27
03/07/16,1,2,726,315,95,6,11,7,24
03/07/16,1,5,776,400,140,4,2,1,7
03/07/16,1,6,3062,370,114,27,7,5,39
03/07/16,1,9,7740,350,135,0,3,2,5
03/07/16,1,10,747,380,163,6,1,1,8
03/07/16,1,11,7652,355,94,28,11,1,40
03/07/16,1,12,7652,350,128,9,14,3,26
03/07/16,1,13,3062,400,33,4,8,2,14
03/07/16,1,14,642,360,119,7,15,1,23
03/07/16,1,15,775,350,107,24,13,0,37
03/07/16,1,16,8032,350,70,29,48,5,82
03/07/16,1,17,542,370,78,31,13,1,45
03/07/16,1,18,542,350,90,7,14,3,24
03/07/16,1,20,8040,350,82,22,5,5,32
03/07/16,1,21,775,350,66,10,19,0,29
03/07/16,1,22,542,350,93,7,12,0,19
03/07/16,1,23,542,350,62,28,6,0,34
03/07/16,1,25,497,375,126,20,3,0,23
03/07/16,1,26,747,360,155,5,2,0,7
03/07/16,1,27,542,360,78,7,19,0,26
03/07/16,1,28,293,375,109,16,3,4,23
03/07/16,2,1,738,305,99,16,22,5,43
03/07/16,2,2,726,315,69,8,3,4,15
03/07/16,2,5,776,400,139,3,4,0,7
03/07/16,2,6,3062,370,130,27,5,4,36
03/07/16,2,9,7740,350,167,1,1,1,3
03/07/16,2,10,747,380,178,5,1,0,6
03/07/16,2,11,7652,355,98,18,16,2,36
03/07/16,2,12,7652,350,102,4,27,4,35
03/07/16,2,13,3062,400,20,2,8,0,10
03/07/16,2,14,642,360,140,4,15,2,21
03/07/16,2,15,775,350,128,14,14,0,28
03/07/16,2,16,8032,350,66,24,48,0,72
03/07/16,2,17,542,370,127,30,14,0,44
03/07/16,2,18,542,350,137,23,10,0,33
03/07/16,2,20,8040,350,115,17,15,7,39
03/07/16,2,21,775,350,74,39,12,0,51
03/07/16,2,24,Exp,360,22,4,4,6,14
03/07/16,2,25,497,375,119,25,3,0,28
03/07/16,2,26,747,360,162,2,6,0,8
03/07/16,2,27,542,360,121,17,7,0,24
03/07/16,2,28,293,375,134,19,6,5,30
03/07/16,,1,305,99,22,19,3,0,22
03/07/16,,2,315,108,12,10,4,0,14
03/07/16,,6,370,123,45,8,6,0,14
03/07/16,,10,380,171,3,8,1,0,9
03/07/16,,12,350,133,19,9,6,0,15
03/07/16,,13,400,109,15,36,0,0,36
03/07/16,,14,360,98,4,25,5,0,30
03/07/16,,15,350,72,7,23,0,0,23
03/07/16,,16,350,24,18,24,0,0,24
03/07/16,,17,370,95,21,9,1,0,10
03/07/16,,18,350,75,25,18,2,0,20
03/07/16,,20,350,85,22,14,0,0,14
03/07/16,,21,350,38,24,9,0,0,9
03/07/16,,22,350,79,5,11,0,0,11
03/07/16,,25,375,99,14,2,0,0,2
03/07/16,,26,360,150,1,4,0,0,4
03/07/16,,27,360,114,11,5,0,0,5
03/07/16,,28,375,129,12,4,0,0,4
03/08/16,1,1,738,305,101,13,30,1,44
03/08/16,1,2,726,315,109,31,10,4,45
03/08/16,1,6,3062,370,133,21,8,9,38
03/08/16,1,10,747,380,173,6,2,1,9
03/08/16,1,11,7652,355,62,2,7,3,12
03/08/16,1,12,7652,350,127,6,25,6,37
03/08/16,1,13,3062,400,99,10,38,1,49
03/08/16,1,15,775,350,117,12,21,0,33
03/08/16,1,16,8032,350,81,21,46,1,68
03/08/16,1,17,542,370,126,14,15,2,31
03/08/16,1,18,542,350,126,18,16,1,35
03/08/16,1,20,8040,350,107,29,9,6,44
03/08/16,1,21,775,350,29,10,8,0,18
03/08/16,1,22,542,350,5,2,0,0,2
03/08/16,1,23,542,350,82,28,2,0,30
03/08/16,1,25,497,375,149,25,5,0,30
03/08/16,1,26,747,360,165,3,2,0,5
03/08/16,1,27,542,360,154,13,9,0,22
03/08/16,1,28,293,375,12,3,1,1,5
03/08/16,2,1,738,305,90,18,31,5,54
03/08/16,2,2,726,315,121,18,13,2,33
03/08/16,2,6,3062,370,85,8,4,2,14
03/08/16,2,7,293,345,49,10,8,5,23
03/08/16,2,9,7740,350,41,4,1,3,8
03/08/16,2,10,747,380,158,1,2,5,8
03/08/16,2,11,7652,355,139,9,5,2,16
03/08/16,2,12,7652,350,127,12,21,2,35
03/08/16,2,13,3062,400,89,10,26,0,36
03/08/16,2,15,775,350,113,19,18,0,37
03/08/16,2,16,8032,350,43,42,40,1,83
03/08/16,2,17,542,370,138,14,10,2,26
03/08/16,2,18,542,350,130,27,19,0,46
03/08/16,2,20,8040,350,111,23,18,5,46
03/08/16,2,22,542,350,72,8,8,0,16
03/08/16,2,23,542,350,120,31,9,0,40
03/08/16,2,25,497,375,132,20,7,0,27
03/08/16,2,26,747,360,148,11,3,0,14
03/08/16,2,27,542,360,126,8,9,0,17
03/08/16,3,1,738,305,53,14,24,4,42
03/08/16,3,2,726,315,128,18,7,3,28
03/08/16,3,5,776,400,133,4,5,2,11
03/08/16,3,6,3062,370,38,4,2,0,6
03/08/16,3,7,293,345,137,24,11,3,38
03/08/16,3,9,7740,350,164,1,0,2,3
03/08/16,3,10,747,380,176,3,3,0,6
03/08/16,3,11,7652,355,147,14,7,3,24
03/08/16,3,12,7652,350,131,4,24,2,30
03/08/16,3,13,3062,400,112,6,34,7,47
03/08/16,3,15,775,350,55,15,13,0,28
03/08/16,3,16,8032,350,33,21,18,0,39
03/08/16,3,17,542,370,76,25,6,0,31
03/08/16,3,18,542,350,72,28,0,1,29
03/08/16,3,20,8040,350,75,16,17,11,44
03/08/16,3,21,775,350,9,2,1,0,3
03/08/16,3,23,542,350,67,2,16,0,18
03/08/16,3,25,497,375,67,11,7,0,18
03/08/16,3,26,747,360,117,6,8,0,14
03/08/16,3,27,542,360,97,11,8,0,19
03/09/16,1,2,726,315,95,25,7,3,35
03/09/16,1,5,8030,400,121,14,9,6,29
03/09/16,1,6,3062,370,128,3,11,7,21
03/09/16,1,7,293,345,127,11,12,0,23
03/09/16,1,9,8038,350,164,1,1,0,2
03/09/16,1,10,747,380,169,3,0,1,4
03/09/16,1,11,7652,355,126,8,15,5,28
03/09/16,1,12,7652,350,135,12,19,4,35
03/09/16,1,13,3062,400,104,12,27,1,40
03/09/16,1,14,8030,360,43,0,7,1,8
03/09/16,1,15,775,350,120,17,17,0,34
03/09/16,1,16,8032,350,60,24,51,2,77
03/09/16,1,17,542,370,75,47,12,1,60
03/09/16,1,18,542,350,81,29,18,4,51
03/09/16,1,20,8040,350,119,18,15,6,39
03/09/16,1,21,775,350,93,29,13,0,42
03/09/16,1,22,542,350,71,6,16,0,22
03/09/16,1,23,542,350,24,3,7,0,10
03/09/16,1,25,542,375,128,19,7,0,26
03/09/16,1,26,747,360,145,5,11,0,16
03/09/16,1,27,542,360,120,15,5,0,20
03/09/16,2,2,726,315,126,11,10,1,22
03/09/16,2,5,8030,400,93,15,6,1,22
03/09/16,2,6,3062,370,124,5,15,8,28
03/09/16,2,7,293,345,103,11,11,3,25
03/09/16,2,9,8038,350,162,1,1,1,3
03/09/16,2,10,747,380,55,1,4,2,7
03/09/16,2,11,7652,355,148,6,8,1,15
03/09/16,2,12,7652,350,135,8,21,2,31
03/09/16,2,13,3062,400,94,1,30,0,31
03/09/16,2,14,8030,360,131,16,2,2,20
03/09/16,2,15,775,350,2,0,0,0,0
03/09/16,2,16,8032,350,82,27,45,0,72
03/09/16,2,17,542,370,92,20,5,4,29
03/09/16,2,18,542,350,106,52,17,1,70
03/09/16,2,20,8040,350,59,8,9,6,23
03/09/16,2,21,775,350,123,24,22,0,46
03/09/16,2,22,542,350,111,33,13,0,46
03/09/16,2,24,exp,360,19,4,3,6,13
03/09/16,2,25,542,375,137,17,11,0,28
03/09/16,2,26,747,360,147,4,5,0,9
03/09/16,2,27,542,360,136,12,5,0,17
03/09/16,2,29,737,270,16,8,3,0,11
03/09/16,3,2,726,315,133,15,5,6,26
03/09/16,3,5,8030,400,162,2,4,1,7
03/09/16,3,6,3062,370,146,12,4,23,39
03/09/16,3,7,293,345,141,16,8,2,26
03/09/16,3,9,8038,350,166,0,0,6,6
03/09/16,3,11,7652,355,137,5,17,4,26
03/09/16,3,12,7652,350,129,8,19,4,31
03/09/16,3,13,3062,400,114,11,37,1,49
03/09/16,3,14,8030,360,163,5,3,0,8
03/09/16,3,16,8032,350,41,36,25,0,61
03/09/16,3,18,542,350,111,17,12,0,29
03/09/16,3,21,775,350,72,18,11,0,29
03/09/16,3,22,542,350,77,25,13,0,38
03/09/16,3,25,542,375,21,0,3,0,3
03/09/16,3,26,747,360,132,1,8,0,9
03/09/16,3,27,542,360,96,8,9,0,17
03/09/16,3,29,737,270,90,12,2,0,14
03/10/16,1,2,726,315,120,21,9,1,31
03/10/16,1,5,8030,400,149,6,5,0,11
03/10/16,1,6,3062,370,148,10,6,4,20
03/10/16,1,7,293,345,129,23,14,2,39
03/10/16,1,9,8038,350,169,0,1,1,2
03/10/16,1,10,8012,380,58,4,10,13,27
03/10/16,1,11,7652,355,140,8,25,3,36
03/10/16,1,12,7652,350,122,12,27,4,43
03/10/16,1,13,3062,400,89,1,33,5,39
03/10/16,1,14,8030,360,166,0,4,1,5
03/10/16,1,15,775,350,40,13,3,0,16
03/10/16,1,16,8032,350,85,39,40,0,79
03/10/16,1,18,542,350,122,27,9,1,37
03/10/16,1,21,775,350,100,27,14,0,41
03/10/16,1,22,542,350,90,24,16,0,40
03/10/16,1,23,542,350,15,5,5,0,10
03/10/16,1,25,542,375,119,15,13,0,28
03/10/16,1,26,747,360,171,3,5,0,8
03/10/16,1,27,542,360,112,10,8,0,18
03/10/16,1,29,737,270,77,19,8,0,27
03/10/16,2,2,726,315,111,9,11,2,22
03/10/16,2,5,8030,400,126,4,11,1,16
03/10/16,2,6,3062,370,133,8,5,15,28
03/10/16,2,7,293,345,132,16,5,3,24
03/10/16,2,9,8038,350,142,0,1,3,4
03/10/16,2,10,8012,380,94,4,14,18,36
03/10/16,2,11,7652,355,141,8,19,3,30
03/10/16,2,12,7652,350,84,4,29,0,33
03/10/16,2,13,3062,400,91,12,21,1,34
03/10/16,2,14,8030,360,164,0,4,1,5
03/10/16,2,15,775,350,139,15,3,0,18
03/10/16,2,16,8032,350,35,24,24,3,51
03/10/16,2,18,542,350,111,46,11,2,59
03/10/16,2,21,775,350,91,24,20,0,44
03/10/16,2,22,542,350,83,17,11,0,28
03/10/16,2,23,542,350,100,30,20,0,50
03/10/16,2,25,542,375,113,36,7,0,43
03/10/16,2,26,747,360,163,0,7,0,7
03/10/16,2,27,542,360,115,12,8,0,20
03/10/16,2,29,737,270,99,10,12,0,22
03/10/16,3,1,996,305,6,11,4,4,19
03/10/16,3,2,726,315,137,9,11,2,22
03/10/16,3,5,8030,400,161,2,3,0,5
03/10/16,3,6,3062,370,151,7,6,8,21
03/10/16,3,7,293,345,135,26,2,1,29
03/10/16,3,9,8038,350,164,0,2,0,2
03/10/16,3,10,8012,380,167,2,6,3,11
03/10/16,3,11,7652,355,156,4,5,3,12
03/10/16,3,12,7652,350,102,18,2,2,22
03/10/16,3,13,3062,400,130,7,26,0,33
03/10/16,3,14,8030,360,158,1,5,1,7
03/10/16,3,15,775,350,111,10,8,0,18
03/10/16,3,18,542,350,63,28,11,0,39
03/10/16,3,21,775,350,58,14,11,0,25
03/10/16,3,22,542,350,68,15,5,0,20
03/10/16,3,23,542,350,75,20,7,0,27
03/10/16,3,25,542,375,93,17,2,0,19
03/10/16,3,26,747,360,167,2,4,0,6
03/10/16,3,27,542,360,111,12,6,0,18
03/10/16,3,29,737,270,56,11,10,0,21
03/11/16,1,1,996,305,81,49,16,9,74
03/11/16,1,2,726,315,124,6,10,2,18
03/11/16,1,5,8030,400,161,1,4,2,7
03/11/16,1,6,3062,370,150,15,6,7,28
03/11/16,1,7,293,345,84,20,2,1,23
03/11/16,1,9,8038,350,169,2,0,1,3
03/11/16,1,10,8012,380,166,5,2,3,10
03/11/16,1,11,7652,355,157,8,4,4,16
03/11/16,1,12,7652,350,121,14,22,5,41
03/11/16,1,13,3062,400,32,1,6,3,10
03/11/16,1,14,8030,360,161,4,5,0,9
03/11/16,1,15,775,350,137,10,11,0,21
03/11/16,1,16,8032,350,83,10,2,7,19
03/11/16,1,18,542,350,89,82,19,8,109
03/11/16,1,21,775,350,77,29,6,0,35
03/11/16,1,22,542,350,116,16,13,0,29
03/11/16,1,23,542,350,98,39,8,0,47
03/11/16,1,24,7625,360,21,4,0,10,14
03/11/16,1,25,542,375,113,28,5,0,33
03/11/16,1,26,747,360,120,0,7,0,7
03/11/16,1,27,542,360,140,18,6,0,24
03/11/16,2,1,996,305,106,20,14,3,37
03/11/16,2,2,726,315,138,9,8,2,19
03/11/16,2,5,8030,400,151,1,6,0,7
03/11/16,2,6,3062,370,146,5,7,9,21
03/11/16,2,9,8038,350,168,2,0,1,3
03/11/16,2,10,8012,380,170,4,5,2,11
03/11/16,2,11,7652,355,143,6,8,2,16
03/11/16,2,12,7652,350,135,9,15,3,27
03/11/16,2,14,8030,360,159,0,8,1,9
03/11/16,2,15,775,350,152,4,7,0,11
03/11/16,2,16,8032,350,132,21,6,1,28
03/11/16,2,18,542,350,123,41,17,3,61
03/11/16,2,21,775,350,116,23,20,0,43
03/11/16,2,22,542,350,124,21,18,0,39
03/11/16,2,23,542,350,126,37,11,0,48
03/11/16,2,24,7625,360,133,19,2,4,25
03/11/16,2,25,542,375,129,38,5,0,43
03/11/16,2,26,747,360,68,0,4,0,4
03/11/16,2,27,542,360,140,18,6,0,24
03/11/16,3,1,996,305,101,55,14,4,73
03/11/16,3,2,726,315,135,21,8,4,33
03/11/16,3,5,8030,400,152,1,10,2,13
03/11/16,3,6,3062,370,125,23,7,8,38
03/11/16,3,9,8038,350,168,0,2,3,5
03/11/16,3,10,8012,380,173,3,6,1,10
03/11/16,3,11,7652,355,162,4,3,3,10
03/11/16,3,12,7652,350,83,3,9,0,12
03/11/16,3,14,8030,360,161,1,6,1,8
03/11/16,3,15,775,350,153,3,7,0,10
03/11/16,3,16,8032,350,123,20,3,2,25
03/11/16,3,18,542,350,85,39,14,1,54
03/11/16,3,21,775,350,91,42,16,0,58
03/11/16,3,22,542,350,109,32,9,0,41
03/11/16,3,23,542,350,110,27,3,0,30
03/11/16,3,24,7625,360,106,19,2,10,31
03/11/16,3,25,542,375,108,37,4,0,41
03/11/16,3,27,542,360,134,15,9,0,24
03/14/16,1,1,996,305,72,62,13,2,77
03/14/16,1,2,726,315,118,12,11,5,28
03/14/16,1,6,3062,370,139,17,4,14,35
03/14/16,1,9,8038,350,161,0,1,1,2
03/14/16,1,10,8012,380,149,1,4,5,10
03/14/16,1,11,7652,355,131,4,6,6,16
03/14/16,1,14,8030,360,160,1,3,2,6
03/14/16,1,15,775,350,143,4,6,0,10
03/14/16,1,16,8032,350,135,32,5,4,41
03/14/16,1,18,542,350,55,17,6,5,28
03/14/16,1,21,775,350,99,20,16,0,36
03/14/16,1,23,542,350,90,24,6,0,30
03/14/16,1,24,7625,360,88,18,2,6,26
03/14/16,1,25,542,375,140,24,2,0,26
03/14/16,1,27,542,360,86,12,7,0,19
03/14/16,2,1,996,305,85,61,15,2,78
03/14/16,2,2,726,315,120,13,17,0,30
03/14/16,2,5,8030,400,149,0,2,0,2
03/14/16,2,6,3062,370,134,33,10,16,59
03/14/16,2,9,8038,350,168,0,1,1,2
03/14/16,2,10,8012,380,154,3,0,2,5
03/14/16,2,11,7652,355,155,9,5,3,17
03/14/16,2,12,7652,350,20,3,11,14,28
03/14/16,2,14,8030,360,156,0,7,3,10
03/14/16,2,15,775,350,132,11,7,0,18
03/14/16,2,16,8032,350,132,21,5,4,30
03/14/16,2,19,747,360,69,2,7,0,9
03/14/16,2,21,775,350,78,21,12,1,34
03/14/16,2,22,542,350,100,18,19,0,37
03/14/16,2,23,542,350,111,22,9,0,31
03/14/16,2,24,7625,360,107,18,1,5,24
03/14/16,2,25,542,375,99,21,5,0,26
03/14/16,3,1,996,305,71,45,19,3,67
03/14/16,3,2,726,315,35,6,2,2,10
03/14/16,3,5,8030,400,150,0,3,1,4
03/14/16,3,6,3062,370,140,25,6,11,42
03/14/16,3,9,8038,350,15,0,1,0,1
03/14/16,3,10,8012,380,170,2,4,4,10
03/14/16,3,11,7652,355,152,7,6,2,15
03/14/16,3,14,8030,360,153,0,3,6,9
03/14/16,3,15,775,350,126,9,6,0,15
03/14/16,3,16,8032,350,122,16,4,2,22
03/14/16,3,19,747,360,91,5,16,0,21
03/14/16,3,21,775,350,62,18,14,0,32
03/14/16,3,22,542,350,59,22,15,0,37
03/14/16,3,23,542,350,68,77,9,0,86
03/14/16,3,24,7625,360,120,4,3,2,9
03/14/16,3,25,542,375,109,14,11,0,25
03/15/16,1,1,996,305,55,35,11,1,47
03/15/16,1,2,726,315,76,27,8,4,39
03/15/16,1,6,3062,370,146,23,8,8,39
03/15/16,1,10,8012,380,92,4,5,1,10
03/15/16,1,11,7652,355,157,7,7,4,18
03/15/16,1,13,3062,400,32,1,6,3,10
03/15/16,1,14,8030,360,170,0,2,1,3
03/15/16,1,15,775,350,148,11,6,0,17
03/15/16,1,16,8032,350,148,15,6,2,23
03/15/16,1,17,542,370,89,9,5,1,15
03/15/16,1,18,542,350,28,17,54,18,89
03/15/16,1,19,747,360,111,4,9,0,13
03/15/16,1,21,775,350,64,15,17,0,32
03/15/16,1,22,542,350,48,13,4,0,17
03/15/16,1,23,542,350,113,35,7,0,42
03/15/16,1,24,7625,360,136,14,1,8,23
03/15/16,1,25,542,375,33,7,1,0,8
03/15/16,1,26,747,360,32,0,4,0,4
03/15/16,1,27,542,360,13,0,1,0,1
03/15/16,1,28,293,375,28,4,0,14,18
03/15/16,2,1,996,305,102,38,18,3,59
03/15/16,2,2,726,315,116,26,9,3,38
03/15/16,2,6,3062,370,144,23,5,10,38
03/15/16,2,10,8012,380,179,0,2,1,3
03/15/16,2,11,7652,355,153,6,4,1,11
03/15/16,2,14,8030,360,160,1,7,1,9
03/15/16,2,15,775,350,131,4,9,0,13
03/15/16,2,16,8032,350,135,8,3,0,11
03/15/16,2,17,542,370,99,22,6,0,28
03/15/16,2,18,542,350,27,31,31,1,63
03/15/16,2,19,747,360,69,21,2,0,23
03/15/16,2,21,775,350,49,10,8,0,18
03/15/16,2,22,542,350,67,10,10,0,20
03/15/16,2,23,542,350,98,19,7,0,26
03/15/16,2,24,7625,360,119,16,2,4,22
03/15/16,2,25,542,375,97,21,4,0,25
03/15/16,2,26,747,360,128,2,8,0,10
03/15/16,2,28,293,375,129,23,0,5,28
03/15/16,3,1,996,305,105,48,14,2,64
03/15/16,3,2,726,315,122,22,15,0,37
03/15/16,3,5,8030,400,85,4,1,6,11
03/15/16,3,10,8012,380,128,2,9,4,15
03/15/16,3,11,7652,355,155,6,2,2,10
03/15/16,3,14,8030,360,165,2,3,0,5
03/15/16,3,15,775,350,116,6,8,0,14
03/15/16,3,16,8032,350,127,12,4,2,18
03/15/16,3,17,542,370,64,19,16,9,44
03/15/16,3,18,542,350,46,7,28,0,35
03/15/16,3,19,747,360,109,7,5,0,12
03/15/16,3,20,8040,350,7,2,1,0,3
03/15/16,3,21,775,350,52,13,12,0,25
03/15/16,3,22,542,350,55,7,8,0,15
03/15/16,3,23,542,350,81,12,11,0,23
03/15/16,3,25,542,375,92,16,3,0,19
03/15/16,3,26,747,360,142,0,7,0,7
03/15/16,3,27,542,360,15,1,2,0,3
03/15/16,3,28,293,375,98,17,0,2,19
03/16/16,1,1,996,305,108,52,18,2,72
03/16/16,1,2,726,315,107,38,15,4,57
03/16/16,1,5,8030,400,141,1,2,4,7
03/16/16,1,11,7652,355,144,7,4,4,15
03/16/16,1,14,8030,360,163,7,4,1,12
03/16/16,1,15,775,350,132,16,5,0,21
03/16/16,1,16,8032,350,146,14,10,0,24
03/16/16,1,17,542,370,97,29,12,1,42
03/16/16,1,18,542,350,49,3,36,2,41
03/16/16,1,19,747,360,111,17,5,0,22
03/16/16,1,20,8040,350,78,27,10,3,40
03/16/16,1,21,775,350,59,15,14,0,29
03/16/16,1,22,542,350,70,18,12,0,30
03/16/16,1,23,542,350,73,20,4,0,24
03/16/16,1,26,747,360,91,6,4,0,10
03/16/16,1,27,542,360,50,14,10,0,24
03/16/16,1,28,293,375,121,15,1,6,22
03/16/16,2,1,996,305,23,10,7,2,19
03/16/16,2,2,726,315,82,19,10,7,36
03/16/16,2,5,8030,400,136,4,18,0,22
03/16/16,2,10,8012,380,67,0,1,4,5
03/16/16,2,13,8035,400,59,19,18,14,51
03/16/16,2,14,8030,360,132,18,5,1,24
03/16/16,2,15,775,350,104,9,7,0,16
03/16/16,2,16,8032,350,99,10,6,1,17
03/16/16,2,17,542,370,84,10,10,0,20
03/16/16,2,18,542,350,39,15,25,1,41
03/16/16,2,19,747,360,92,22,5,0,27
03/16/16,2,20,8040,350,81,10,17,3,30
03/16/16,2,21,775,350,71,10,9,0,19
03/16/16,2,22,542,350,65,37,3,0,40
03/16/16,2,23,542,350,88,19,9,0,28
03/16/16,2,24,7625,360,67,33,1,1,35
03/16/16,2,26,747,360,151,1,8,0,9
03/16/16,2,27,542,360,57,14,8,0,22
03/16/16,2,28,293,375,123,21,1,6,28
03/16/16,3,1,996,305,16,2,2,1,5
03/16/16,3,5,8030,400,149,1,7,2,10
03/16/16,3,13,8035,400,102,8,45,1,54
03/16/16,3,14,8030,360,149,3,5,3,11
03/16/16,3,15,775,350,116,7,8,0,15
03/16/16,3,17,542,370,126,19,17,0,36
03/16/16,3,18,542,350,112,16,37,4,57
03/16/16,3,19,747,360,96,25,3,0,28
03/16/16,3,20,8040,350,68,10,30,0,40
03/16/16,3,21,775,350,41,21,5,0,26
03/16/16,3,22,542,350,74,18,11,0,29
03/16/16,3,23,542,350,69,18,6,0,24
03/16/16,3,24,7625,360,54,25,1,3,29
03/16/16,3,26,747,360,129,4,8,0,12
03/16/16,3,27,542,360,46,10,6,0,16
03/16/16,3,28,293,375,114,15,1,7,23
03/17/16,1,1,996,305,108,47,8,3,58
03/17/16,1,5,8030,400,163,2,3,0,5
03/17/16,1,11,7652,355,9,4,1,22,27
03/17/16,1,13,8035,400,71,3,28,0,31
03/17/16,1,14,8030,360,167,4,1,0,5
03/17/16,1,15,775,350,73,7,1,0,8
03/17/16,1,17,542,370,108,15,15,0,30
03/17/16,1,18,542,350,102,17,31,0,48
03/17/16,1,19,747,360,81,11,3,0,14
03/17/16,1,20,8040,350,96,20,21,2,43
03/17/16,1,21,775,350,67,15,7,0,22
03/17/16,1,22,542,350,60,17,11,0,28
03/17/16,1,23,542,350,64,16,7,0,23
03/17/16,1,24,7625,360,72,31,0,6,37
03/17/16,1,25,542,375,20,8,8,0,16
03/17/16,1,26,747,360,151,5,6,0,11
03/17/16,1,27,542,360,80,16,8,0,24
03/17/16,1,28,293,375,98,11,1,12,24
03/17/16,2,1,996,305,114,40,17,7,64
03/17/16,2,5,8030,400,148,9,8,3,20
03/17/16,2,10,8012,380,157,1,5,11,17
03/17/16,2,11,7652,355,147,21,3,3,27
03/17/16,2,13,3062,400,123,3,29,3,35
03/17/16,2,14,8030,360,166,6,2,1,9
03/17/16,2,15,775,350,16,2,3,0,5
03/17/16,2,17,542,370,100,24,8,1,33
03/17/16,2,18,542,350,77,4,17,1,22
03/17/16,2,19,747,360,130,11,1,0,12
03/17/16,2,20,8040,350,87,23,26,1,50
03/17/16,2,21,775,350,81,17,14,0,31
03/17/16,2,22,542,350,62,21,5,0,26
03/17/16,2,23,542,350,87,18,7,0,25
03/17/16,2,24,7625,360,116,13,2,4,19
03/17/16,2,25,542,375,78,28,8,0,36
03/17/16,2,26,747,360,165,0,7,0,7
03/17/16,2,27,542,360,77,16,3,0,19
03/17/16,2,28,293,375,67,20,1,10,31
03/17/16,3,1,996,305,117,42,9,3,54
03/17/16,3,5,8030,400,157,3,8,0,11
03/17/16,3,11,7652,355,140,26,4,3,33
03/17/16,3,13,3062,400,116,11,43,6,60
03/17/16,3,14,8030,360,159,9,1,2,12
03/17/16,3,17,542,370,99,12,12,4,28
03/17/16,3,18,542,350,78,7,29,0,36
03/17/16,3,19,747,360,171,0,4,0,4
03/17/16,3,20,8040,350,98,16,12,0,28
03/17/16,3,21,775,350,84,15,14,0,29
03/17/16,3,22,542,350,69,29,6,0,35
03/17/16,3,23,542,350,62,22,8,0,30
03/17/16,3,24,7625,360,53,7,0,3,10
03/17/16,3,25,542,375,89,27,9,0,36
03/17/16,3,26,747,360,175,1,2,0,3
03/17/16,3,27,542,360,84,19,5,0,24
03/18/16,1,1,996,305,118,39,16,1,56
03/18/16,1,5,8030,400,157,3,2,2,7
03/18/16,1,11,7652,355,151,14,3,2,19
03/18/16,1,13,3062,400,95,1,48,0,49
03/18/16,1,14,8030,360,11,1,2,0,3
03/18/16,1,17,542,370,83,18,22,2,42
03/18/16,1,18,542,350,89,4,34,2,40
03/18/16,1,19,747,360,114,1,3,0,4
03/18/16,1,20,8040,350,111,17,11,2,30
03/18/16,1,21,775,350,69,22,9,0,31
03/18/16,1,22,542,350,49,17,7,0,24
03/18/16,1,23,542,350,85,13,3,0,16
03/18/16,1,25,542,375,89,19,14,0,33
03/18/16,1,26,747,360,159,9,2,0,11
03/18/16,1,27,542,360,73,21,4,0,25
03/18/16,2,1,996,305,116,41,16,1,58
03/18/16,2,5,8030,400,160,4,4,0,8
03/18/16,2,11,7652,355,138,5,18,4,27
03/18/16,2,13,3062,400,118,20,34,2,56
03/18/16,2,14,8030,360,58,0,2,1,3
03/18/16,2,17,542,370,83,9,18,0,27
03/18/16,2,18,542,350,84,4,25,0,29
03/18/16,2,19,747,360,143,8,3,0,11
03/18/16,2,20,8040,350,98,22,15,5,42
03/18/16,2,21,775,350,80,18,11,0,29
03/18/16,2,23,542,350,46,11,5,0,16
03/18/16,2,25,542,375,64,23,9,0,32
03/18/16,2,26,747,360,152,6,4,0,10
03/18/16,2,27,542,360,87,23,6,0,29
03/18/16,2,28,293,375,60,40,1,12,53
03/18/16,3,1,996,305,105,38,10,6,54
03/18/16,3,5,8030,400,148,10,5,3,18
03/18/16,3,11,7652,355,127,12,11,4,27
03/18/16,3,13,3062,400,109,13,39,4,56
03/18/16,3,14,8030,360,164,7,3,1,11
03/18/16,3,17,542,370,75,15,10,2,27
03/18/16,3,18,542,350,94,2,27,1,30
03/18/16,3,19,747,360,159,7,1,0,8
03/18/16,3,20,8040,350,91,27,11,4,42
03/18/16,3,21,775,350,60,21,7,0,28
03/18/16,3,25,542,375,81,25,8,0,33
03/18/16,3,26,747,360,121,3,8,0,11
03/18/16,3,27,542,360,77,13,13,0,26
03/18/16,3,28,293,375,54,64,0,4,68
03/21/16,1,1,996,305,103,51,19,1,71
03/21/16,1,3,996,200,11,10,7,0,17
03/21/16,1,4,5302,200,27,14,5,0,19
03/21/16,1,5,8030,400,157,0,4,4,8
03/21/16,1,6,3062,370,55,16,13,6,35
03/21/16,1,11,7652,355,150,8,8,2,18
03/21/16,1,12,7652,350,29,0,4,0,4
03/21/16,1,13,3062,400,116,5,22,0,27
03/21/16,1,14,8030,360,157,7,0,2,9
03/21/16,1,17,542,370,72,11,24,1,36
03/21/16,1,18,542,350,64,8,36,3,47
03/21/16,1,19,747,360,133,2,9,0,11
03/21/16,1,20,8040,350,80,16,16,5,37
03/21/16,1,22,542,350,49,17,7,0,24
03/21/16,1,23,542,350,85,13,3,0,16
03/21/16,1,24,7625,360,73,10,1,4,15
03/21/16,1,25,542,375,53,18,4,0,22
03/21/16,1,26,747,360,142,13,4,0,17
03/21/16,1,27,542,360,74,11,6,0,17
03/21/16,1,28,7625,375,93,25,2,8,35
03/21/16,2,1,996,305,110,28,20,4,52
03/21/16,2,3,996,200,49,11,3,0,14
03/21/16,2,4,5302,200,6,1,2,0,3
03/21/16,2,5,8030,400,161,1,1,2,4
03/21/16,2,6,3062,370,137,27,14,2,43
03/21/16,2,9,491,350,108,5,13,7,25
03/21/16,2,11,7652,355,148,6,11,5,22
03/21/16,2,12,7652,350,126,11,24,2,37
03/21/16,2,13,3062,400,103,17,31,3,51
03/21/16,2,14,8030,360,169,2,2,0,4
03/21/16,2,17,542,370,67,14,11,2,27
03/21/16,2,18,542,350,87,24,26,0,50
03/21/16,2,19,747,360,140,2,2,0,4
03/21/16,2,20,8040,350,94,25,21,2,48
03/21/16,2,22,542,350,38,21,3,0,24
03/21/16,2,23,542,350,46,11,5,0,16
03/21/16,2,24,7625,360,126,13,0,3,16
03/21/16,2,25,542,375,52,26,8,0,34
03/21/16,2,26,747,360,143,13,6,0,19
03/21/16,2,27,542,360,93,11,15,0,26
03/21/16,2,28,7625,375,128,18,4,4,26
03/21/16,3,1,996,305,9,2,11,0,13
03/21/16,3,5,8030,400,156,2,1,1,4
03/21/16,3,6,3062,370,111,17,10,4,31
03/21/16,3,9,491,350,89,23,23,1,47
03/21/16,3,11,7652,355,147,7,6,3,16
03/21/16,3,12,7652,350,7,5,55,0,60
03/21/16,3,13,3062,400,92,8,32,4,44
03/21/16,3,14,8030,360,149,0,4,7,11
03/21/16,3,17,542,370,46,9,3,1,13
03/21/16,3,18,542,350,26,3,11,1,15
03/21/16,3,19,747,360,87,0,4,0,4
03/21/16,3,20,8040,350,53,16,10,9,35
03/21/16,3,22,542,350,28,9,3,0,12
03/21/16,3,23,542,350,11,11,3,0,14
03/21/16,3,24,7625,360,84,5,1,4,10
03/21/16,3,25,542,375,10,3,5,0,8
03/21/16,3,26,747,360,70,3,2,0,5
03/21/16,3,27,542,360,55,7,3,0,10
03/21/16,3,28,7625,375,40,33,0,4,37
03/22/16,1,3,996,200,79,24,3,0,27
03/22/16,1,4,5302,200,30,36,1,0,37
03/22/16,1,5,8030,400,149,3,2,2,7
03/22/16,1,6,3062,370,136,33,11,4,48
03/22/16,1,9,491,350,141,14,6,2,22
03/22/16,1,11,7652,355,158,6,5,2,13
03/22/16,1,12,7652,350,104,9,17,4,30
03/22/16,1,13,3062,400,86,12,16,3,31
03/22/16,1,14,8030,360,128,7,1,3,11
03/22/16,1,17,542,370,95,20,11,0,31
03/22/16,1,18,542,350,83,17,31,0,48
03/22/16,1,19,747,360,181,0,3,0,3
03/22/16,1,20,8040,350,95,13,18,7,38
03/22/16,1,21,775,350,14,8,2,0,10
03/22/16,1,23,542,350,24,29,1,0,30
03/22/16,1,24,7625,360,115,16,7,3,26
03/22/16,1,25,542,375,43,20,9,0,29
03/22/16,1,26,747,360,157,4,8,0,12
03/22/16,1,27,542,360,20,5,63,0,68
03/22/16,1,28,7625,375,83,24,3,3,30
03/22/16,2,2,972,315,6,0,0,11,11
03/22/16,2,3,996,200,37,2,4,0,6
03/22/16,2,4,5302,200,23,24,12,0,36
03/22/16,2,5,8030,400,165,1,0,0,1
03/22/16,2,6,3062,370,130,15,11,5,31
03/22/16,2,9,491,350,130,14,7,2,23
03/22/16,2,11,7652,355,148,10,6,3,19
03/22/16,2,12,7652,350,133,9,18,4,31
03/22/16,2,13,3062,400,132,13,31,1,45
03/22/16,2,14,8030,360,168,3,2,2,7
03/22/16,2,17,542,370,64,23,5,2,30
03/22/16,2,18,542,350,66,20,16,0,36
03/22/16,2,19,747,360,167,0,2,0,2
03/22/16,2,20,8040,350,99,19,12,2,33
03/22/16,2,21,775,350,18,10,2,0,12
03/22/16,2,22,542,350,53,19,7,0,26
03/22/16,2,23,542,350,35,28,5,0,33
03/22/16,2,24,7625,360,131,9,3,5,17
03/22/16,2,25,542,375,52,17,7,0,24
03/22/16,2,26,747,360,142,2,9,0,11
03/22/16,2,28,7625,375,112,17,4,4,25
03/22/16,3,2,972,315,102,36,11,8,55
03/22/16,3,5,8030,400,147,3,2,3,8
03/22/16,3,6,3062,370,138,24,18,4,46
03/22/16,3,9,491,350,129,43,6,0,49
03/22/16,3,10,8012,380,12,1,0,0,1
03/22/16,3,11,7652,355,152,9,1,2,12
03/22/16,3,12,7652,350,32,1,5,0,6
03/22/16,3,13,3062,400,122,13,37,1,51
03/22/16,3,14,8030,360,152,3,2,4,9
03/22/16,3,17,542,370,96,17,7,1,25
03/22/16,3,18,542,350,71,25,20,0,45
03/22/16,3,19,747,360,148,2,5,0,7
03/22/16,3,20,8040,350,77,15,17,4,36
03/22/16,3,22,542,350,94,22,13,0,35
03/22/16,3,23,542,350,60,21,4,0,25
03/22/16,3,24,7625,360,99,21,2,2,25
03/22/16,3,25,542,375,55,15,13,0,28
03/22/16,3,26,747,360,105,4,9,0,13
03/22/16,3,27,542,360,61,8,8,0,16
03/22/16,3,28,7625,375,87,37,0,2,39
03/23/16,1,2,972,315,132,5,6,5,16
03/23/16,1,3,996,200,127,16,21,7,44
03/23/16,1,5,8030,400,165,0,1,0,1
03/23/16,1,6,3062,370,117,29,20,5,54
03/23/16,1,8,exp,350,25,4,4,7,15
03/23/16,1,9,491,350,152,9,3,4,16
03/23/16,1,10,8012,380,157,12,5,1,18
03/23/16,1,11,7652,355,113,18,12,8,38
03/23/16,1,13,3062,400,105,12,31,0,43
03/23/16,1,14,8030,360,136,5,2,5,12
03/23/16,1,18,542,350,47,70,26,3,99
03/23/16,1,19,747,360,163,2,7,0,9
03/23/16,1,20,8040,350,94,24,11,3,38
03/23/16,1,22,542,350,69,12,13,0,25
03/23/16,1,23,542,350,51,36,4,0,40
03/23/16,1,24,7625,360,110,9,2,7,18
03/23/16,1,25,542,375,98,18,8,0,26
03/23/16,1,26,747,360,179,1,4,0,5
03/23/16,1,27,542,360,73,28,0,0,28
03/23/16,1,28,7625,375,122,22,3,6,31
03/23/16,2,2,972,315,83,2,1,9,12
03/23/16,2,3,996,200,37,5,13,4,22
03/23/16,2,5,8030,400,161,1,4,1,6
03/23/16,2,6,3062,370,129,30,9,2,41
03/23/16,2,9,491,350,159,12,4,5,21
03/23/16,2,10,8012,380,179,1,1,1,3
03/23/16,2,11,7652,355,63,9,8,4,21
03/23/16,2,13,3062,400,74,33,28,2,63
03/23/16,2,14,8030,360,160,3,4,2,9
03/23/16,2,18,542,350,58,22,14,0,36
03/23/16,2,19,747,360,150,1,4,0,5
03/23/16,2,20,8040,350,103,16,140,0,156
03/23/16,2,22,542,350,42,22,8,0,30
03/23/16,2,23,542,350,53,31,3,0,34
03/23/16,2,24,7625,360,130,6,0,9,15
03/23/16,2,25,542,375,56,22,10,0,32
03/23/16,2,26,747,360,132,8,4,0,12
03/23/16,2,27,542,360,64,15,13,0,28
03/23/16,2,28,7625,375,136,13,5,5,23
03/23/16,3,2,972,315,135,11,2,1,14
03/23/16,3,5,8030,400,158,3,2,1,6
03/23/16,3,6,3062,370,138,15,16,8,39
03/23/16,3,9,491,350,146,5,7,4,16
03/23/16,3,10,8012,380,62,4,2,0,6
03/23/16,3,13,3062,400,110,14,36,2,52
03/23/16,3,14,8030,360,121,5,2,13,20
03/23/16,3,18,542,350,75,12,25,2,39
03/23/16,3,19,747,360,104,1,4,0,5
03/23/16,3,20,8040,350,100,13,17,1,31
03/23/16,3,22,542,350,75,29,9,0,38
03/23/16,3,23,542,350,67,35,1,0,36
03/23/16,3,25,542,375,51,32,6,1,39
03/23/16,3,26,747,360,106,26,1,0,27
03/23/16,3,27,542,360,87,17,11,0,28
03/23/16,3,28,7625,375,96,21,1,3,25
03/24/16,1,2,972,315,141,11,3,4,18
03/24/16,1,3,996,200,38,14,6,7,27
03/24/16,1,4,5302,200,42,18,6,11,35
03/24/16,1,5,8030,400,163,0,3,1,4
03/24/16,1,6,3062,370,134,32,6,7,45
03/24/16,1,9,491,350,152,3,9,2,14
03/24/16,1,13,3062,400,116,6,26,0,32
03/24/16,1,14,8030,360,85,2,2,7,11
03/24/16,1,17,542,370,2,4,1,5,10
03/24/16,1,18,542,350,50,36,36,0,72
03/24/16,1,19,747,360,153,2,4,0,6
03/24/16,1,20,8040,350,88,12,14,9,35
03/24/16,1,22,542,350,70,38,7,0,45
03/24/16,1,23,542,350,87,15,8,0,23
03/24/16,1,25,542,375,55,41,4,0,45
03/24/16,1,26,747,360,154,7,2,0,9
03/24/16,1,27,542,360,74,18,10,0,28
03/24/16,1,28,7625,375,72,26,5,5,36
03/24/16,2,1,726,305,63,9,36,13,58
03/24/16,2,2,972,315,144,5,2,0,7
03/24/16,2,3,996,200,69,27,4,12,43
03/24/16,2,4,5302,200,67,35,3,10,48
03/24/16,2,5,8030,400,122,0,2,1,3
03/24/16,2,6,3062,370,123,20,11,9,40
03/24/16,2,9,491,350,158,3,4,0,7
03/24/16,2,11,7652,355,7,9,0,1,10
03/24/16,2,13,3062,400,18,0,13,0,13
03/24/16,2,14,8030,360,127,2,3,8,13
03/24/16,2,15,641,350,73,5,3,0,8
03/24/16,2,17,542,370,48,12,18,2,32
03/24/16,2,18,542,350,56,23,17,0,40
03/24/16,2,19,747,360,150,3,4,0,7
03/24/16,2,20,542,350,77,17,22,2,41
03/24/16,2,22,542,350,58,17,6,0,23
03/24/16,2,23,542,350,27,22,3,0,25
03/24/16,2,24,7625,360,16,3,0,2,5
03/24/16,2,25,542,375,59,18,11,0,29
03/24/16,2,26,747,360,136,5,8,0,13
03/24/16,2,27,542,360,38,30,2,0,32
03/24/16,2,28,7625,375,75,34,3,5,42
03/24/16,3,1,726,305,99,10,31,1,42
03/24/16,3,2,972,315,135,8,2,2,12
03/24/16,3,3,996,200,123,27,12,8,47
03/24/16,3,4,5302,200,87,37,3,8,48
03/24/16,3,6,3062,370,129,12,18,5,35
03/24/16,3,9,491,350,143,4,12,0,16
03/24/16,3,11,7652,355,84,7,36,5,48
03/24/16,3,14,8030,360,136,3,3,9,15
03/24/16,3,15,641,350,102,3,3,0,6
03/24/16,3,17,542,370,79,29,16,3,48
03/24/16,3,18,542,350,45,14,25,1,40
03/24/16,3,19,747,360,141,3,2,0,5
03/24/16,3,20,542,350,86,8,12,3,23
03/24/16,3,22,542,350,82,22,10,0,32
03/24/16,3,23,542,350,38,33,5,0,38
03/24/16,3,24,7625,360,71,13,3,6,22
03/24/16,3,25,542,375,69,19,5,0,24
03/24/16,3,26,747,360,73,4,4,0,8
03/24/16,3,27,542,360,42,13,6,0,19
03/24/16,3,28,7625,375,31,3,0,0,3
03/25/16,1,1,726,305,106,15,16,4,35
03/25/16,1,2,972,315,135,17,1,1,19
03/25/16,1,3,996,200,75,21,5,5,31
03/25/16,1,4,5302,200,3,37,0,8,45
03/25/16,1,5,8030,400,134,0,1,7,8
03/25/16,1,6,3062,370,147,16,10,7,33
03/25/16,1,7,7742,345,12,1,4,13,18
03/25/16,1,9,491,350,146,7,4,1,12
03/25/16,1,11,7652,355,106,12,22,3,37
03/25/16,1,14,8030,360,162,4,3,2,9
03/25/16,1,15,641,350,132,3,9,0,12
03/25/16,1,17,542,370,90,27,10,0,37
03/25/16,1,18,542,350,56,37,26,1,64
03/25/16,1,19,747,360,112,14,2,0,16
03/25/16,1,20,8040,350,77,4,18,11,33
03/25/16,1,22,542,350,59,11,12,0,23
03/25/16,1,23,542,350,74,44,4,0,48
03/25/16,1,24,7625,360,116,16,1,4,21
03/25/16,1,25,542,375,72,37,9,0,46
03/25/16,1,26,747,360,121,6,6,0,12
03/25/16,1,27,542,360,74,31,3,0,34
03/25/16,1,28,7625,375,51,14,7,2,23
03/25/16,2,1,726,305,111,12,19,2,33
03/25/16,2,2,972,315,107,32,4,2,38
03/25/16,2,3,996,200,112,45,8,9,62
03/25/16,2,4,5302,200,67,42,0,8,50
03/25/16,2,5,8030,400,155,0,4,0,4
03/25/16,2,6,3062,370,112,11,14,4,29
03/25/16,2,7,7742,345,69,4,31,6,41
03/25/16,2,9,491,350,156,2,7,0,9
03/25/16,2,14,8030,360,104,1,2,5,8
03/25/16,2,15,641,350,112,4,4,0,8
03/25/16,2,17,542,370,90,32,17,0,49
03/25/16,2,18,542,350,61,14,26,1,41
03/25/16,2,20,8040,350,77,11,13,3,27
03/25/16,2,21,775,350,21,18,2,0,20
03/25/16,2,22,542,350,82,22,9,0,31
03/25/16,2,23,542,350,82,23,3,0,26
03/25/16,2,24,7625,360,134,17,4,5,26
03/25/16,2,25,542,375,94,12,9,0,21
03/25/16,2,27,542,360,52,21,2,0,23
03/25/16,3,1,726,305,110,14,23,2,39
03/25/16,3,2,972,315,104,32,4,2,38
03/25/16,3,3,996,200,117,34,16,3,53
03/25/16,3,4,5302,200,26,79,1,4,84
03/25/16,3,5,8030,400,162,0,1,2,3
03/25/16,3,6,3062,370,117,24,19,5,48
03/25/16,3,7,7742,345,124,1,29,4,34
03/25/16,3,9,491,350,157,4,3,1,8
03/25/16,3,14,8030,360,161,0,2,2,4
03/25/16,3,15,641,350,112,4,4,0,8
03/25/16,3,17,542,370,68,26,11,2,39
03/25/16,3,18,542,350,77,16,11,0,27
03/25/16,3,21,775,350,38,24,5,1,30
03/25/16,3,22,542,350,77,16,8,1,25
03/25/16,3,23,542,350,91,28,5,0,33
03/25/16,3,24,7625,360,122,12,2,6,20
03/25/16,3,25,542,375,94,12,9,0,21
03/25/16,3,27,542,360,49,15,3,0,18
03/28/16,1,1,726,305,111,12,19,3,34
03/28/16,1,2,972,315,122,31,2,2,35
03/28/16,1,3,996,200,99,35,11,4,50
03/28/16,1,4,5302,200,72,50,1,10,61
03/28/16,1,5,8030,400,156,1,2,0,3
03/28/16,1,6,3062,370,113,31,27,7,65
03/28/16,1,7,7742,345,118,7,11,2,20
03/28/16,1,9,491,350,154,9,0,0,9
03/28/16,1,13,8035,400,116,6,26,0,32
03/28/16,1,15,641,350,117,1,13,0,14
03/28/16,1,17,542,370,82,16,20,3,39
03/28/16,1,21,775,350,16,11,2,0,13
03/28/16,1,22,542,350,86,20,16,0,36
03/28/16,1,23,542,350,94,22,5,0,27
03/28/16,1,24,7625,360,130,15,1,8,24
03/28/16,1,25,542,375,106,18,11,0,29
03/28/16,1,27,542,360,69,16,9,0,25
03/28/16,2,1,726,305,112,12,27,3,42
03/28/16,2,2,972,315,119,34,2,1,37
03/28/16,2,3,996,200,6,3,3,2,8
03/28/16,2,4,5302,200,97,39,2,7,48
03/28/16,2,5,8030,400,156,1,5,1,7
03/28/16,2,6,3062,370,7,0,7,1,8
03/28/16,2,7,7742,345,124,8,22,3,33
03/28/16,2,9,491,350,146,14,3,2,19
03/28/16,2,12,7652,350,101,6,14,2,22
03/28/16,2,15,641,350,105,2,10,0,12
03/28/16,2,17,542,370,89,21,18,0,39
03/28/16,2,18,542,350,67,44,12,0,56
03/28/16,2,22,542,350,62,10,16,0,26
03/28/16,2,23,542,350,83,26,7,1,34
03/28/16,2,24,7625,360,139,9,3,4,16
03/28/16,2,25,542,375,100,19,11,0,30
03/28/16,2,27,542,360,98,23,9,0,32
03/28/16,2,28,7625,375,78,6,2,6,14
03/28/16,3,1,726,305,105,12,23,0,35
03/28/16,3,2,972,315,107,28,1,2,31
03/28/16,3,3,996,200,73,36,33,9,78
03/28/16,3,4,5302,200,99,27,37,2,66
03/28/16,3,5,8030,400,164,2,0,0,2
03/28/16,3,7,7742,345,118,5,30,4,39
03/28/16,3,9,491,350,152,12,2,0,14
03/28/16,3,12,7652,350,87,12,34,5,51
03/28/16,3,15,641,350,46,1,3,0,4
03/28/16,3,17,542,370,91,39,15,4,58
03/28/16,3,18,542,350,82,65,6,0,71
03/28/16,3,22,542,350,123,19,18,0,37
03/28/16,3,23,542,350,99,32,5,0,37
03/28/16,3,24,7625,360,101,12,3,5,20
03/28/16,3,28,7625,375,118,9,5,3,17
03/29/16,1,1,726,305,93,13,12,5,30
03/29/16,1,2,972,315,119,35,0,0,35
03/29/16,1,3,996,200,80,22,39,5,66
03/29/16,1,4,5302,200,42,18,6,11,35
03/29/16,1,5,8030,400,153,0,7,3,10
03/29/16,1,6,3062,370,125,26,10,6,42
03/29/16,1,7,7742,345,136,10,12,4,26
03/29/16,1,9,491,350,60,4,12,2,18
03/29/16,1,12,7652,350,121,6,13,4,23
03/29/16,1,15,641,350,115,3,10,0,13
03/29/16,1,17,542,370,106,35,11,1,47
03/29/16,1,18,542,350,107,31,15,1,47
03/29/16,1,22,542,350,109,26,13,0,39
03/29/16,1,23,542,350,102,39,12,0,51
03/29/16,1,27,542,360,32,8,12,0,20
03/29/16,1,28,7625,375,102,6,15,7,28
03/29/16,2,1,726,305,93,15,16,1,32
03/29/16,2,2,972,315,108,39,1,2,42
03/29/16,2,3,996,200,57,28,14,2,44
03/29/16,2,4,5302,200,67,39,0,7,46
03/29/16,2,5,8030,400,165,1,1,0,2
03/29/16,2,6,3062,370,116,25,16,3,44
03/29/16,2,7,7742,345,118,8,17,5,30
03/29/16,2,12,7652,350,126,8,15,3,26
03/29/16,2,13,8003,400,4,15,1,8,24
03/29/16,2,14,8030,360,20,1,0,1,2
03/29/16,2,15,641,350,105,2,13,0,15
03/29/16,2,17,542,370,52,20,27,0,47
03/29/16,2,18,542,350,103,25,9,0,34
03/29/16,2,22,542,350,80,14,22,0,36
03/29/16,2,23,542,350,100,14,7,0,21
03/29/16,2,27,542,360,75,17,12,0,29
03/29/16,2,28,7625,375,130,10,3,8,21
03/29/16,3,1,726,305,101,20,21,2,43
03/29/16,3,2,972,315,104,47,0,1,48
03/29/16,3,3,996,200,69,16,42,5,63
03/29/16,3,4,5302,200,60,64,1,3,68
03/29/16,3,5,8030,400,163,5,0,1,6
03/29/16,3,6,3062,370,131,19,12,11,42
03/29/16,3,7,7742,345,73,16,17,3,36
03/29/16,3,12,7652,350,104,7,27,5,39
03/29/16,3,13,8003,400,110,15,9,13,37
03/29/16,3,14,8030,360,147,2,3,1,6
03/29/16,3,15,641,350,71,4,17,0,21
03/29/16,3,17,542,370,69,51,9,1,61
03/29/16,3,18,542,350,116,36,5,2,43
03/29/16,3,22,542,350,80,14,22,0,36
03/29/16,3,23,542,350,111,30,4,0,34
03/29/16,3,27,542,360,75,17,12,0,29
03/29/16,3,28,7625,375,111,27,1,4,32
03/30/16,1,1,726,305,103,16,24,6,46
03/30/16,1,2,972,315,77,12,18,3,33
03/30/16,1,3,996,300,70,43,28,6,77
03/30/16,1,4,5302,280,59,26,0,12,38
03/30/16,1,5,8030,400,162,2,2,1,5
03/30/16,1,6,3062,370,119,29,11,5,45
03/30/16,1,12,7652,350,103,7,21,6,34
03/30/16,1,13,8003,400,110,34,5,13,52
03/30/16,1,14,8030,360,169,1,0,1,2
03/30/16,1,15,641,350,108,4,9,0,13
03/30/16,1,17,542,370,108,13,17,1,31
03/30/16,1,18,542,350,114,20,14,1,35
03/30/16,1,20,8040,350,61,26,15,1,42
03/30/16,1,22,542,350,71,11,11,0,22
03/30/16,1,23,542,350,102,28,10,0,38
03/30/16,1,25,542,375,83,10,16,0,26
03/30/16,1,27,542,360,83,12,19,0,31
03/30/16,1,28,7625,375,136,10,4,6,20
03/30/16,2,1,726,305,115,15,21,2,38
03/30/16,2,3,996,300,61,41,33,1,75
03/30/16,2,4,5302,280,43,28,0,3,31
03/30/16,2,5,8030,400,159,7,0,3,10
03/30/16,2,6,3062,370,133,25,10,7,42
03/30/16,2,12,7652,350,126,8,14,3,25
03/30/16,2,13,8003,400,93,17,6,5,28
03/30/16,2,14,8030,360,144,6,2,3,11
03/30/16,2,15,641,350,91,4,7,0,11
03/30/16,2,17,542,370,102,15,12,0,27
03/30/16,2,18,542,350,62,13,21,0,34
03/30/16,2,20,8040,350,64,42,15,1,58
03/30/16,2,22,542,350,61,17,14,0,31
03/30/16,2,23,542,350,97,14,6,0,20
03/30/16,2,25,542,375,70,14,14,0,28
03/30/16,2,27,542,360,69,10,12,0,22
03/30/16,2,28,7625,375,132,9,2,0,11
03/30/16,2,29,737,270,38,15,10,0,25
03/30/16,3,1,726,305,109,11,23,3,37
03/30/16,3,3,996,300,72,48,29,7,84
03/30/16,3,4,5302,280,87,57,1,13,71
03/30/16,3,5,8030,400,153,6,2,2,10
03/30/16,3,6,3062,370,138,25,10,7,42
03/30/16,3,12,7652,350,125,10,16,6,32
03/30/16,3,13,8003,400,82,29,14,9,52
03/30/16,3,14,8030,360,163,4,5,0,9
03/30/16,3,15,641,350,59,3,12,0,15
03/30/16,3,17,542,370,72,16,14,0,30
03/30/16,3,18,542,350,78,20,15,8,43
03/30/16,3,20,8040,350,83,20,10,0,30
03/30/16,3,22,542,350,61,9,15,0,24
03/30/16,3,23,542,350,116,22,5,0,27
03/30/16,3,25,542,375,80,11,11,0,22
03/30/16,3,27,542,360,80,14,14,0,28
03/30/16,3,28,7625,375,23,1,0,1,2
03/30/16,3,29,737,270,73,20,12,0,32
03/31/16,1,1,726,305,96,21,21,0,42
03/31/16,1,3,996,300,75,28,35,2,65
03/31/16,1,4,5302,280,94,45,0,8,53
03/31/16,1,5,8030,400,161,5,0,1,6
03/31/16,1,6,3062,370,143,9,8,8,25
03/31/16,1,12,7652,350,105,20,12,2,34
03/31/16,1,13,8003,400,82,27,10,12,49
03/31/16,1,14,8030,360,157,6,5,1,12
03/31/16,1,17,542,370,114,16,8,4,28
03/31/16,1,18,542,350,93,23,4,0,27
03/31/16,1,20,8040,350,63,20,22,6,48
03/31/16,1,22,542,350,37,14,15,0,29
03/31/16,1,23,542,350,107,28,3,0,31
03/31/16,1,25,542,375,103,12,11,0,23
03/31/16,1,27,542,360,89,17,14,0,31
03/31/16,1,29,737,270,53,21,10,0,31
03/31/16,2,1,726,305,102,13,23,5,41
03/31/16,2,3,996,300,45,13,37,0,50
03/31/16,2,4,5302,280,73,37,0,1,38
03/31/16,2,5,8030,400,156,4,7,0,11
03/31/16,2,6,3062,370,134,5,15,5,25
03/31/16,2,12,7652,350,118,15,12,5,32
03/31/16,2,13,8003,400,69,48,8,13,69
03/31/16,2,14,8030,360,11,0,5,0,5
03/31/16,2,16,7742,350,32,16,11,10,37
03/31/16,2,17,542,370,115,18,3,3,24
03/31/16,2,20,8040,350,88,32,15,6,53
03/31/16,2,22,542,350,54,11,14,0,25
03/31/16,2,23,542,350,92,28,7,0,35
03/31/16,2,24,7625,360,102,11,5,2,18
03/31/16,2,25,542,375,89,12,12,0,24
03/31/16,2,27,542,360,82,14,13,0,27
03/31/16,2,29,737,270,52,22,18,0,40
03/31/16,3,1,726,305,114,11,15,4,30
03/31/16,3,3,996,300,69,29,33,0,62
03/31/16,3,4,5302,280,67,50,1,2,53
03/31/16,3,5,8030,400,160,3,22,1,26
03/31/16,3,6,3062,370,140,11,11,11,33
03/31/16,3,7,7742,345,91,21,9,4,34
03/31/16,3,10,exp,380,60,5,10,3,18
03/31/16,3,12,7652,350,126,14,11,1,26
03/31/16,3,13,8030,400,86,53,8,4,65
03/31/16,3,16,7742,350,74,42,8,3,53
03/31/16,3,17,542,370,87,16,11,1,28
03/31/16,3,20,8040,350,98,39,14,2,55
03/31/16,3,23,542,350,95,23,9,0,32
03/31/16,3,24,7625,360,136,7,3,5,15
03/31/16,3,25,542,375,72,17,6,0,23
03/31/16,3,27,542,360,62,17,12,0,29
03/31/16,3,29,737,270,36,11,4,0,15
04/01/16,1,1,726,305,108,16,19,0,35
04/01/16,1,3,996,300,77,33,27,5,65
04/01/16,1,4,5302,280,62,68,0,3,71
04/01/16,1,5,8030,400,158,3,3,0,6
04/01/16,1,6,3062,370,131,7,13,9,29
04/01/16,1,7,7742,345,127,15,11,2,28
04/01/16,1,10,exp,380,37,3,13,0,16
04/01/16,1,12,7652,350,105,17,16,8,41
04/01/16,1,13,8003,400,96,41,10,5,56
04/01/16,1,15,641,350,114,8,17,0,25
04/01/16,1,16,7742,350,91,20,11,6,37
04/01/16,1,17,542,370,58,24,15,2,41
04/01/16,1,20,8040,350,83,17,19,7,43
04/01/16,1,22,542,350,15,5,0,0,5
04/01/16,1,23,542,350,105,36,10,0,46
04/01/16,1,24,7625,360,135,14,3,7,24
04/01/16,1,25,542,375,69,23,16,0,39
04/01/16,1,27,542,360,74,23,16,0,39
04/01/16,1,29,737,270,52,23,8,0,31
04/01/16,2,1,726,305,99,9,17,1,27
04/01/16,2,2,972,315,66,18,33,7,58
04/01/16,2,3,996,300,65,14,22,4,40
04/01/16,2,4,5302,280,46,26,2,2,30
04/01/16,2,5,8030,400,139,2,1,4,7
04/01/16,2,6,3062,370,114,23,11,6,40
04/01/16,2,7,7742,345,90,26,6,1,33
04/01/16,2,12,7652,350,107,14,15,4,33
04/01/16,2,13,8003,400,51,31,6,1,38
04/01/16,2,15,641,350,131,1,3,0,4
04/01/16,2,16,7742,350,74,10,12,5,27
04/01/16,2,17,542,370,91,40,9,0,49
04/01/16,2,20,8040,350,85,30,19,2,51
04/01/16,2,23,542,350,86,28,5,0,33
04/01/16,2,24,7625,360,129,17,3,5,25
04/01/16,2,25,542,375,84,17,12,0,29
04/01/16,2,27,542,360,79,18,21,0,39
04/01/16,2,29,737,270,55,18,12,0,30
04/01/16,3,1,726,305,120,8,13,1,22
04/01/16,3,2,972,315,103,10,27,2,39
04/01/16,3,3,996,300,66,3,18,4,25
04/01/16,3,4,5302,280,75,34,0,7,41
04/01/16,3,5,8030,400,103,2,3,1,6
04/01/16,3,6,3062,370,138,19,9,13,41
04/01/16,3,7,7742,345,123,37,0,4,41
04/01/16,3,12,7652,350,123,13,23,2,38
04/01/16,3,13,8003,400,83,59,8,11,78
04/01/16,3,15,641,350,110,5,11,0,16
04/01/16,3,16,7742,350,86,25,11,8,44
04/01/16,3,17,542,370,74,21,10,5,36
04/01/16,3,20,8040,350,76,28,21,2,51
04/01/16,3,23,542,350,63,10,5,0,15
04/01/16,3,24,7625,360,71,13,2,1,16
04/01/16,3,25,542,375,63,24,9,0,33
04/01/16,3,27,542,360,82,24,9,0,33
04/01/16,3,29,737,270,71,12,8,0,20
04/04/16,1,1,726,305,101,23,16,5,44
04/04/16,1,2,738,315,94,12,30,10,52
04/04/16,1,3,996,300,5,3,2,1,6
04/04/16,1,4,5302,280,67,46,0,4,50
04/04/16,1,5,8030,400,154,2,1,2,5
04/04/16,1,6,3062,370,143,8,8,6,22
04/04/16,1,7,7742,345,130,21,6,4,31
04/04/16,1,12,7652,350,118,20,10,4,34
04/04/16,1,15,641,350,135,2,6,0,8
04/04/16,1,16,8032,350,96,40,9,3,52
04/04/16,1,17,542,370,81,31,19,1,51
04/04/16,1,19,747,360,21,1,7,0,8
04/04/16,1,20,8040,350,72,25,17,8,50
04/04/16,1,22,542,350,1,0,2,0,2
04/04/16,1,23,542,350,117,30,7,0,37
04/04/16,1,24,7625,360,108,10,1,6,17
04/04/16,1,25,542,375,94,26,15,0,41
04/04/16,1,27,542,360,77,28,19,0,47
04/04/16,1,29,737,270,61,18,12,0,30
04/04/16,2,1,726,305,97,22,24,2,48
04/04/16,2,2,738,315,97,17,31,1,49
04/04/16,2,3,996,300,88,32,22,6,60
04/04/16,2,4,5302,280,93,29,0,3,32
04/04/16,2,5,8030,400,158,1,4,0,5
04/04/16,2,6,3062,370,140,17,8,11,36
04/04/16,2,7,7742,345,134,17,12,3,32
04/04/16,2,8,781,350,64,10,7,3,20
04/04/16,2,12,7652,350,127,7,24,3,34
04/04/16,2,15,641,350,157,2,2,0,4
04/04/16,2,16,8032,350,127,30,7,2,39
04/04/16,2,17,542,370,92,20,11,0,31
04/04/16,2,19,747,360,83,3,9,0,12
04/04/16,2,20,8040,350,87,30,14,2,46
04/04/16,2,22,542,350,85,15,11,0,26
04/04/16,2,23,542,350,86,23,4,0,27
04/04/16,2,24,7625,360,120,10,2,5,17
04/04/16,2,25,542,375,75,30,6,1,37
04/04/16,2,27,542,360,70,17,15,0,32
04/04/16,2,29,737,270,59,21,11,0,32
04/04/16,3,1,726,305,105,19,22,0,41
04/04/16,3,2,738,315,100,30,35,4,69
04/04/16,3,3,996,300,46,9,42,3,54
04/04/16,3,4,5302,280,88,40,0,2,42
04/04/16,3,5,8030,400,16,1,0,1,2
04/04/16,3,6,3062,370,131,16,9,12,37
04/04/16,3,7,7742,345,143,19,9,3,31
04/04/16,3,8,781,350,85,17,17,0,34
04/04/16,3,12,7652,350,109,12,15,1,28
04/04/16,3,15,641,350,149,0,4,0,4
04/04/16,3,16,8032,350,110,11,4,3,18
04/04/16,3,17,542,370,41,12,10,1,23
04/04/16,3,19,747,360,87,5,4,0,9
04/04/16,3,20,8040,350,61,8,19,5,32
04/04/16,3,22,542,350,45,18,2,0,20
04/04/16,3,23,542,350,101,18,3,0,21
04/04/16,3,24,7625,360,101,11,1,6,18
04/04/16,3,25,542,375,48,7,11,0,18
04/04/16,3,27,542,360,73,18,14,0,32
04/04/16,3,29,737,270,44,17,9,2,28
04/05/16,1,1,726,305,97,11,12,2,25
04/05/16,1,2,738,315,91,14,34,9,57
04/05/16,1,3,996,300,76,20,35,3,58
04/05/16,1,4,5302,280,81,53,1,8,62
04/05/16,1,7,7742,345,102,8,8,5,21
04/05/16,1,8,781,350,83,14,12,2,28
04/05/16,1,11,7652,355,122,18,16,4,38
04/05/16,1,14,8030,360,152,1,5,0,6
04/05/16,1,15,641,350,102,19,6,6,31
04/05/16,1,16,8032,350,94,13,15,3,31
04/05/16,1,17,542,370,16,8,1,1,10
04/05/16,1,18,542,350,77,27,2,0,29
04/05/16,1,19,485,360,69,9,29,5,43
04/05/16,1,21,775,350,90,26,8,0,34
04/05/16,1,22,542,350,110,36,11,1,48
04/05/16,1,23,542,350,143,8,2,8,18
04/05/16,1,24,7625,360,84,30,13,0,43
04/05/16,1,26,747,360,71,22,14,0,36
04/05/16,1,28,7625,375,53,21,18,0,39
04/05/16,1,29,737,270,53,21,18,0,39
04/05/16,2,1,726,305,103,8,17,2,27
04/05/16,2,2,738,315,86,5,29,0,34
04/05/16,2,3,996,300,74,8,31,2,41
04/05/16,2,4,5302,280,92,27,1,7,35
04/05/16,2,7,7742,345,102,21,10,2,33
04/05/16,2,8,781,350,101,12,22,2,36
04/05/16,2,12,7652,350,113,20,16,4,40
04/05/16,2,15,641,350,128,11,6,0,17
04/05/16,2,16,8032,350,119,30,2,6,38
04/05/16,2,17,542,370,113,26,2,1,29
04/05/16,2,18,542,350,94,26,4,3,33
04/05/16,2,19,485,360,131,21,4,0,25
04/05/16,2,20,8040,350,88,17,19,2,38
04/05/16,2,22,542,350,64,21,10,0,31
04/05/16,2,23,542,350,82,32,2,1,35
04/05/16,2,24,7625,360,127,10,5,4,19
04/05/16,2,25,542,375,59,11,9,0,20
04/05/16,2,27,542,360,55,15,10,0,25
04/05/16,2,29,737,270,74,20,10,0,30
04/05/16,3,1,726,305,113,12,19,3,34
04/05/16,3,2,738,315,109,16,26,2,44
04/05/16,3,3,996,300,79,6,45,6,57
04/05/16,3,4,5302,280,75,25,2,10,37
04/05/16,3,7,7742,345,128,8,9,3,20
04/05/16,3,8,781,350,107,7,26,1,34
04/05/16,3,12,7652,350,106,21,9,1,31
04/05/16,3,15,641,350,92,8,7,0,15
04/05/16,3,16,8032,350,113,24,4,2,30
04/05/16,3,17,542,370,80,21,4,0,25
04/05/16,3,18,542,350,59,21,11,0,32
04/05/16,3,19,485,360,139,8,3,0,11
04/05/16,3,20,8040,350,78,14,25,1,40
04/05/16,3,22,542,350,64,15,10,0,25
04/05/16,3,23,542,350,95,17,7,0,24
04/05/16,3,24,7625,360,67,4,2,4,10
04/05/16,3,25,542,375,50,13,11,0,24
04/05/16,3,27,542,360,73,18,14,0,32
04/05/16,3,29,737,270,74,19,11,1,31
04/06/16,1,1,726,305,86,18,19,1,38
04/06/16,1,2,738,315,93,21,25,1,47
04/06/16,1,3,996,300,74,19,37,2,58
04/06/16,1,4,5302,280,79,2,32,3,37
04/06/16,1,5,8030,400,106,2,6,5,13
04/06/16,1,7,7742,345,115,12,6,3,21
04/06/16,1,8,exp,350,87,7,15,1,23
04/06/16,1,9,8035,350,6,16,2,1,19
04/06/16,1,11,7652,355,54,4,41,11,56
04/06/16,1,13,7740,400,16,6,2,0,8
04/06/16,1,15,641,350,177,9,17,0,26
04/06/16,1,16,8032,350,92,22,6,0,28
04/06/16,1,17,542,370,97,28,12,2,42
04/06/16,1,18,542,350,111,32,8,0,40
04/06/16,1,19,747,360,138,12,21,9,42
04/06/16,1,20,8040,350,87,12,21,9,42
04/06/16,1,21,642,350,103,20,2,0,22
04/06/16,1,22,542,350,91,16,9,0,25
04/06/16,1,23,542,350,114,26,8,0,34
04/06/16,1,25,542,375,89,25,15,0,40
04/06/16,1,27,542,360,71,22,14,0,36
04/06/16,1,29,737,270,48,22,10,0,32
04/06/16,2,1,726,305,108,9,18,1,28
04/06/16,2,2,738,315,112,33,15,1,49
04/06/16,2,3,996,300,67,18,27,3,48
04/06/16,2,4,5302,280,80,1,31,5,37
04/06/16,2,5,8030,400,116,1,11,3,15
04/06/16,2,7,7742,345,137,5,7,1,13
04/06/16,2,8,exp,350,92,16,12,0,28
04/06/16,2,9,8035,350,48,6,18,5,29
04/06/16,2,11,7652,355,85,6,19,0,25
04/06/16,2,13,7740,400,85,11,8,0,19
04/06/16,2,15,641,350,137,3,11,0,14
04/06/16,2,16,8032,350,140,11,4,3,18
04/06/16,2,17,542,370,98,41,9,0,50
04/06/16,2,18,542,350,112,19,10,1,30
04/06/16,2,19,747,360,139,15,2,0,17
04/06/16,2,20,8040,350,80,24,17,2,43
04/06/16,2,21,642,350,130,13,5,0,18
04/06/16,2,22,542,350,94,12,15,0,27
04/06/16,2,23,542,350,66,23,9,0,32
04/06/16,2,25,542,375,71,25,9,0,34
04/06/16,2,27,542,360,60,16,10,0,26
04/06/16,2,29,737,270,77,19,8,0,27
04/06/16,3,1,726,305,102,25,15,3,43
04/06/16,3,2,738,315,72,27,17,4,48
04/06/16,3,3,996,300,70,7,27,5,39
04/06/16,3,4,5302,280,57,19,2,7,28
04/06/16,3,5,8030,400,144,4,8,1,13
04/06/16,3,7,7742,345,138,10,9,2,21
04/06/16,3,8,exp,350,102,15,17,1,33
04/06/16,3,9,8035,350,78,11,32,7,50
04/06/16,3,11,7652,355,88,2,33,3,38
04/06/16,3,13,7740,400,121,17,11,2,30
04/06/16,3,15,641,350,177,9,17,0,26
04/06/16,3,16,8032,350,116,10,5,3,18
04/06/16,3,17,542,370,90,27,8,0,35
04/06/16,3,18,542,350,119,6,11,2,19
04/06/16,3,19,747,360,151,5,3,0,8
04/06/16,3,21,642,350,107,29,3,0,32
04/06/16,3,22,542,350,62,29,11,0,40
04/06/16,3,23,542,350,83,28,6,0,34
04/06/16,3,25,542,375,50,27,9,0,36
04/06/16,3,27,542,360,73,18,14,0,32
04/06/16,3,29,737,270,82,20,7,0,27
04/07/16,1,1,726,305,86,24,18,2,44
04/07/16,1,2,738,315,82,28,17,1,46
04/07/16,1,3,996,300,52,15,29,1,45
04/07/16,1,4,5302,280,90,30,0,0,30
04/07/16,1,5,8030,400,141,3,6,1,10
04/07/16,1,7,7742,345,116,6,4,2,12
04/07/16,1,8,715,350,95,8,12,1,21
04/07/16,1,9,8035,350,113,4,9,0,13
04/07/16,1,11,7652,355,78,35,16,3,54
04/07/16,1,13,7740,400,94,5,12,6,23
04/07/16,1,14,8030,360,120,1,12,3,16
04/07/16,1,16,7742,350,115,9,4,2,15
04/07/16,1,18,542,350,81,62,11,0,73
04/07/16,1,19,747,360,120,18,12,0,30
04/07/16,1,21,642,350,127,22,2,0,24
04/07/16,1,22,542,350,69,34,9,0,43
04/07/16,1,23,542,350,116,69,6,0,75
04/07/16,1,24,7625,360,89,5,4,7,16
04/07/16,1,25,542,375,75,31,10,0,41
04/07/16,1,27,542,360,36,6,7,0,13
04/07/16,1,29,737,270,61,11,3,0,14
04/07/16,2,1,726,305,82,12,24,0,36
04/07/16,2,2,738,315,86,25,17,0,42
04/07/16,2,3,996,300,81,10,31,0,41
04/07/16,2,4,5302,280,63,29,0,0,29
04/07/16,2,5,8030,400,123,1,12,0,13
04/07/16,2,7,7742,345,141,12,3,0,15
04/07/16,2,8,715,350,74,6,11,0,17
04/07/16,2,9,8035,350,135,2,8,0,10
04/07/16,2,10,715,380,117,8,11,0,19
04/07/16,2,11,7652,355,98,26,2,0,28
04/07/16,2,13,7740,400,43,5,9,0,14
04/07/16,2,14,8030,360,158,0,2,0,2
04/07/16,2,16,7742,350,113,13,8,0,21
04/07/16,2,18,542,350,60,54,6,0,60
04/07/16,2,19,747,360,120,19,13,0,32
04/07/16,2,21,642,350,100,13,0,0,13
04/07/16,2,22,542,350,70,25,10,0,35
04/07/16,2,23,542,350,34,10,5,0,15
04/07/16,2,24,7625,360,136,8,1,0,9
04/07/16,2,25,542,375,72,12,36,0,48
04/07/16,2,27,542,360,77,10,12,0,22
04/07/16,2,29,737,270,49,10,1,0,11
04/07/16,3,1,726,305,91,36,16,2,54
04/07/16,3,2,738,315,86,26,18,1,45
04/07/16,3,3,996,300,83,3,26,4,33
04/07/16,3,4,5302,280,54,31,2,12,45
04/07/16,3,5,8030,400,160,2,4,0,6
04/07/16,3,7,7742,345,118,15,11,2,28
04/07/16,3,8,715,350,108,5,16,1,22
04/07/16,3,9,8035,350,143,3,6,1,10
04/07/16,3,10,715,380,130,4,8,2,14
04/07/16,3,11,7652,355,111,15,13,3,31
04/07/16,3,13,7740,400,78,16,10,3,29
04/07/16,3,14,8030,360,150,6,2,2,10
04/07/16,3,16,7742,350,106,13,5,4,22
04/07/16,3,18,542,350,54,37,5,1,43
04/07/16,3,19,747,360,160,3,1,0,4
04/07/16,3,21,642,350,102,1,1,0,2
04/07/16,3,22,542,350,69,31,8,0,39
04/07/16,3,23,542,350,64,32,2,0,34
04/07/16,3,24,7625,360,118,13,1,3,17
04/07/16,3,25,542,375,42,29,6,0,35
04/07/16,3,27,542,360,109,11,10,0,21
04/07/16,3,29,737,270,83,10,2,0,12
04/08/16,1,1,726,305,74,17,14,0,31
04/08/16,1,2,738,315,67,25,23,3,51
04/08/16,1,3,996,300,35,13,17,1,31
04/08/16,1,4,5302,280,72,23,3,3,29
04/08/16,1,5,8030,400,138,2,4,0,6
04/08/16,1,7,7742,345,96,20,13,3,36
04/08/16,1,8,715,350,54,5,7,1,13
04/08/16,1,9,8035,350,147,3,7,0,10
04/08/16,1,10,715,380,160,1,6,0,7
04/08/16,1,11,7652,355,112,21,2,2,25
04/08/16,1,13,7740,400,129,11,6,7,24
04/08/16,1,14,8030,360,99,1,2,0,3
04/08/16,1,15,641,350,29,4,3,0,7
04/08/16,1,16,7742,350,92,11,7,6,24
04/08/16,1,17,542,370,30,34,3,2,39
04/08/16,1,18,542,350,68,68,7,1,76
04/08/16,1,19,747,360,106,7,6,0,13
04/08/16,1,21,642,350,136,9,6,0,15
04/08/16,1,22,542,350,57,38,11,0,49
04/08/16,1,23,542,350,63,29,10,0,39
04/08/16,1,24,7625,360,144,10,0,8,18
04/08/16,1,25,542,375,65,30,4,0,34
04/08/16,1,27,542,360,57,4,17,0,21
04/08/16,1,29,737,270,84,0,0,0,0
04/08/16,2,1,726,305,96,13,15,3,31
04/08/16,2,2,738,315,65,20,20,4,44
04/08/16,2,4,5302,280,64,21,0,3,24
04/08/16,2,5,8030,400,140,0,3,2,5
04/08/16,2,7,7742,345,143,9,3,1,13
04/08/16,2,8,715,350,96,13,13,0,26
04/08/16,2,9,8035,350,104,1,15,2,18
04/08/16,2,10,715,380,129,7,6,2,15
04/08/16,2,11,7652,355,70,16,8,1,25
04/08/16,2,13,7740,400,101,11,13,6,30
04/08/16,2,14,8030,360,153,1,5,2,8
04/08/16,2,15,641,350,96,18,6,0,24
04/08/16,2,16,7742,350,127,13,7,2,22
04/08/16,2,17,542,370,78,21,9,3,33
04/08/16,2,18,542,350,65,24,14,0,38
04/08/16,2,19,747,360,65,4,1,0,5
04/08/16,2,21,642,350,130,16,1,0,17
04/08/16,2,22,542,350,33,27,4,0,31
04/08/16,2,23,542,350,40,27,2,0,29
04/08/16,2,24,7625,360,117,12,0,5,17
04/08/16,2,25,542,375,32,21,3,0,24
04/08/16,2,27,542,360,66,6,15,0,21
04/08/16,2,29,737,270,74,0,0,0,0
04/08/16,3,1,726,305,94,21,16,8,45
04/08/16,3,2,738,315,90,28,30,7,65
04/08/16,3,4,5302,280,96,19,2,7,28
04/08/16,3,5,8030,400,150,1,7,1,9
04/08/16,3,7,7742,345,127,12,12,2,26
04/08/16,3,8,715,350,97,17,16,2,35
04/08/16,3,9,8035,350,141,1,9,4,14
04/08/16,3,10,715,380,138,10,21,3,34
04/08/16,3,13,7740,400,107,19,7,4,30
04/08/16,3,14,8030,360,163,2,8,2,12
04/11/16,1,1,726,305,92,16,23,3,42
04/11/16,1,2,738,315,67,27,23,24,74
04/11/16,1,3,996,300,52,46,11,6,63
04/11/16,1,4,5302,280,85,16,1,7,24
04/11/16,1,5,8030,400,155,1,2,1,4
04/11/16,1,7,7742,345,108,29,6,3,38
04/11/16,1,9,8035,350,131,2,9,1,12
04/11/16,1,10,715,380,82,5,8,1,14
04/11/16,1,11,7652,355,4,1,0,5,6
04/11/16,1,14,8030,360,151,2,5,1,8
04/11/16,1,15,641,350,54,36,0,0,36
04/11/16,1,16,8032,350,113,9,5,6,20
04/11/16,1,17,542,370,76,32,6,6,44
04/11/16,1,18,542,350,104,33,12,5,50
04/11/16,1,20,8040,350,2,3,2,3,8
04/11/16,1,21,642,350,109,19,2,0,21
04/11/16,1,22,542,350,53,58,4,0,62
04/11/16,1,23,542,350,44,25,16,0,41
04/11/16,1,24,7625,360,131,13,1,4,18
04/11/16,1,25,542,375,30,10,4,0,14
04/11/16,1,27,542,360,36,3,13,0,16
04/11/16,1,29,737,270,38,21,10,0,31
04/11/16,2,1,726,305,78,10,21,7,38
04/11/16,2,2,738,315,55,18,11,2,31
04/11/16,2,3,996,300,95,19,12,2,33
04/11/16,2,4,5302,280,63,25,0,1,26
04/11/16,2,5,8030,400,166,0,1,0,1
04/11/16,2,7,7742,345,134,13,5,3,21
04/11/16,2,9,8035,350,154,1,6,0,7
04/11/16,2,10,715,380,162,3,5,1,9
04/11/16,2,11,7652,355,75,14,12,5,31
04/11/16,2,12,542,350,54,27,11,5,43
04/11/16,2,14,8030,360,136,4,6,1,11
04/11/16,2,15,641,350,57,55,5,0,60
04/11/16,2,16,8032,350,100,35,4,3,42
04/11/16,2,17,542,370,106,29,9,1,39
04/11/16,2,18,542,350,103,32,6,0,38
04/11/16,2,20,8040,350,92,29,20,1,50
04/11/16,2,21,642,350,130,23,1,0,24
04/11/16,2,22,542,350,46,51,5,0,56
04/11/16,2,24,7625,360,125,9,2,3,14
04/11/16,2,29,737,270,84,18,8,0,26
04/11/16,3,1,726,305,99,19,17,0,36
04/11/16,3,2,738,315,95,21,17,3,41
04/11/16,3,3,996,300,109,7,15,5,27
04/11/16,3,4,5302,280,68,17,8,1,26
04/11/16,3,5,8030,400,152,0,2,5,7
04/11/16,3,7,7742,345,107,55,6,4,65
04/11/16,3,9,8035,350,156,2,9,1,12
04/11/16,3,10,715,380,156,5,9,1,15
04/11/16,3,11,7652,355,138,5,15,3,23
04/11/16,3,12,542,350,20,2,4,3,9
04/11/16,3,14,8030,360,141,1,7,3,11
04/11/16,3,15,641,350,31,30,1,0,31
04/11/16,3,16,8032,350,74,13,2,2,17
04/11/16,3,17,542,370,80,7,5,2,14
04/11/16,3,18,542,350,62,29,1,1,31
04/11/16,3,20,8040,350,56,17,6,4,27
04/11/16,3,21,642,350,52,14,2,0,16
04/11/16,3,22,542,350,34,14,3,0,17
04/11/16,3,24,7625,360,84,6,0,5,11
04/11/16,3,25,542,375,9,0,3,0,3
04/11/16,3,29,737,270,47,6,3,0,9
04/12/16,1,1,726,305,81,10,28,4,42
04/12/16,1,2,738,315,95,30,20,2,52
04/12/16,1,3,996,300,98,11,16,0,27
04/12/16,1,4,5302,280,88,36,0,1,37
04/12/16,1,5,8030,400,145,1,6,0,7
04/12/16,1,7,7742,345,95,37,7,2,46
04/12/16,1,9,8035,350,133,3,9,2,14
04/12/16,1,10,715,380,150,17,6,0,23
04/12/16,1,11,7652,355,139,3,12,3,18
04/12/16,1,12,542,350,77,38,13,4,55
04/12/16,1,13,7740,400,4,4,5,2,11
04/12/16,1,14,8030,360,141,3,12,0,15
04/12/16,1,15,641,350,112,9,6,0,15
04/12/16,1,16,8032,350,145,7,7,7,21
04/12/16,1,17,542,370,128,19,7,4,30
04/12/16,1,18,542,350,110,34,6,0,40
04/12/16,1,19,485,360,82,2,3,0,5
04/12/16,1,20,8040,350,89,23,19,2,44
04/12/16,1,21,642,350,138,4,2,0,6
04/12/16,1,22,542,350,37,35,2,0,37
04/12/16,1,23,542,350,55,12,6,0,18
04/12/16,1,24,7625,360,123,10,0,6,16
04/12/16,1,25,542,375,111,10,8,0,18
04/12/16,1,29,737,270,67,15,10,0,25
04/12/16,2,1,726,305,106,7,14,1,22
04/12/16,2,2,738,315,83,16,14,3,33
04/12/16,2,3,996,300,92,10,12,1,23
04/12/16,2,4,5302,280,81,29,1,4,34
04/12/16,2,5,8030,400,157,1,2,1,4
04/12/16,2,7,7742,345,102,28,5,2,35
04/12/16,2,8,715,350,19,2,3,13,18
04/12/16,2,9,8035,350,154,2,6,0,8
04/12/16,2,10,715,380,151,3,5,0,8
04/12/16,2,11,7652,355,134,5,10,1,16
04/12/16,2,12,542,350,46,24,10,2,36
04/12/16,2,13,7740,400,59,9,12,1,22
04/12/16,2,14,8030,360,117,3,3,0,6
04/12/16,2,15,641,350,125,0,8,0,8
04/12/16,2,16,8032,350,97,28,5,2,35
04/12/16,2,17,542,370,123,12,6,1,19
04/12/16,2,18,542,350,43,67,4,2,73
04/12/16,2,19,485,360,115,7,2,0,9
04/12/16,2,20,8040,350,71,17,21,0,38
04/12/16,2,21,642,350,124,5,2,0,7
04/12/16,2,22,542,350,60,24,11,0,35
04/12/16,2,23,542,350,49,31,1,0,32
04/12/16,2,24,7625,360,114,16,2,5,23
04/12/16,2,25,542,375,80,20,9,0,29
04/12/16,2,29,737,270,44,23,12,0,35
04/12/16,3,1,726,305,105,9,29,1,39
04/12/16,3,2,738,315,92,16,15,1,32
04/12/16,3,3,996,300,89,14,15,5,34
04/12/16,3,4,5302,280,85,36,2,4,42
04/12/16,3,5,8030,400,154,1,5,1,7
04/12/16,3,7,7742,345,137,17,9,3,29
04/12/16,3,8,715,350,158,0,6,2,8
04/12/16,3,9,8035,350,151,0,8,3,11
04/12/16,3,10,715,380,159,7,8,1,16
04/12/16,3,11,7652,355,53,3,18,0,21
04/12/16,3,12,542,350,95,23,10,1,34
04/12/16,3,13,7740,400,114,14,11,5,30
04/12/16,3,14,8030,360,161,3,4,1,8
04/12/16,3,15,641,350,129,4,3,0,7
04/12/16,3,16,8032,350,36,22,19,33,74
04/12/16,3,17,542,370,94,13,5,3,21
04/12/16,3,18,542,350,45,45,2,1,48
04/12/16,3,19,485,360,114,7,3,0,10
04/12/16,3,20,8040,350,43,4,26,8,38
04/12/16,3,21,642,350,122,2,2,0,4
04/12/16,3,22,542,350,69,6,8,0,14
04/12/16,3,23,542,350,56,17,2,0,19
04/12/16,3,25,542,375,82,9,2,0,11
04/12/16,3,27,542,360,54,7,5,0,12
04/12/16,3,29,737,270,54,20,11,0,31
04/13/16,1,1,726,305,106,6,25,4,35
04/13/16,1,2,738,315,112,19,13,3,35
04/13/16,1,3,996,300,5,1,3,1,5
04/13/16,1,4,5302,280,65,28,0,7,35
04/13/16,1,5,8030,400,160,0,4,1,5
04/13/16,1,7,7742,345,138,22,3,4,29
04/13/16,1,8,715,350,140,2,4,2,8
04/13/16,1,9,8035,350,129,10,1,1,12
04/13/16,1,10,715,380,154,7,13,1,21
04/13/16,1,12,542,350,111,25,11,1,37
04/13/16,1,13,7740,400,104,10,7,4,21
04/13/16,1,14,8030,360,145,4,6,0,10
04/13/16,1,15,641,350,159,4,7,0,11
04/13/16,1,16,8032,350,94,30,18,12,60
04/13/16,1,17,542,370,118,17,8,1,26
04/13/16,1,18,542,350,99,51,4,3,58
04/13/16,1,19,485,360,123,11,8,0,19
04/13/16,1,20,8040,350,42,32,16,3,51
04/13/16,1,21,642,350,39,0,5,0,5
04/13/16,1,22,542,350,88,15,14,0,29
04/13/16,1,23,542,350,85,17,10,0,27
04/13/16,1,25,542,375,93,23,2,0,25
04/13/16,1,27,542,360,102,18,3,0,21
04/13/16,1,29,737,270,56,21,15,0,36
04/13/16,2,1,726,305,103,2,24,2,28
04/13/16,2,2,738,315,75,23,16,1,40
04/13/16,2,3,996,300,91,15,16,1,32
04/13/16,2,4,5302,280,92,19,0,4,23
04/13/16,2,5,8030,400,165,1,0,0,1
04/13/16,2,7,7742,345,128,14,8,2,24
04/13/16,2,8,715,350,160,1,1,0,2
04/13/16,2,9,8035,350,15,0,9,1,10
04/13/16,2,10,715,380,169,6,3,1,10
04/13/16,2,11,7652,355,17,1,2,0,3
04/13/16,2,12,542,350,108,14,12,2,28
04/13/16,2,13,7740,400,93,8,10,4,22
04/13/16,2,14,8030,360,158,2,4,1,7
04/13/16,2,15,641,350,137,10,8,0,18
04/13/16,2,16,8032,350,113,20,5,4,29
04/13/16,2,17,542,370,132,11,9,2,22
04/13/16,2,18,542,350,69,53,7,1,61
04/13/16,2,19,485,360,129,13,3,0,16
04/13/16,2,20,8040,350,75,18,16,0,34
04/13/16,2,22,542,350,82,26,16,0,42
04/13/16,2,23,542,350,92,27,6,0,33
04/13/16,2,25,542,375,92,16,11,0,27
04/13/16,2,27,542,360,127,6,11,0,17
04/13/16,2,29,737,270,16,0,0,0,0
04/13/16,3,1,726,305,92,13,32,2,47
04/13/16,3,2,738,315,109,22,25,3,50
04/13/16,3,3,996,300,106,21,8,5,34
04/13/16,3,4,5302,280,86,34,1,12,47
04/13/16,3,5,8030,400,162,0,0,1,1
04/13/16,3,7,7742,345,120,13,11,4,28
04/13/16,3,8,715,350,148,2,4,3,9
04/13/16,3,10,715,380,147,5,12,0,17
04/13/16,3,11,7652,355,37,12,56,27,95
04/13/16,3,12,542,350,116,10,15,0,25
04/13/16,3,13,7740,400,97,13,25,6,44
04/13/16,3,14,8030,360,167,2,2,0,4
04/13/16,3,15,641,350,134,4,7,0,11
04/13/16,3,16,8032,350,66,7,4,1,12
04/13/16,3,17,542,370,82,3,4,1,8
04/13/16,3,18,542,350,62,24,4,1,29
04/13/16,3,19,485,360,78,12,0,0,12
04/13/16,3,20,8040,350,38,15,12,1,28
04/13/16,3,22,542,350,38,10,11,0,21
04/13/16,3,23,542,350,45,22,5,0,27
04/13/16,3,25,542,375,60,7,8,0,15
04/13/16,3,27,542,360,64,4,6,0,10
04/13/16,3,28,8032,375,33,4,12,3,19
04/14/16,1,1,726,305,102,14,22,2,38
04/14/16,1,2,738,315,98,21,20,3,44
04/14/16,1,3,996,300,111,13,7,2,22
04/14/16,1,4,5302,280,99,29,1,4,34
04/14/16,1,5,8030,400,159,0,4,0,4
04/14/16,1,7,7742,345,104,30,8,0,38
04/14/16,1,8,715,350,151,1,3,4,8
04/14/16,1,9,8035,350,26,0,3,4,7
04/14/16,1,10,715,380,163,5,6,0,11
04/14/16,1,11,7652,355,105,22,14,3,39
04/14/16,1,12,542,350,127,20,13,3,36
04/14/16,1,13,7740,348,96,8,15,4,27
04/14/16,1,14,8030,360,160,2,4,2,8
04/14/16,1,15,641,350,145,5,13,0,18
04/14/16,1,16,8032,350,140,18,7,4,29
04/14/16,1,17,542,370,117,13,17,4,34
04/14/16,1,18,542,350,102,24,18,3,45
04/14/16,1,19,485,360,111,23,5,0,28
04/14/16,1,20,8040,350,67,12,22,1,35
04/14/16,1,22,542,350,66,14,16,0,30
04/14/16,1,23,542,350,94,26,8,0,34
04/14/16,1,25,542,375,84,15,14,0,29
04/14/16,1,27,542,360,110,10,17,0,27
04/14/16,1,28,8032,375,79,13,19,1,33
04/14/16,1,29,737,270,29,5,6,0,11
04/14/16,2,1,726,305,119,3,15,3,21
04/14/16,2,2,738,315,87,27,15,2,44
04/14/16,2,3,996,300,94,10,11,4,25
04/14/16,2,4,5302,280,88,25,0,3,28
04/14/16,2,5,8030,400,145,0,2,1,3
04/14/16,2,7,7742,345,134,15,2,2,19
04/14/16,2,8,715,350,151,0,6,1,7
04/14/16,2,9,8035,350,114,4,18,3,25
04/14/16,2,10,715,380,160,4,4,0,8
04/14/16,2,11,7652,355,108,20,11,2,33
04/14/16,2,12,542,350,109,15,9,2,26
04/14/16,2,13,7740,348,111,8,3,4,15
04/14/16,2,14,8030,360,135,0,10,0,10
04/14/16,2,15,641,350,147,4,3,0,7
04/14/16,2,16,8032,350,123,10,5,4,19
04/14/16,2,17,542,370,131,7,9,2,18
04/14/16,2,18,542,350,112,23,4,2,29
04/14/16,2,19,485,360,110,20,3,0,23
04/14/16,2,20,8040,350,48,17,22,0,39
04/14/16,2,22,542,350,68,15,11,0,26
04/14/16,2,23,542,350,78,24,5,0,29
04/14/16,2,25,542,375,79,18,5,0,23
04/14/16,2,27,542,360,112,10,12,0,22
04/14/16,2,28,8032,375,98,7,18,0,25
04/14/16,2,29,737,270,66,12,10,0,22
04/14/16,3,1,726,305,115,8,19,4,31
04/14/16,3,2,738,315,101,31,21,1,53
04/14/16,3,3,996,300,107,16,11,1,28
04/14/16,3,4,5302,280,102,19,3,8,30
04/14/16,3,5,8030,400,157,2,3,1,6
04/14/16,3,7,7742,345,9,0,1,1,2
04/14/16,3,8,715,350,157,0,0,1,1
04/14/16,3,9,8035,350,107,0,8,4,12
04/14/16,3,10,715,380,169,6,4,0,10
04/14/16,3,11,7652,355,128,15,20,5,40
04/14/16,3,12,542,350,148,16,5,0,21
04/14/16,3,13,7740,348,12,1,1,0,2
04/14/16,3,14,8030,360,152,3,3,1,7
04/14/16,3,15,641,350,98,4,9,0,13
04/14/16,3,16,8032,350,99,14,3,2,19
04/14/16,3,17,542,370,107,5,2,2,9
04/14/16,3,18,542,350,85,28,2,2,32
04/14/16,3,19,485,360,93,5,5,0,10
04/14/16,3,20,8040,350,55,12,12,1,25
04/14/16,3,22,542,350,54,18,8,0,26
04/14/16,3,23,542,350,63,21,4,0,25
04/14/16,3,25,542,375,48,13,7,0,20
04/14/16,3,27,542,360,109,6,7,0,13
04/14/16,3,28,8032,375,90,4,10,3,17
04/14/16,3,29,737,270,59,11,10,1,22
04/15/16,1,1,726,305,95,12,24,2,38
04/15/16,1,2,738,315,30,38,5,4,47
04/15/16,1,3,996,300,85,12,6,2,20
04/15/16,1,4,5302,280,89,26,0,4,30
04/15/16,1,5,8030,400,66,3,5,2,10
04/15/16,1,7,7742,345,59,6,6,8,20
04/15/16,1,8,715,350,122,1,8,1,10
04/15/16,1,10,715,380,156,10,4,2,16
04/15/16,1,11,7652,355,104,27,16,2,45
04/15/16,1,12,542,350,120,27,8,1,36
04/15/16,1,13,7740,348,35,4,2,5,11
04/15/16,1,14,8030,360,105,4,3,0,7
04/15/16,1,15,641,350,150,6,5,0,11
04/15/16,1,16,8032,350,137,14,6,7,27
04/15/16,1,17,542,370,103,18,7,3,28
04/15/16,1,18,542,350,108,40,8,1,49
04/15/16,1,19,485,360,135,9,3,0,12
04/15/16,1,20,8040,350,79,15,20,5,40
04/15/16,1,22,542,350,57,15,19,0,34
04/15/16,1,23,542,350,109,28,2,0,30
04/15/16,1,24,7625,360,106,15,12,7,34
04/15/16,1,25,542,375,108,20,5,0,25
04/15/16,1,27,542,360,136,14,15,0,29
04/15/16,1,28,8032,375,73,1,10,4,15
04/15/16,1,29,737,270,62,18,21,0,39
04/15/16,2,1,726,305,90,10,29,3,42
04/15/16,2,2,738,315,64,19,13,2,34
04/15/16,2,3,996,300,11,3,1,3,7
04/15/16,2,4,5302,280,91,13,1,9,23
04/15/16,2,5,8030,400,99,1,0,5,6
04/15/16,2,7,7742,345,135,5,7,2,14
04/15/16,2,8,715,350,147,0,3,1,4
04/15/16,2,10,715,380,163,3,5,0,8
04/15/16,2,11,7652,355,104,17,12,3,32
04/15/16,2,12,542,350,128,11,11,1,23
04/15/16,2,13,7740,348,42,9,5,0,14
04/15/16,2,14,8030,360,153,3,5,1,9
04/15/16,2,15,641,350,92,4,14,0,18
04/15/16,2,16,8032,350,141,11,4,3,18
04/15/16,2,17,542,370,123,13,8,1,22
04/15/16,2,18,542,350,100,26,9,0,35
04/15/16,2,19,485,360,138,9,4,0,13
04/15/16,2,20,8040,350,68,24,14,0,38
04/15/16,2,22,542,350,15,5,6,0,11
04/15/16,2,23,542,350,48,26,3,0,29
04/15/16,2,24,7625,360,99,13,9,10,32
04/15/16,2,25,542,375,105,20,3,0,23
04/15/16,2,27,542,360,94,13,8,0,21
04/15/16,2,28,8032,375,86,8,19,0,27
04/15/16,2,29,737,270,52,20,23,0,43
04/15/16,3,1,726,305,83,11,17,1,29
04/15/16,3,2,738,315,71,21,16,2,39
04/15/16,3,3,996,300,82,26,11,1,38
04/15/16,3,4,5302,280,74,25,1,3,29
04/15/16,3,5,8030,400,152,0,2,1,3
04/15/16,3,7,7742,345,96,8,9,4,21
04/15/16,3,8,715,350,127,3,2,1,6
04/15/16,3,10,715,380,50,4,6,0,10
04/15/16,3,11,7652,355,90,18,7,2,27
04/15/16,3,12,542,350,95,3,10,0,13
04/15/16,3,14,8030,360,124,1,5,2,8
04/15/16,3,15,641,350,108,2,4,0,6
04/15/16,3,16,8032,350,65,8,5,2,15
04/15/16,3,17,542,370,35,7,1,0,8
04/15/16,3,18,542,350,44,16,5,0,21
04/15/16,3,19,485,360,102,8,2,0,10
04/15/16,3,20,8040,350,35,7,11,1,19
04/15/16,3,23,542,350,62,8,5,0,13
04/15/16,3,24,7625,360,82,11,4,4,19
04/15/16,3,25,542,375,71,14,6,0,20
04/15/16,3,27,542,360,91,3,8,0,11
04/15/16,3,28,8032,375,63,5,15,1,21
04/15/16,3,29,737,270,30,11,12,1,24
04/18/16,1,1,726,305,94,9,24,2,35
04/18/16,1,2,738,315,79,38,12,9,59
04/18/16,1,3,996,290,106,24,8,3,35
04/18/16,1,4,5302,270,69,45,0,2,47
04/18/16,1,5,8030,400,156,1,1,1,3
04/18/16,1,7,7742,345,124,10,8,4,22
04/18/16,1,8,715,350,137,4,7,2,13
04/18/16,1,10,715,380,153,10,3,0,13
04/18/16,1,11,7652,355,118,21,5,2,28
04/18/16,1,12,542,350,133,10,10,0,20
04/18/16,1,14,8030,360,131,6,3,0,9
04/18/16,1,15,641,350,134,3,7,0,10
04/18/16,1,16,7742,350,92,15,2,1,18
04/18/16,1,17,542,370,12,1,5,4,10
04/18/16,1,18,542,350,112,30,8,1,39
04/18/16,1,19,485,360,138,9,4,0,13
04/18/16,1,20,8040,350,69,15,20,18,53
04/18/16,1,21,775,350,30,7,9,0,16
04/18/16,1,22,542,350,10,0,7,0,7
04/18/16,1,23,542,350,125,31,3,0,34
04/18/16,1,24,7625,360,83,13,9,5,27
04/18/16,1,25,542,375,111,16,5,0,21
04/18/16,1,27,542,360,125,14,8,0,22
04/18/16,1,28,8032,375,88,7,12,1,20
04/18/16,1,29,737,270,60,22,10,0,32
04/18/16,2,1,726,305,84,6,23,2,31
04/18/16,2,2,738,315,54,47,4,1,52
04/18/16,2,3,996,290,103,6,10,1,17
04/18/16,2,4,5302,270,58,41,0,4,45
04/18/16,2,5,8030,400,158,0,1,0,1
04/18/16,2,7,7742,345,138,10,6,3,19
04/18/16,2,8,715,350,153,2,1,0,3
04/18/16,2,10,715,380,130,19,6,0,25
04/18/16,2,11,7652,355,107,20,8,2,30
04/18/16,2,12,542,350,118,5,20,0,25
04/18/16,2,13,7740,400,10,5,2,13,20
04/18/16,2,14,8030,360,79,4,5,4,13
04/18/16,2,15,641,350,119,3,9,0,12
04/18/16,2,17,542,370,111,8,6,1,15
04/18/16,2,18,542,350,104,16,6,0,22
04/18/16,2,19,485,360,145,7,1,0,8
04/18/16,2,20,8040,350,83,11,15,5,31
04/18/16,2,21,775,350,71,7,14,0,21
04/18/16,2,22,542,350,55,11,8,0,19
04/18/16,2,23,542,350,77,20,5,0,25
04/18/16,2,24,7625,360,114,12,8,6,26
04/18/16,2,25,542,375,100,18,3,0,21
04/18/16,2,26,495,360,32,24,6,0,30
04/18/16,2,27,542,360,115,11,8,0,19
04/18/16,2,28,8032,375,86,5,10,3,18
04/18/16,2,29,737,270,57,26,8,0,34
04/18/16,3,1,726,305,115,33,21,4,58
04/18/16,3,2,738,315,83,59,14,2,75
04/18/16,3,3,996,290,108,17,11,9,37
04/18/16,3,4,5302,270,95,25,0,14,39
04/18/16,3,5,8030,400,151,1,3,1,5
04/18/16,3,7,7742,345,149,3,8,4,15
04/18/16,3,8,715,350,153,2,1,1,4
04/18/16,3,10,715,380,161,8,5,0,13
04/18/16,3,11,7652,355,116,23,8,2,33
04/18/16,3,12,542,350,78,17,8,1,26
04/18/16,3,13,7740,400,122,9,13,1,23
04/18/16,3,15,641,350,155,4,2,0,6
04/18/16,3,16,7742,350,6,2,6,4,12
04/18/16,3,17,542,370,106,6,3,0,9
04/18/16,3,18,542,350,59,15,3,2,20
04/18/16,3,19,485,360,102,3,3,0,6
04/18/16,3,20,8040,350,39,8,12,1,21
04/18/16,3,21,775,350,49,7,12,0,19
04/18/16,3,22,542,350,71,15,6,0,21
04/18/16,3,23,542,350,58,22,3,0,25
04/18/16,3,24,7625,360,90,8,4,5,17
04/18/16,3,25,542,375,36,4,5,0,9
04/18/16,3,26,495,360,24,11,12,0,23
04/18/16,3,27,542,360,75,6,8,0,14
04/18/16,3,28,8032,375,76,3,15,0,18
04/18/16,3,29,737,270,25,15,5,0,20
04/19/16,1,1,726,305,128,8,12,5,25
04/19/16,1,2,738,315,100,29,20,4,53
04/19/16,1,3,996,290,113,22,11,2,35
04/19/16,1,4,5302,270,100,33,0,6,39
04/19/16,1,5,8030,400,164,0,2,0,2
04/19/16,1,7,7742,345,144,12,7,3,22
04/19/16,1,8,715,350,100,3,3,3,9
04/19/16,1,9,8035,350,140,0,8,5,13
04/19/16,1,10,715,380,170,11,2,1,14
04/19/16,1,11,7652,355,112,20,15,3,38
04/19/16,1,13,7740,400,114,13,4,4,21
04/19/16,1,14,8030,360,103,1,5,2,8
04/19/16,1,15,641,350,165,2,7,0,9
04/19/16,1,16,7742,350,98,29,9,3,41
04/19/16,1,17,542,370,129,8,10,0,18
04/19/16,1,18,542,350,78,40,7,1,48
04/19/16,1,19,485,360,126,6,1,0,7
04/19/16,1,20,8040,350,44,20,20,5,45
04/19/16,1,21,775,350,62,15,6,0,21
04/19/16,1,22,542,350,81,15,21,0,36
04/19/16,1,23,542,350,81,28,4,0,32
04/19/16,1,24,7625,360,99,14,10,4,28
04/19/16,1,25,542,375,127,15,3,0,18
04/19/16,1,26,495,360,95,6,14,0,20
04/19/16,1,27,542,360,98,10,4,0,14
04/19/16,1,28,8032,375,108,10,17,0,27
04/19/16,1,29,737,270,40,27,10,0,37
04/19/16,2,1,726,305,102,3,21,1,25
04/19/16,2,2,738,315,77,27,8,2,37
04/19/16,2,3,996,300,8,0,1,0,1
04/19/16,2,4,5302,300,79,25,1,6,32
04/19/16,2,5,8030,400,149,2,2,1,5
04/19/16,2,7,7742,345,125,8,9,3,20
04/19/16,2,8,715,350,155,2,4,1,7
04/19/16,2,9,8035,350,144,0,9,1,10
04/19/16,2,10,715,380,158,8,4,0,12
04/19/16,2,11,7652,355,126,25,8,2,35
04/19/16,2,13,7740,400,122,14,6,4,24
04/19/16,2,14,8030,360,144,1,11,0,12
04/19/16,2,15,641,350,117,1,7,0,8
04/19/16,2,16,7742,350,129,18,9,3,30
04/19/16,2,17,542,370,116,13,4,1,18
04/19/16,2,18,542,350,38,8,4,1,13
04/19/16,2,19,485,360,121,6,1,0,7
04/19/16,2,20,8040,350,47,17,22,1,40
04/19/16,2,21,775,350,47,16,9,0,25
04/19/16,2,22,542,350,58,10,15,0,25
04/19/16,2,23,542,350,61,10,4,0,14
04/19/16,2,24,7625,360,122,13,5,8,26
04/19/16,2,25,542,375,97,10,7,0,17
04/19/16,2,26,495,360,78,0,20,0,20
04/19/16,2,27,542,360,129,8,9,0,17
04/19/16,2,28,8032,375,69,5,19,1,25
04/19/16,2,29,737,270,41,25,12,0,37
04/19/16,3,1,726,305,104,11,28,1,40
04/19/16,3,2,738,315,114,36,17,1,54
04/19/16,3,3,996,300,63,39,8,23,70
04/19/16,3,4,5302,300,100,31,3,13,47
04/19/16,3,5,8030,400,161,0,2,0,2
04/19/16,3,7,7742,345,140,5,18,1,24
04/19/16,3,8,715,350,158,3,1,0,4
04/19/16,3,9,8035,350,146,0,15,3,18
04/19/16,3,10,715,380,156,5,9,0,14
04/19/16,3,11,7652,355,107,29,6,5,40
04/19/16,3,13,7740,400,123,12,8,5,25
04/19/16,3,14,8030,360,149,5,12,1,18
04/19/16,3,15,641,350,134,5,5,2,12
04/19/16,3,16,7742,350,70,6,3,1,10
04/19/16,3,17,542,370,64,1,6,2,9
04/19/16,3,19,485,360,35,1,5,0,6
04/19/16,3,20,8040,350,19,4,14,5,23
04/19/16,3,21,775,350,34,12,4,0,16
04/19/16,3,22,542,350,41,6,12,0,18
04/19/16,3,24,7625,360,65,9,5,4,18
04/19/16,3,25,542,375,43,11,4,0,15
04/19/16,3,26,495,360,50,1,6,0,7
04/19/16,3,27,542,360,62,7,10,0,17
04/19/16,3,28,8032,375,62,5,9,2,16
04/19/16,3,29,737,270,16,5,2,0,7
04/20/16,1,1,726,305,119,8,21,1,30
04/20/16,1,2,738,315,106,22,29,0,51
04/20/16,1,3,996,300,86,47,12,3,62
04/20/16,1,4,5302,300,80,32,0,5,37
04/20/16,1,5,8030,400,158,0,2,2,4
04/20/16,1,7,7742,345,134,7,19,4,30
04/20/16,1,8,715,350,156,4,1,1,6
04/20/16,1,9,8035,350,154,0,9,4,13
04/20/16,1,10,715,380,179,3,2,0,5
04/20/16,1,11,7652,355,136,21,3,3,27
04/20/16,1,12,542,350,6,5,2,0,7
04/20/16,1,13,7740,400,117,12,9,4,25
04/20/16,1,14,8030,360,156,5,7,0,12
04/20/16,1,15,641,350,134,3,5,0,8
04/20/16,1,16,7742,350,134,10,10,5,25
04/20/16,1,17,542,370,129,11,8,1,20
04/20/16,1,19,485,360,94,5,7,0,12
04/20/16,1,20,8040,350,44,15,21,4,40
04/20/16,1,21,775,350,72,16,12,0,28
04/20/16,1,22,542,350,95,24,17,0,41
04/20/16,1,24,7625,360,111,15,12,7,34
04/20/16,1,25,542,375,87,16,5,0,21
04/20/16,1,26,495,360,139,3,16,0,19
04/20/16,1,27,542,360,56,7,6,0,13
04/20/16,1,28,8032,375,91,11,16,0,27
04/20/16,1,29,737,270,58,21,12,0,33
04/20/16,2,1,726,305,69,8,17,7,32
04/20/16,2,2,738,315,86,19,13,2,34
04/20/16,2,3,996,300,79,29,8,1,38
04/20/16,2,4,5302,300,90,23,0,1,24
04/20/16,2,5,8030,400,147,1,4,0,5
04/20/16,2,7,7742,345,130,7,10,4,21
04/20/16,2,8,715,350,154,2,4,0,6
04/20/16,2,9,8035,350,125,1,8,2,11
04/20/16,2,10,715,380,136,3,17,4,24
04/20/16,2,11,7652,355,94,20,11,2,33
04/20/16,2,12,542,350,51,28,9,1,38
04/20/16,2,13,7740,400,82,9,12,1,22
04/20/16,2,14,8030,360,151,0,8,2,10
04/20/16,2,15,641,350,34,0,10,0,10
04/20/16,2,16,7742,350,124,13,9,4,26
04/20/16,2,17,542,370,113,12,11,3,26
04/20/16,2,18,542,350,109,13,8,2,23
04/20/16,2,20,8040,350,43,12,40,0,52
04/20/16,2,21,775,350,70,20,3,0,23
04/20/16,2,22,542,350,71,19,17,0,36
04/20/16,2,23,542,350,62,6,4,0,10
04/20/16,2,24,7625,360,53,9,5,4,18
04/20/16,2,26,495,360,96,1,19,0,20
04/20/16,2,28,8032,375,108,11,23,1,35
04/20/16,2,29,737,270,66,20,10,0,30
04/20/16,3,1,726,305,121,10,14,3,27
04/20/16,3,2,738,315,112,22,12,3,37
04/20/16,3,3,996,300,91,38,8,6,52
04/20/16,3,4,5302,300,102,30,2,7,39
04/20/16,3,5,8030,400,165,0,0,1,1
04/20/16,3,7,7742,345,135,13,15,2,30
04/20/16,3,8,715,350,160,2,2,0,4
04/20/16,3,9,8035,350,144,0,12,2,14
04/20/16,3,10,715,380,144,8,4,1,13
04/20/16,3,11,7652,355,119,36,12,2,50
04/20/16,3,12,542,350,85,61,8,2,71
04/20/16,3,13,7740,400,87,10,7,4,21
04/20/16,3,14,8030,360,153,1,7,1,9
04/20/16,3,16,7742,350,36,7,9,3,19
04/20/16,3,17,542,370,63,11,4,1,16
04/20/16,3,18,542,350,70,0,0,0,0
04/20/16,3,20,8040,350,41,9,14,2,25
04/20/16,3,21,775,350,41,12,6,0,18
04/20/16,3,22,542,350,52,7,10,0,17
04/20/16,3,23,542,350,73,11,2,0,13
04/20/16,3,26,495,360,59,3,8,0,11
04/20/16,3,28,8032,375,56,2,12,1,15
04/20/16,3,29,737,270,37,12,6,0,18
04/21/16,1,1,726,305,101,9,25,3,37
04/21/16,1,2,738,315,101,16,16,4,36
04/21/16,1,3,996,300,87,44,13,1,58
04/21/16,1,4,5302,300,103,30,2,5,37
04/21/16,1,5,8030,400,161,0,4,2,6
04/21/16,1,6,EXP,370,13,5,2,13,20
04/21/16,1,7,7742,345,141,14,3,4,21
04/21/16,1,8,715,350,165,3,0,0,3
04/21/16,1,9,8035,350,147,0,10,3,13
04/21/16,1,10,715,380,167,11,0,1,12
04/21/16,1,11,7652,355,124,15,7,2,24
04/21/16,1,12,542,350,97,31,5,2,38
04/21/16,1,14,8030,360,143,0,8,2,10
04/21/16,1,16,7742,350,116,13,13,5,31
04/21/16,1,17,542,370,119,13,16,6,35
04/21/16,1,18,542,350,140,9,8,0,17
04/21/16,1,20,8040,350,50,10,31,4,45
04/21/16,1,21,775,350,130,23,6,0,29
04/21/16,1,22,542,350,100,14,28,0,42
04/21/16,1,23,542,350,137,15,8,0,23
04/21/16,1,26,495,360,141,1,16,0,17
04/21/16,1,27,542,360,19,9,0,0,9
04/21/16,1,28,8032,375,92,7,19,3,29
04/21/16,1,29,737,270,89,12,8,0,20
04/21/16,2,1,726,305,67,4,14,4,22
04/21/16,2,2,738,315,119,11,9,4,24
04/21/16,2,3,996,300,97,17,9,6,32
04/21/16,2,4,5302,300,64,29,1,5,35
04/21/16,2,5,8030,400,160,1,1,1,3
04/21/16,2,6,EXP,370,49,12,4,3,19
04/21/16,2,7,7742,345,123,13,9,4,26
04/21/16,2,8,715,350,145,2,3,0,5
04/21/16,2,9,8035,350,97,16,17,1,34
04/21/16,2,10,715,380,142,7,6,0,13
04/21/16,2,11,7652,355,97,16,17,1,34
04/21/16,2,12,542,350,61,26,13,0,39
04/21/16,2,14,8030,360,118,1,10,0,11
04/21/16,2,16,7742,350,90,13,7,3,23
04/21/16,2,17,542,370,126,9,8,1,18
04/21/16,2,18,542,350,130,14,10,3,27
04/21/16,2,21,775,350,112,29,9,0,38
04/21/16,2,22,542,350,95,30,16,0,46
04/21/16,2,23,542,350,120,33,6,0,39
04/21/16,2,25,542,375,62,9,5,0,14
04/21/16,2,26,495,360,106,6,23,0,29
04/21/16,2,27,542,360,70,6,36,0,42
04/21/16,2,29,737,270,87,14,7,0,21
04/21/16,3,1,726,305,77,8,28,7,43
04/21/16,3,2,738,315,114,17,21,1,39
04/21/16,3,3,996,300,91,39,7,6,52
04/21/16,3,4,5302,300,67,46,2,7,55
04/21/16,3,5,8030,400,164,2,0,0,2
04/21/16,3,7,7742,345,121,9,12,3,24
04/21/16,3,8,715,350,155,1,3,2,6
04/21/16,3,9,8035,350,132,0,14,4,18
04/21/16,3,10,715,380,119,10,22,0,32
04/21/16,3,11,7652,355,114,28,19,2,49
04/21/16,3,12,542,350,101,30,14,0,44
04/21/16,3,13,7740,400,52,3,0,0,3
04/21/16,3,14,8030,360,148,3,6,0,9
04/21/16,3,16,7742,350,53,5,4,0,9
04/21/16,3,17,542,370,81,8,3,1,12
04/21/16,3,18,542,350,73,9,3,1,13
04/21/16,3,20,8040,350,9,11,1,3,15
04/21/16,3,21,775,350,62,9,4,0,13
04/21/16,3,22,542,350,38,10,13,0,23
04/21/16,3,23,542,350,59,9,3,0,12
04/21/16,3,25,542,375,17,5,2,0,7
04/21/16,3,26,495,360,18,0,10,0,10
04/21/16,3,27,542,360,41,8,6,0,14
04/21/16,3,29,737,270,40,9,3,1,13
04/22/16,1,1,726,305,82,31,15,1,47
04/22/16,1,2,738,315,107,25,9,2,36
04/22/16,1,3,996,300,69,37,8,5,50
04/22/16,1,4,5302,300,63,44,3,6,53
04/22/16,1,5,8030,400,151,1,4,4,9
04/22/16,1,6,774,370,5,11,0,2,13
04/22/16,1,7,7742,345,116,12,6,6,24
04/22/16,1,8,715,350,159,5,1,0,6
04/22/16,1,9,8035,350,122,1,20,1,22
04/22/16,1,11,7652,355,124,23,11,3,37
04/22/16,1,12,542,350,93,40,4,11,55
04/22/16,1,13,7740,400,139,9,4,2,15
04/22/16,1,14,8030,360,146,2,6,1,9
04/22/16,1,16,7742,350,135,16,6,3,25
04/22/16,1,17,542,370,102,22,13,0,35
04/22/16,1,18,542,350,131,8,14,1,23
04/22/16,1,19,7371,360,45,3,4,0,7
04/22/16,1,20,8040,350,92,9,19,4,32
04/22/16,1,21,775,350,75,25,6,0,31
04/22/16,1,22,542,350,87,16,14,0,30
04/22/16,1,23,542,350,119,27,4,0,31
04/22/16,1,24,7675,360,8,4,0,4,8
04/22/16,1,25,542,375,98,13,7,0,20
04/22/16,1,26,495,360,115,1,26,0,27
04/22/16,1,27,542,360,90,28,4,0,32
04/22/16,1,29,737,270,95,8,6,0,14
04/22/16,2,1,726,305,84,9,19,2,30
04/22/16,2,2,738,315,80,19,15,1,35
04/22/16,2,3,996,300,87,16,6,4,26
04/22/16,2,4,5302,300,45,32,3,2,37
04/22/16,2,5,8030,400,142,1,1,1,3
04/22/16,2,6,774,370,118,4,5,2,11
04/22/16,2,7,7742,345,126,7,12,2,21
04/22/16,2,8,715,350,169,1,6,0,7
04/22/16,2,9,8035,350,111,0,16,1,17
04/22/16,2,11,7652,355,128,13,4,1,18
04/22/16,2,12,542,350,83,15,17,0,32
04/22/16,2,13,7740,400,91,14,6,2,22
04/22/16,2,14,8030,360,162,5,4,0,9
04/22/16,2,16,7742,350,106,16,8,3,27
04/22/16,2,17,542,370,87,32,7,2,41
04/22/16,2,18,542,350,106,15,13,0,28
04/22/16,2,19,7371,360,68,2,18,0,20
04/22/16,2,20,8040,350,103,11,15,3,29
04/22/16,2,21,775,350,85,17,7,0,24
04/22/16,2,22,542,350,79,17,13,0,30
04/22/16,2,23,542,350,100,28,1,0,29
04/22/16,2,24,7675,360,89,27,3,2,32
04/22/16,2,25,542,375,109,13,7,0,20
04/22/16,2,26,495,360,77,9,13,0,22
04/22/16,2,27,542,360,74,32,3,0,35
04/22/16,2,29,737,270,71,9,5,1,15
04/22/16,3,1,726,305,103,15,27,2,44
04/22/16,3,2,738,315,72,37,13,1,51
04/22/16,3,3,996,300,90,48,5,6,59
04/22/16,3,4,5302,300,76,50,1,11,62
04/22/16,3,5,8030,400,153,2,4,3,9
04/22/16,3,6,774,370,152,5,5,5,15
04/22/16,3,7,7742,345,130,17,12,2,31
04/22/16,3,8,715,350,150,6,1,2,9
04/22/16,3,9,8035,350,133,0,20,4,24
04/22/16,3,11,7652,355,128,19,5,5,29
04/22/16,3,12,542,350,111,14,16,2,32
04/22/16,3,13,7740,400,138,14,5,4,23
04/22/16,3,14,8030,360,158,6,1,3,10
04/25/16,1,1,726,305,100,12,23,3,38
04/25/16,1,2,738,315,46,8,10,12,30
04/25/16,1,3,996,300,104,24,10,2,36
04/25/16,1,4,5302,300,56,54,3,9,66
04/25/16,1,5,8030,400,154,1,3,0,4
04/25/16,1,6,774,370,149,4,4,2,10
04/25/16,1,7,7742,345,135,7,8,5,20
04/25/16,1,8,715,350,146,0,3,1,4
04/25/16,1,9,8035,350,47,1,26,2,29
04/25/16,1,10,3062,380,18,2,1,5,8
04/25/16,1,11,7652,355,91,21,13,6,40
04/25/16,1,12,542,350,93,38,15,0,53
04/25/16,1,13,7740,400,136,12,9,2,23
04/25/16,1,14,8030,360,133,13,0,3,16
04/25/16,1,16,7742,350,129,13,9,4,26
04/25/16,1,17,542,370,57,13,21,0,34
04/25/16,1,18,542,350,141,7,3,2,12
04/25/16,1,19,7371,360,137,2,9,0,11
04/25/16,1,20,8040,350,131,14,7,2,23
04/25/16,1,21,775,350,59,25,4,1,30
04/25/16,1,22,542,350,51,5,19,0,24
04/25/16,1,23,542,350,93,7,4,0,11
04/25/16,1,24,7675,360,82,19,8,3,30
04/25/16,1,25,542,375,83,10,9,0,19
04/25/16,1,26,495,360,119,7,17,0,24
04/25/16,1,27,542,360,97,32,1,0,33
04/25/16,1,28,8032,375,7,5,4,5,14
04/25/16,1,29,737,270,65,18,10,0,28
04/25/16,2,1,726,305,113,19,18,2,39
04/25/16,2,2,738,315,103,8,28,3,39
04/25/16,2,3,996,300,23,5,1,2,8
04/25/16,2,4,5302,300,40,79,3,4,86
04/25/16,2,5,8030,400,135,0,3,2,5
04/25/16,2,6,774,370,149,10,3,1,14
04/25/16,2,7,7742,345,136,4,8,3,15
04/25/16,2,8,715,350,163,0,0,1,1
04/25/16,2,10,3062,380,131,19,8,1,28
04/25/16,2,11,7652,355,105,15,12,5,32
04/25/16,2,12,542,350,96,8,15,3,26
04/25/16,2,13,7740,400,90,14,6,2,22
04/25/16,2,14,8030,360,144,2,5,1,8
04/25/16,2,16,7742,350,122,16,11,2,29
04/25/16,2,17,542,370,109,15,6,0,21
04/25/16,2,18,542,350,118,12,9,1,22
04/25/16,2,19,7371,360,125,4,6,0,10
04/25/16,2,20,8040,350,87,15,15,1,31
04/25/16,2,21,775,350,56,27,7,0,34
04/25/16,2,22,542,350,53,13,11,0,24
04/25/16,2,23,542,350,131,14,3,0,17
04/25/16,2,24,7675,360,76,26,6,4,36
04/25/16,2,25,542,375,121,8,8,0,16
04/25/16,2,26,495,360,103,12,10,0,22
04/25/16,2,27,542,360,67,31,4,0,35
04/25/16,2,28,8032,375,75,17,17,2,36
04/25/16,2,29,737,270,83,15,12,0,27
04/25/16,3,1,726,305,99,17,17,2,36
04/25/16,3,2,738,315,117,10,21,3,34
04/25/16,3,3,996,300,30,8,3,7,18
04/25/16,3,4,5302,300,28,20,1,11,32
04/25/16,3,6,774,370,151,10,1,2,13
04/25/16,3,7,7742,345,135,16,10,4,30
04/25/16,3,8,715,350,161,1,3,0,4
04/25/16,3,10,3062,380,146,30,5,2,37
04/25/16,3,11,7652,355,74,17,7,3,27
04/25/16,3,12,542,350,106,45,9,2,56
04/25/16,3,13,7740,400,124,4,8,4,16
04/25/16,3,14,8030,360,159,0,6,1,7
04/25/16,3,16,7742,350,137,15,5,3,23
04/25/16,3,17,542,370,45,6,5,1,12
04/25/16,3,18,542,350,56,0,3,1,4
04/25/16,3,19,7371,360,50,1,4,0,5
04/25/16,3,20,8040,350,47,4,4,2,10
04/25/16,3,21,775,350,28,11,2,0,13
04/25/16,3,22,542,350,14,1,6,0,7
04/25/16,3,23,542,350,58,1,4,0,5
04/25/16,3,24,7675,360,28,12,3,2,17
04/25/16,3,25,542,375,46,9,1,0,10
04/25/16,3,26,495,360,24,0,6,0,6
04/25/16,3,27,542,360,36,6,3,0,9
04/25/16,3,28,8032,375,26,5,11,1,17
04/25/16,3,29,737,270,34,8,5,0,13
04/26/16,1,1,726,305,96,21,18,3,42
04/26/16,1,2,738,315,99,19,28,0,47
04/26/16,1,3,996,300,112,24,10,6,40
04/26/16,1,4,5302,300,77,39,1,11,51
04/26/16,1,6,774,370,149,11,5,8,24
04/26/16,1,7,7742,345,132,23,0,4,27
04/26/16,1,8,715,350,165,0,0,0,0
04/26/16,1,9,8035,350,95,0,17,8,25
04/26/16,1,10,3062,380,100,29,7,1,37
04/26/16,1,12,542,350,101,30,11,0,41
04/26/16,1,13,7740,400,3,0,3,1,4
04/26/16,1,14,8030,360,125,0,2,0,2
04/26/16,1,16,7742,350,117,21,5,3,29
04/26/16,1,17,542,370,96,18,8,2,28
04/26/16,1,18,542,350,140,4,10,0,14
04/26/16,1,19,7371,360,93,11,10,0,21
04/26/16,1,20,8040,350,117,15,8,1,24
04/26/16,1,21,775,350,74,17,9,0,26
04/26/16,1,22,542,350,55,5,14,0,19
04/26/16,1,23,542,350,105,12,3,0,15
04/26/16,1,24,7675,360,93,20,6,3,29
04/26/16,1,25,542,375,94,13,10,0,23
04/26/16,1,26,495,360,146,4,13,0,17
04/26/16,1,27,542,360,83,27,6,0,33
04/26/16,1,28,8032,375,36,27,14,1,42
04/26/16,1,29,737,270,85,16,8,0,24
04/26/16,2,1,726,305,93,19,22,1,42
04/26/16,2,2,738,315,84,13,15,3,31
04/26/16,2,3,996,300,114,21,10,3,34
04/26/16,2,4,5302,300,47,27,2,1,30
04/26/16,2,6,774,370,150,2,8,0,10
04/26/16,2,7,7742,345,139,4,13,2,19
04/26/16,2,8,715,350,160,1,0,0,1
04/26/16,2,9,8035,350,118,0,22,2,24
04/26/16,2,10,3062,380,142,5,9,4,18
04/26/16,2,12,542,350,85,13,13,2,28
04/26/16,2,13,7740,400,19,0,4,7,11
04/26/16,2,14,8030,360,138,0,3,0,3
04/26/16,2,15,641,350,9,0,3,0,3
04/26/16,2,16,7742,350,100,27,6,4,37
04/26/16,2,18,542,350,129,10,8,2,20
04/26/16,2,19,7371,360,125,1,12,0,13
04/26/16,2,20,8040,350,103,15,11,2,28
04/26/16,2,21,775,350,80,13,8,0,21
04/26/16,2,22,542,350,90,8,15,0,23
04/26/16,2,23,542,350,120,10,4,0,14
04/26/16,2,24,7675,360,95,21,3,2,26
04/26/16,2,25,542,375,113,18,5,0,23
04/26/16,2,26,495,360,102,1,20,0,21
04/26/16,2,27,542,360,94,27,4,0,31
04/26/16,2,28,8032,375,48,32,21,0,53
04/26/16,2,29,737,270,76,14,6,0,20
04/26/16,3,1,726,305,103,11,21,1,33
04/26/16,3,2,738,315,108,16,24,6,46
04/26/16,3,3,996,300,98,21,13,7,41
04/26/16,3,4,5302,300,25,98,2,6,106
04/26/16,3,6,774,370,157,6,2,4,12
04/26/16,3,7,7742,345,135,6,9,8,23
04/26/16,3,8,715,350,163,2,1,1,4
04/26/16,3,9,8035,350,39,0,0,7,7
04/26/16,3,10,3062,380,142,21,4,2,27
04/26/16,3,12,542,350,119,29,11,4,44
04/26/16,3,13,7740,400,129,8,7,6,21
04/26/16,3,14,8030,360,95,3,4,4,11
04/26/16,3,16,7742,350,127,19,12,3,34
04/26/16,3,17,542,370,36,15,11,2,28
04/26/16,3,18,542,350,110,7,7,2,16
04/26/16,3,19,7371,360,152,4,4,0,8
04/26/16,3,20,8040,350,76,9,12,2,23
04/26/16,3,21,775,350,81,20,4,0,24
04/26/16,3,22,542,350,72,7,15,0,22
04/26/16,3,23,542,350,70,6,0,0,6
04/26/16,3,24,7675,360,78,24,6,2,32
04/26/16,3,25,542,375,112,4,10,0,14
04/26/16,3,26,495,360,101,1,14,0,15
04/26/16,3,27,542,360,65,21,0,0,21
04/26/16,3,28,8032,375,56,3,17,0,20
04/26/16,3,29,737,270,59,11,4,1,16
04/27/16,1,1,726,305,72,9,16,0,25
04/27/16,1,2,738,315,102,11,25,2,38
04/27/16,1,3,996,300,104,23,7,5,35
04/27/16,1,4,5302,300,94,58,1,4,63
04/27/16,1,5,8030,400,131,0,8,0,8
04/27/16,1,6,774,370,141,7,6,5,18
04/27/16,1,7,7742,345,126,17,6,2,25
04/27/16,1,8,715,350,163,1,0,0,1
04/27/16,1,9,8035,350,145,1,8,2,11
04/27/16,1,10,3062,380,134,20,1,2,23
04/27/16,1,12,542,350,46,11,6,0,17
04/27/16,1,13,7740,400,112,10,8,4,22
04/27/16,1,14,8030,360,160,1,6,1,8
04/27/16,1,16,7742,350,110,12,14,3,29
04/27/16,1,17,542,370,91,23,5,3,31
04/27/16,1,18,542,350,144,9,6,0,15
04/27/16,1,19,7371,360,164,4,5,0,9
04/27/16,1,20,8040,350,85,11,18,2,31
04/27/16,1,21,775,350,79,19,6,0,25
04/27/16,1,22,542,350,44,9,4,0,13
04/27/16,1,24,7675,360,83,30,5,5,40
04/27/16,1,25,542,375,89,14,2,1,17
04/27/16,1,26,495,360,151,2,17,0,19
04/27/16,1,27,542,360,92,22,10,0,32
04/27/16,1,28,8032,375,77,9,22,2,33
04/27/16,1,29,737,270,56,22,8,0,30
04/27/16,2,2,738,315,17,0,4,13,17
04/27/16,2,3,996,300,97,20,15,1,36
04/27/16,2,4,5302,300,11,5,0,0,5
04/27/16,2,6,774,370,45,3,4,0,7
04/27/16,2,7,7742,345,130,15,7,4,26
04/27/16,2,8,715,350,162,0,3,0,3
04/27/16,2,9,8035,350,165,0,3,1,4
04/27/16,2,10,3062,380,170,10,2,1,13
04/27/16,2,11,7652,355,72,16,9,0,25
04/27/16,2,12,542,350,19,14,2,1,17
04/27/16,2,13,7740,400,149,11,1,4,16
04/27/16,2,14,8030,360,155,1,4,1,6
04/27/16,2,15,641,350,90,3,14,0,17
04/27/16,2,16,7742,350,126,28,7,4,39
04/27/16,2,17,542,370,74,33,7,2,42
04/27/16,2,18,542,350,128,6,7,3,16
04/27/16,2,19,7371,360,45,0,8,1,9
04/27/16,2,20,8040,350,109,21,12,4,37
04/27/16,2,22,542,350,80,11,12,0,23
04/27/16,2,23,542,350,2,2,0,0,2
04/27/16,2,24,7675,360,83,21,9,3,33
04/27/16,2,25,542,375,130,15,5,0,20
04/27/16,2,26,495,360,110,2,12,0,14
04/27/16,2,27,542,360,82,30,6,0,36
04/27/16,2,28,8032,375,62,7,19,2,28
04/27/16,2,29,737,270,68,21,10,2,33
04/27/16,3,3,996,300,106,30,7,11,48
04/27/16,3,7,7742,345,135,6,18,6,30
04/27/16,3,8,715,350,154,0,1,0,1
04/27/16,3,9,8035,350,154,0,7,6,13
04/27/16,3,10,3062,380,153,9,10,0,19
04/27/16,3,11,7652,355,138,21,15,4,40
04/27/16,3,13,7740,400,139,2,7,5,14
04/27/16,3,14,8030,360,132,2,5,2,9
04/27/16,3,15,641,350,74,2,8,0,10
04/27/16,3,16,7742,350,127,31,7,4,42
04/27/16,3,17,542,370,44,25,4,2,31
04/27/16,3,18,542,350,99,6,4,1,11
04/27/16,3,20,8040,350,85,5,12,7,24
04/27/16,3,22,542,350,54,12,5,0,17
04/27/16,3,23,542,350,37,10,3,0,13
04/27/16,3,24,7675,360,65,15,3,4,22
04/27/16,3,25,542,375,92,10,4,0,14
04/27/16,3,26,495,360,48,3,11,0,14
04/27/16,3,27,542,360,68,21,0,0,21
04/27/16,3,28,8032,375,52,10,14,1,25
04/27/16,3,29,737,270,42,15,7,0,22
04/28/16,1,3,996,300,119,14,8,2,24
04/28/16,1,4,5302,300,84,52,1,3,56
04/28/16,1,7,7742,345,123,20,11,3,34
04/28/16,1,8,715,350,156,0,4,0,4
04/28/16,1,9,8035,350,144,0,13,0,13
04/28/16,1,10,3062,380,143,21,7,2,30
04/28/16,1,11,7652,355,107,15,36,2,53
04/28/16,1,13,7740,400,122,13,7,5,25
04/28/16,1,14,8030,360,136,2,7,1,10
04/28/16,1,15,641,350,114,6,14,0,20
04/28/16,1,16,7742,350,125,26,12,3,41
04/28/16,1,17,542,370,121,21,6,1,28
04/28/16,1,18,542,350,144,12,6,0,18
04/28/16,1,20,8040,350,119,18,13,1,32
04/28/16,1,22,542,350,105,32,5,0,37
04/28/16,1,23,542,350,100,47,4,0,51
04/28/16,1,24,7675,360,88,20,7,7,34
04/28/16,1,25,542,375,114,14,14,0,28
04/28/16,1,26,495,360,148,6,22,0,28
04/28/16,1,27,542,360,119,39,4,0,43
04/28/16,1,28,8032,375,89,10,19,0,29
04/28/16,1,29,737,270,73,22,8,0,30
04/28/16,2,1,726,305,41,2,6,7,15
04/28/16,2,3,996,300,101,31,11,3,45
04/28/16,2,4,5302,300,90,36,1,4,41
04/28/16,2,7,7742,345,13,1,2,0,3
04/28/16,2,8,715,350,140,0,4,1,5
04/28/16,2,9,8035,350,146,0,9,2,11
04/28/16,2,10,3062,380,149,16,4,2,22
04/28/16,2,11,7652,355,78,35,26,4,65
04/28/16,2,14,8030,360,100,0,6,0,6
04/28/16,2,15,641,350,102,6,8,2,16
04/28/16,2,16,7742,350,133,8,11,3,22
04/28/16,2,17,542,370,120,10,6,1,17
04/28/16,2,18,542,350,118,9,9,3,21
04/28/16,2,20,8040,350,89,11,15,1,27
04/28/16,2,22,542,350,74,10,14,0,24
04/28/16,2,23,542,350,90,31,6,0,37
04/28/16,2,24,7675,360,109,24,4,0,28
04/28/16,2,25,542,375,100,10,14,0,24
04/28/16,2,26,495,360,135,2,17,0,19
04/28/16,2,27,542,360,95,37,8,0,45
04/28/16,2,28,8032,375,72,16,27,1,44
04/28/16,2,29,737,270,70,20,6,1,27
04/28/16,3,1,726,305,112,14,15,2,31
04/28/16,3,3,996,300,72,26,10,5,41
04/28/16,3,4,5302,300,79,82,3,11,96
04/28/16,3,7,7742,345,120,12,7,6,25
04/28/16,3,8,715,350,156,0,4,1,5
04/28/16,3,9,8035,350,148,0,13,1,14
04/28/16,3,10,3062,380,144,28,7,0,35
04/28/16,3,11,7652,355,137,18,6,4,28
04/28/16,3,15,641,350,6,1,2,0,3
04/28/16,3,16,7742,350,127,24,7,3,34
04/28/16,3,17,542,370,89,12,6,1,19
04/28/16,3,18,542,350,99,13,4,1,18
04/28/16,3,20,8040,350,68,10,9,2,21
04/28/16,3,22,542,350,36,15,6,0,21
04/28/16,3,23,542,350,56,24,2,0,26
04/28/16,3,24,7675,360,54,13,4,4,21
04/28/16,3,25,542,375,61,7,9,0,16
04/28/16,3,26,495,360,56,0,12,0,12
04/28/16,3,27,542,360,56,22,2,0,24
04/28/16,3,28,8032,375,53,9,13,1,23
04/28/16,3,29,737,270,22,7,4,1,12
04/29/16,1,1,726,305,114,12,4,2,18
04/29/16,1,3,996,300,15,4,1,3,8
04/29/16,1,4,5302,300,88,57,3,9,69
04/29/16,1,5,8030,400,56,1,7,2,10
04/29/16,1,7,7742,345,146,13,3,2,18
04/29/16,1,8,715,350,162,1,3,0,4
04/29/16,1,9,8035,350,147,0,12,3,15
04/29/16,1,10,3062,380,143,28,4,3,35
04/29/16,1,11,7652,355,131,23,5,2,30
04/29/16,1,12,542,350,82,16,13,3,32
04/29/16,1,15,641,350,121,9,15,0,24
04/29/16,1,16,7742,350,138,22,8,1,31
04/29/16,1,17,542,370,142,18,7,0,25
04/29/16,1,18,542,350,139,11,8,1,20
04/29/16,1,20,8040,350,111,21,9,4,34
04/29/16,1,22,542,350,99,17,11,0,28
04/29/16,1,23,542,350,107,38,4,0,42
04/29/16,1,25,542,375,108,13,11,0,24
04/29/16,1,26,495,360,139,6,27,0,33
04/29/16,1,27,542,360,112,30,11,0,41
04/29/16,1,28,8032,375,62,16,28,6,50
04/29/16,1,29,737,270,98,10,6,0,16
04/29/16,2,1,726,305,100,8,2,8,18
04/29/16,2,2,738,315,35,2,10,6,18
04/29/16,2,3,996,300,89,21,18,0,39
04/29/16,2,4,5302,300,70,63,1,1,65
04/29/16,2,5,8030,400,153,1,3,2,6
04/29/16,2,7,7742,345,132,14,12,2,28
04/29/16,2,8,715,350,161,1,2,0,3
04/29/16,2,9,8035,350,157,4,1,1,6
04/29/16,2,10,3062,380,150,16,4,0,20
04/29/16,2,11,7652,355,48,4,2,1,7
04/29/16,2,12,542,350,115,24,16,0,40
04/29/16,2,14,8030,360,15,1,0,6,7
04/29/16,2,15,641,350,57,10,10,0,20
04/29/16,2,16,7742,350,128,24,1,3,28
04/29/16,2,17,542,370,109,16,9,3,28
04/29/16,2,18,542,350,143,5,9,0,14
04/29/16,2,20,8040,350,90,11,14,4,29
04/29/16,2,21,775,350,12,4,1,0,5
04/29/16,2,22,542,350,57,14,9,0,23
04/29/16,2,23,542,350,108,22,3,0,25
04/29/16,2,25,542,375,63,14,10,0,24
04/29/16,2,26,495,360,89,2,20,0,22
04/29/16,2,27,542,360,88,36,2,0,38
04/29/16,2,28,8032,375,53,18,7,2,27
04/29/16,2,29,737,270,65,18,5,0,23
04/29/16,3,2,738,315,124,15,8,3,26
04/29/16,3,3,996,300,105,26,17,7,50
04/29/16,3,4,5302,300,85,59,1,9,69
04/29/16,3,5,8030,400,133,33,2,2,37
04/29/16,3,7,7742,345,140,24,5,4,33
04/29/16,3,8,715,350,160,0,2,1,3
04/29/16,3,9,8035,350,148,2,6,6,14
04/29/16,3,10,3062,380,106,15,8,0,23
04/29/16,3,11,7652,355,148,8,7,3,18
04/29/16,3,12,542,350,92,54,13,1,68
04/29/16,3,14,8030,360,25,0,0,0,0
04/29/16,3,15,641,350,68,3,7,0,10
04/29/16,3,16,7742,350,139,15,6,1,22
04/29/16,3,17,542,370,67,4,3,2,9
04/29/16,3,18,542,350,15,1,5,1,7
04/29/16,3,20,8040,350,39,2,7,1,10
04/29/16,3,21,775,350,47,6,3,0,9
04/29/16,3,22,542,350,50,11,5,0,16
04/29/16,3,23,542,350,45,12,1,0,13
04/29/16,3,24,7675,360,23,0,2,3,5
04/29/16,3,25,542,375,11,0,0,0,0
04/29/16,3,26,495,360,3,0,1,0,1
04/29/16,3,27,542,360,48,10,1,0,11
04/29/16,3,28,8032,375,30,3,9,1,13
04/29/16,3,29,737,270,13,6,4,0,10
05/02/16,1,1,728,305,114,15,7,6,28
05/02/16,1,2,738,315,96,16,13,10,39
05/02/16,1,3,996,300,86,24,16,5,45
05/02/16,1,4,5302,300,70,59,1,1,61
05/02/16,1,5,8030,400,127,8,6,0,14
05/02/16,1,7,7742,345,117,18,13,2,33
05/02/16,1,8,715,350,148,1,2,0,3
05/02/16,1,9,8035,350,144,1,8,3,12
05/02/16,1,11,7652,355,54,8,1,2,11
05/02/16,1,12,542,350,100,32,13,2,47
05/02/16,1,14,8030,360,118,0,1,1,2
05/02/16,1,16,7742,350,114,15,12,3,30
05/02/16,1,17,542,370,125,19,3,1,23
05/02/16,1,20,8040,350,97,9,6,6,21
05/02/16,1,21,775,350,3,0,2,1,3
05/02/16,1,22,542,350,110,15,14,0,29
05/02/16,1,23,542,350,118,29,8,0,37
05/02/16,1,24,7675,360,104,20,4,4,28
05/02/16,1,26,495,360,114,6,29,0,35
05/02/16,1,27,542,360,113,40,4,0,44
05/02/16,1,28,8032,375,74,5,22,2,29
05/02/16,1,29,737,270,81,18,7,0,25
05/02/16,2,1,728,305,133,8,4,0,12
05/02/16,2,2,738,315,99,25,15,2,42
05/02/16,2,3,996,300,84,22,15,2,39
05/02/16,2,4,5302,300,54,48,4,0,52
05/02/16,2,5,8030,400,150,3,4,0,7
05/02/16,2,7,7742,345,136,12,12,4,28
05/02/16,2,9,8035,350,144,1,5,3,9
05/02/16,2,12,542,350,89,30,10,2,42
05/02/16,2,14,8030,360,162,2,1,0,3
05/02/16,2,16,7742,350,118,9,11,2,22
05/02/16,2,17,542,370,140,10,3,0,13
05/02/16,2,20,8040,350,101,13,14,2,29
05/02/16,2,21,775,350,37,1,21,0,22
05/02/16,2,22,542,350,55,6,12,0,18
05/02/16,2,23,542,350,93,33,3,0,36
05/02/16,2,24,7675,360,102,14,12,6,32
05/02/16,2,25,542,375,9,12,3,0,15
05/02/16,2,26,495,360,94,1,20,0,21
05/02/16,2,27,542,360,56,20,5,0,25
05/02/16,2,28,8032,375,75,20,16,0,36
05/02/16,2,29,737,270,77,19,6,0,25
05/02/16,3,1,728,305,126,6,7,3,16
05/02/16,3,2,738,315,123,19,9,2,30
05/02/16,3,3,996,300,112,8,19,9,36
05/02/16,3,4,5302,300,49,99,14,9,122
05/02/16,3,5,8030,400,163,0,2,1,3
05/02/16,3,7,7742,345,130,2,15,2,19
05/02/16,3,9,8035,350,3,0,4,0,4
05/02/16,3,12,542,350,110,59,14,2,75
05/02/16,3,14,8030,360,154,6,0,1,7
05/02/16,3,16,7742,350,138,9,7,4,20
05/02/16,3,17,542,370,42,1,1,1,3
05/02/16,3,18,542,350,12,7,4,6,17
05/02/16,3,20,8040,350,21,5,4,1,10
05/02/16,3,21,775,350,7, ,4,0,4
05/02/16,3,22,542,350,16,1,6,0,7
05/02/16,3,23,542,350,32,9,1,0,10
05/02/16,3,24,7675,360,34,5,0,3,8
05/02/16,3,25,542,375,15,5,2,0,7
05/02/16,3,26,495,360,18,2,6,0,8
05/02/16,3,28,8032,375,18,0,6,1,7
05/02/16,3,29,737,270,11,2,3,0,5
05/03/16,1,1,728,305,125,5,9,2,16
05/03/16,1,2,738,315,115,19,19,1,39
05/03/16,1,3,996,300,105,15,24,1,40
05/03/16,1,4,5302,300,96,35,3,7,45
05/03/16,1,5,8030,400,159,2,2,0,4
05/03/16,1,7,7742,345,123,14,22,2,38
05/03/16,1,9,8035,350,2,1,3,1,5
05/03/16,1,11,7652,355,67,23,15,3,41
05/03/16,1,12,542,350,114,28,16,0,44
05/03/16,1,14,8030,360,162,3,3,0,6
05/03/16,1,16,7742,350,140,14,14,3,31
05/03/16,1,17,542,370,130,18,5,2,25
05/03/16,1,18,542,350,92,35,4,6,45
05/03/16,1,20,8040,350,92,21,15,7,43
05/03/16,1,21,775,350,39,3,9,0,12
05/03/16,1,22,542,350,63,3,14,0,17
05/03/16,1,23,542,350,82,22,5,0,27
05/03/16,1,24,7675,360,93,17,7,4,28
05/03/16,1,25,542,375,79,21,4,0,25
05/03/16,1,26,495,360,112,23,28,0,51
05/03/16,1,28,8032,375,69,13,27,1,41
05/03/16,2,1,728,305,135,5,3,1,9
05/03/16,2,2,738,315,111,18,11,3,32
05/03/16,2,3,996,300,110,5,15,3,23
05/03/16,2,4,5302,300,92,43,0,3,46
05/03/16,2,5,8030,400,152,1,3,1,5
05/03/16,2,7,7742,345,123,16,17,3,36
05/03/16,2,8,92,350,4,0,1,6,7
05/03/16,2,11,7652,355,113,24,11,2,37
05/03/16,2,12,542,350,111,28,10,1,39
05/03/16,2,14,8030,360,159,2,4,1,7
05/03/16,2,16,7742,350,99,10,11,4,25
05/03/16,2,17,542,370,135,16,5,0,21
05/03/16,2,18,542,350,105,41,3,0,44
05/03/16,2,20,8040,350,107,7,15,2,24
05/03/16,2,21,775,350,77,13,13,0,26
05/03/16,2,23,542,350,107,22,5,1,28
05/03/16,2,24,7675,360,89,15,3,7,25
05/03/16,2,25,542,375,95,33,7,0,40
05/03/16,2,26,495,360,102,5,19,0,24
05/03/16,2,28,8032,375,92,8,16,3,27
05/03/16,2,29,737,270,22,3,0,0,3
05/03/16,3,1,728,305,122,8,7,2,17
05/03/16,3,2,738,315,121,9,15,2,26
05/03/16,3,3,996,300,126,6,11,2,19
05/03/16,3,4,5302,300,83,43,3,4,50
05/03/16,3,5,8030,400,157,0,5,0,5
05/03/16,3,7,7742,345,134,16,11,2,29
05/03/16,3,8,92,350,124,8,9,16,33
05/03/16,3,11,7652,355,132,19,2,2,23
05/03/16,3,12,542,350,104,27,1,1,29
05/03/16,3,14,8030,360,8,1,1,1,3
05/03/16,3,17,542,370,64,6,1,1,8
05/03/16,3,18,542,350,37,21,1,1,23
05/03/16,3,20,8040,350,39,6,3,3,12
05/03/16,3,21,775,350,23,2,0,0,2
05/03/16,3,22,542,350,16,1,0,0,1
05/03/16,3,23,542,350,60,7,0,0,7
05/03/16,3,24,7675,360,54,10,4,4,18
05/03/16,3,25,542,375,50,11,0,0,11
05/03/16,3,26,495,360,32,2,0,0,2
05/03/16,3,27,542,360,6,4,0,0,4
05/03/16,3,28,8032,375,37,6,3,3,12
05/03/16,3,29,737,270,40,0,0,0,0
05/04/16,1,1,728,305,131,17,2,2,21
05/04/16,1,2,738,315,51,4,9,4,17
05/04/16,1,3,996,300,113,15,7,4,26
05/04/16,1,4,5302,300,59,27,6,4,37
05/04/16,1,5,8030,400,157,1,3,2,6
05/04/16,1,7,7742,345,141,18,11,4,33
05/04/16,1,8,92,350,128,14,14,6,34
05/04/16,1,10,3062,380,68,9,6,3,18
05/04/16,1,11,7652,355,125,13,19,1,33
05/04/16,1,12,542,350,124,39,10,1,50
05/04/16,1,17,542,370,107,25,6,0,31
05/04/16,1,18,542,350,118,23,6,2,31
05/04/16,1,21,775,350,45,3,20,0,23
05/04/16,1,22,542,350,81,13,15,0,28
05/04/16,1,23,542,350,98,27,5,1,33
05/04/16,1,24,7675,360,107,17,3,7,27
05/04/16,1,25,542,375,104,20,7,0,27
05/04/16,1,26,495,360,127,3,27,0,30
05/04/16,1,27,542,360,32,21,6,0,27
05/04/16,1,29,737,270,30,6,5,0,11
05/04/16,2,1,728,305,136,3,5,1,9
05/04/16,2,2,738,315,92,29,10,4,43
05/04/16,2,3,996,300,19,2,1,1,4
05/04/16,2,4,5302,300,81,34,1,3,38
05/04/16,2,5,8030,400,154,0,6,8,14
05/04/16,2,7,7742,345,131,18,10,3,31
05/04/16,2,8,92,350,125,11,15,1,27
05/04/16,2,10,3062,380,153,8,11,0,19
05/04/16,2,11,7652,355,135,19,11,3,33
05/04/16,2,12,542,350,92,27,20,0,47
05/04/16,2,17,542,370,33,9,4,1,14
05/04/16,2,18,542,350,128,23,7,1,31
05/04/16,2,21,775,350,80,7,20,0,27
05/04/16,2,22,542,350,87,5,15,0,20
05/04/16,2,23,542,350,90,31,6,1,38
05/04/16,2,24,7675,360,84,17,3,10,30
05/04/16,2,25,542,375,105,20,4,0,24
05/04/16,2,26,495,360,117,4,8,0,12
05/04/16,2,27,542,360,65,32,3,0,35
05/04/16,2,29,737,270,77,12,9,0,21
05/04/16,3,1,728,305,18,13,1,0,14
05/04/16,3,2,738,315,71,39,11,29,79
05/04/16,3,4,5302,300,62,19,1,2,22
05/04/16,3,5,8030,400,142,0,4,2,6
05/04/16,3,7,7742,345,76,47,17,0,64
05/04/16,3,8,92,350,105,7,10,1,18
05/04/16,3,10,3062,380,152,6,4,0,10
05/04/16,3,11,7652,355,104,11,15,2,28
05/04/16,3,12,542,350,88,21,15,7,43
05/04/16,3,18,542,350,86,25,2,1,28
05/04/16,3,21,775,350,44,2,14,0,16
05/04/16,3,22,542,350,69,7,13,0,20
05/04/16,3,23,542,350,29,7,0,0,7
05/04/16,3,25,542,375,74,9,7,0,16
05/04/16,3,26,495,360,63,2,16,0,18
05/04/16,3,27,542,360,85,18,3,0,21
05/04/16,3,29,737,270,54,7,5,1,13
05/05/16,1,1,728,305,131,8,4,1,13
05/05/16,1,2,738,315,104,37,6,4,47
05/05/16,1,5,8030,400,163,2,2,1,5
05/05/16,1,7,7742,345,112,20,14,3,37
05/05/16,1,8,715,350,140,7,11,3,21
05/05/16,1,10,3062,380,155,15,9,1,25
05/05/16,1,11,7652,355,128,13,26,4,43
05/05/16,1,12,542,350,91,24,19,2,45
05/05/16,1,14,8030,360,158,2,2,1,5
05/05/16,1,18,542,350,103,21,7,2,30
05/05/16,1,21,775,350,70,4,14,0,18
05/05/16,1,22,542,350,108,7,21,0,28
05/05/16,1,23,542,350,99,29,9,0,38
05/05/16,1,25,542,375,98,22,11,0,33
05/05/16,1,26,495,360,146,1,20,0,21
05/05/16,1,27,542,360,80,23,9,0,32
05/05/16,1,29,737,270,74,19,7,0,26
05/05/16,2,1,728,305,110,9,6,4,19
05/05/16,2,2,738,315,98,25,11,5,41
05/05/16,2,3,996,300,91,38,16,2,56
05/05/16,2,5,8030,400,148,1,4,2,7
05/05/16,2,7,7742,345,131,14,14,3,31
05/05/16,2,8,715,350,132,7,15,0,22
05/05/16,2,10,3062,380,122,6,0,1,7
05/05/16,2,11,7652,355,134,14,17,2,33
05/05/16,2,12,542,350,115,24,7,1,32
05/05/16,2,14,8030,360,144,7,4,0,11
05/05/16,2,18,542,350,127,27,5,1,33
05/05/16,2,21,775,350,45,2,22,0,24
05/05/16,2,22,542,350,85,8,17,0,25
05/05/16,2,23,542,350,100,35,1,0,36
05/05/16,2,25,542,375,103,20,6,0,26
05/05/16,2,26,495,360,84,0,17,0,17
05/05/16,2,27,542,360,98,30,6,0,36
05/05/16,2,29,737,270,93,22,10,0,32
05/05/16,2,30,1001,270,15,6,2,4,12
05/05/16,3,1,728,305,85,7,20,7,34
05/05/16,3,2,738,315,71,39,9,4,52
05/05/16,3,3,996,300,100,29,22,3,54
05/05/16,3,5,8030,400,163,1,4,1,6
05/05/16,3,7,7742,345,139,10,11,2,23
05/05/16,3,8,715,350,134,7,6,2,15
05/05/16,3,10,3062,380,155,23,3,4,30
05/05/16,3,11,7652,355,125,16,4,2,22
05/05/16,3,12,542,350,125,23,9,1,33
05/05/16,3,14,8030,360,159,5,2,3,10
05/05/16,3,17,542,370,36,9,9,4,22
05/05/16,3,18,542,350,11,1,0,2,3
05/05/16,3,21,775,350,58,3,26,0,29
05/05/16,3,22,542,350,55,2,10,0,12
05/05/16,3,23,542,350,89,20,2,0,22
05/05/16,3,24,7675,360,61,18,3,0,21
05/05/16,3,25,542,375,71,27,4,0,31
05/05/16,3,27,542,360,69,25,3,0,28
05/05/16,3,29,737,270,69,16,5, ,21
05/06/16,1,1,728,305,5,1,7,6,14
05/06/16,1,2,738,315,109,22,12,2,36
05/06/16,1,3,996,300,98,32,9,5,46
05/06/16,1,4,999,300,35,6,5,5,16
05/06/16,1,5,8030,400,159,3,2,1,6
05/06/16,1,7,7742,345,137,11,14,2,27
05/06/16,1,8,715,350,37,5,15,1,21
05/06/16,1,10,3062,380,153,17,9,0,26
05/06/16,1,11,7652,355,120,16,23,3,42
05/06/16,1,12,542,350,69,52,9,2,63
05/06/16,1,14,8030,360,140,10,3,4,17
05/06/16,1,16,285,350,2,4,6,4,14
05/06/16,1,17,542,370,111,13,12,3,28
05/06/16,1,18,542,350,49,4,6,4,14
05/06/16,1,21,775,350,16,1,20,0,21
05/06/16,1,22,542,350,76,9,22,0,31
05/06/16,1,23,542,350,86,29,7,1,37
05/06/16,1,24,7675,360,105,16,7,8,31
05/06/16,1,25,542,375,122,21,8,0,29
05/06/16,1,27,542,360,125,36,6,1,43
05/06/16,1,29,737,270,87,12,5,0,17
05/06/16,1,30,1001,270,16,10,18,0,28
05/06/16,2,2,738,315,115,11,14,3,28
05/06/16,2,3,996,300,71,17,10,4,31
05/06/16,2,4,999,300,93,26,11,4,41
05/06/16,2,5,8030,400,139,1,7,0,8
05/06/16,2,7,7742,345,134,11,16,2,29
05/06/16,2,10,3062,380,147,19,3,1,23
05/06/16,2,11,7652,355,112,14,33,2,49
05/06/16,2,12,542,350,63,41,13,0,54
05/06/16,2,14,8030,360,143,1,9,0,10
05/06/16,2,16,285,350,109,28,3,3,34
05/06/16,2,17,542,370,116,13,9,0,22
05/06/16,2,18,542,350,84,23,3,1,27
05/06/16,2,21,775,350,37,4,24,0,28
05/06/16,2,22,542,350,88,20,13,0,33
05/06/16,2,23,542,350,89,29,8,0,37
05/06/16,2,24,7675,360,106,13,7,6,26
05/06/16,2,25,542,375,100,20,6,0,26
05/06/16,2,27,542,360,100,33,7,0,40
05/06/16,2,29,737,270,88,15,6,0,21
05/06/16,2,30,1001,270,4,15,6,0,21
05/06/16,3,1,728,305,72,19,3,9,31
05/06/16,3,2,738,315,113,23,11,4,38
05/06/16,3,3,996,300,114,25,7,7,39
05/06/16,3,4,999,300,101,3,13,3,19
05/06/16,3,5,8030,400,159,0,4,5,9
05/06/16,3,7,7742,345,145,16,10,6,32
05/06/16,3,10,3062,380,126,67,10,2,79
05/06/16,3,11,7652,355,125,17,18,6,41
05/06/16,3,12,542,350,96,65,17,3,85
05/06/16,3,14,8030,360,153,5,2,2,9
05/06/16,3,16,285,350,140,16,14,5,35
05/09/16,1,1,728,305,118,15,5,5,25
05/09/16,1,2,738,315,107,16,11,5,32
05/09/16,1,3,996,300,102,16,13,2,31
05/09/16,1,4,999,300,99,22,7,1,30
05/09/16,1,5,8030,400,139,11,1,1,13
05/09/16,1,6,774,370,2,3,2,7,12
05/09/16,1,7,7742,345,112,14,7,4,25
05/09/16,1,10,3062,380,116,33,6,3,42
05/09/16,1,11,7652,355,83,9,25,3,37
05/09/16,1,12,542,350,51,63,8,1,72
05/09/16,1,14,8030,360,141,1,3,0,4
05/09/16,1,16,285,350,109,22,4,5,31
05/09/16,1,17,542,370,67,10,13,1,24
05/09/16,1,18,542,350,102,18,13,1,32
05/09/16,1,20,8040,350,17,13,8,14,35
05/09/16,1,21,775,350,26,0,14,0,14
05/09/16,1,22,542,350,73,17,12,0,29
05/09/16,1,23,542,350,53,15,12,0,27
05/09/16,1,24,7675,360,100,11,4,5,20
05/09/16,1,25,542,375,109,21,8,0,29
05/09/16,1,27,542,360,76,26,7,0,33
05/09/16,1,29,737,270,95,22,11,0,33
05/09/16,2,1,728,305,112,16,3,1,20
05/09/16,2,2,738,315,88,21,15,3,39
05/09/16,2,3,996,300,107,10,14,2,26
05/09/16,2,4,999,300,79,19,5,2,26
05/09/16,2,5,8030,400,136,1,9,1,11
05/09/16,2,6,774,370,121,11,9,11,31
05/09/16,2,7,7742,345,127,7,13,3,23
05/09/16,2,10,3062,380,143,19,4,1,24
05/09/16,2,11,7652,355,117,19,17,5,41
05/09/16,2,12,542,350,42,59,8,0,67
05/09/16,2,14,8030,360,136,2,4,1,7
05/09/16,2,16,285,350,98,29,5,3,37
05/09/16,2,17,542,370,67,6,13,2,21
05/09/16,2,18,542,350,103,31,10,1,42
05/09/16,2,20,8040,350,52,6,13,3,22
05/09/16,2,21,775,350,35,2,11,0,13
05/09/16,2,22,542,350,73,19,14,0,33
05/09/16,2,23,542,350,52,19,13,0,32
05/09/16,2,24,7675,360,109,14,6,6,26
05/09/16,2,25,542,375,95,22,5,0,27
05/09/16,2,27,542,360,105,28,3,0,31
05/09/16,2,29,737,270,91,23,5,9,37
05/09/16,3,1,728,305,112,22,2,4,28
05/09/16,3,2,738,315,106,31,14,3,48
05/09/16,3,3,996,300,88,21,21,6,48
05/09/16,3,4,999,300,107,29,9,5,43
05/09/16,3,5,8030,400,159,0,4,1,5
05/09/16,3,6,774,370,133,7,10,13,30
05/09/16,3,7,7742,345,124,36,11,3,50
05/09/16,3,10,3062,380,131,27,6,0,33
05/09/16,3,11,7652,355,102,14,33,8,55
05/09/16,3,12,542,350,86,53,16,2,71
05/09/16,3,14,8030,360,163,3,4,1,8
05/09/16,3,16,285,350,129,33,9,7,49
05/10/16,1,1,726,305,117,27,3,4,34
05/10/16,1,2,738,315,118,25,11,3,39
05/10/16,1,3,996,300,92,13,18,5,36
05/10/16,1,4,999,300,61,22,5,0,27
05/10/16,1,5,8030,400,90,0,1,1,2
05/10/16,1,6,774,370,104,12,8,3,23
05/10/16,1,7,7742,345,132,14,15,2,31
05/10/16,1,9,7601,350,20,1,0,2,3
05/10/16,1,10,3062,380,150,31,3,0,34
05/10/16,1,11,7652,355,131,9,14,3,26
05/10/16,1,12,542,350,34,21,8,2,31
05/10/16,1,14,8030,360,167,1,3,1,5
05/10/16,1,16,285,350,120,35,1,6,42
05/10/16,1,17,542,370,126,13,14,2,29
05/10/16,1,18,542,350,102,12,22,5,39
05/10/16,1,19,997,360,14,8,2,0,10
05/10/16,1,20,8040,350,1,1,1,3,5
05/10/16,1,21,775,350,23,5,15,0,20
05/10/16,1,22,542,350,82,9,17,0,26
05/10/16,1,23,542,350,81,38,12,0,50
05/10/16,1,24,7675,360,135,10,6,8,24
05/10/16,1,25,542,375,102,8,20,0,28
05/10/16,1,27,542,360,101,24,7,1,32
05/10/16,1,29,737,270,75,18,10,0,28
05/10/16,2,1,726,305,115,1,1,0,2
05/10/16,2,2,738,315,74,35,10,11,56
05/10/16,2,3,996,300,100,20,7,1,28
05/10/16,2,4,999,300,17,7,1,3,11
05/10/16,2,6,774,370,91,20,11,4,35
05/10/16,2,7,7742,345,131,12,7,1,20
05/10/16,2,8,92,350,72,3,12,5,20
05/10/16,2,9,7601,350,118,9,7,1,17
05/10/16,2,10,3062,380,148,18,4,0,22
05/10/16,2,11,7652,355,120,9,17,3,29
05/10/16,2,14,8030,360,147,3,4,1,8
05/10/16,2,16,285,350,105,28,8,6,42
05/10/16,2,17,542,370,126,17,4,0,21
05/10/16,2,18,542,350,103,20,7,3,30
05/10/16,2,19,997,360,18,6,1,0,7
05/10/16,2,20,8040,350,59,8,27,8,43
05/10/16,2,21,775,350,23,0,15,0,15
05/10/16,2,22,542,350,97,8,13,0,21
05/10/16,2,23,542,350,83,27,5,0,32
05/10/16,2,24,7675,360,81,5,3,5,13
05/10/16,2,25,542,375,92,25,7,0,32
05/10/16,2,27,542,360,80,29,6,0,35
05/10/16,2,29,737,270,84,20,12,0,32
05/10/16,3,1,726,305,121,30,3,3,36
05/10/16,3,2,738,315,106,30,20,3,53
05/10/16,3,4,999,300,94,35,12,10,57
05/10/16,3,6,774,370,127,23,14,5,42
05/10/16,3,7,7742,345,132,21,10,4,35
05/10/16,3,8,92,350,125,10,9,1,20
05/10/16,3,9,7601,350,151,10,3,4,17
05/10/16,3,10,3062,380,56,4,5,0,9
05/10/16,3,11,7652,355,140,6,22,1,29
05/10/16,3,14,8030,360,166,3,3,1,7
05/10/16,3,16,285,350,121,35,8,8,51
05/10/16,3,17,542,370,88,8,5,1,14
05/10/16,3,18,542,350,78,20,5,3,28
05/10/16,3,20,8040,350,22,4,11,0,15
05/10/16,3,21,775,350,10,0,12,0,12
05/10/16,3,22,542,350,64,9,12,0,21
05/10/16,3,23,542,350,72,23,2,0,25
05/10/16,3,25,542,375,40,16,7,0,23
05/10/16,3,27,542,360,54,23,6,0,29
05/10/16,3,29,737,270,48,0,0,0,0
05/11/16,1,1,726,305,103,34,6,3,43
05/11/16,1,2,738,315,96,43,12,8,63
05/11/16,1,3,996,300,12,3,9,4,16
05/11/16,1,4,999,310,99,39,13,4,56
05/11/16,1,6,774,370,122,30,7,3,40
05/11/16,1,7,7742,345,126,13,14,6,33
05/11/16,1,8,92,350,109,16,8,1,25
05/11/16,1,9,7601,350,157,6,3,3,12
05/11/16,1,10,3062,380,9,1,1,6,8
05/11/16,1,11,7652,355,118,21,16,5,42
05/11/16,1,12,7393,350,3,2,5,5,12
05/11/16,1,14,8030,360,145,1,3,0,4
05/11/16,1,17,542,370,141,19,6,3,28
05/11/16,1,18,542,350,116,31,9,2,42
05/11/16,1,19,997,360,6,2,0,0,2
05/11/16,1,21,775,350,10,0,12,0,12
05/11/16,1,22,542,350,133,14,15,0,29
05/11/16,1,23,542,350,107,35,4,0,39
05/11/16,1,25,542,375,79,31,13,0,44
05/11/16,1,27,542,360,67,21,11,0,32
05/11/16,1,29,737,270,80,18,6,0,24
05/11/16,2,1,726,305,109,21,4,0,25
05/11/16,2,2,738,315,64,17,12,6,35
05/11/16,2,3,996,300,69,17,23,5,45
05/11/16,2,4,999,310,84,31,11,3,45
05/11/16,2,6,774,370,63,6,6,2,14
05/11/16,2,7,7742,345,139,11,6,4,21
05/11/16,2,8,92,350,108,5,18,0,23
05/11/16,2,9,7601,350,148,2,5,2,9
05/11/16,2,10,3062,380,144,9,6,2,17
05/11/16,2,11,7652,355,87,9,32,3,44
05/11/16,2,12,7393,350,114,29,7,3,39
05/11/16,2,14,8030,360,30,0,0,3,3
05/11/16,2,17,542,370,125,12,14,1,27
05/11/16,2,18,542,350,82,19,6,1,26
05/11/16,2,19,997,360,12,2,1,0,3
05/11/16,2,21,775,350,29,3,32,0,35
05/11/16,2,22,542,350,118,19,8,0,27
05/11/16,2,23,542,350,92,39,4,1,44
05/11/16,2,25,542,375,111,19,10,0,29
05/11/16,2,27,542,360,89,21,10,0,31
05/11/16,2,29,737,270,71,15,5,0,20
05/11/16,3,1,726,305,101,33,5,5,43
05/11/16,3,2,738,315,113,16,8,2,26
05/11/16,3,3,996,300,92,26,28,5,59
05/11/16,3,4,999,310,93,45,15,4,64
05/11/16,3,7,7742,345,133,8,11,1,20
05/11/16,3,8,92,350,134,9,16,1,26
05/11/16,3,9,7601,350,151,14,3,3,20
05/11/16,3,10,3062,380,174,7,0,0,7
05/11/16,3,11,7652,355,123,18,29,2,49
05/11/16,3,12,7393,350,97,32,0,0,32
05/11/16,3,16,285,350,100,41,0,7,48
05/11/16,3,17,542,370,58,3,0,1,4
05/11/16,3,21,775,350,25,2,20,0,22
05/11/16,3,22,542,350,50,5,5,0,10
05/11/16,3,23,542,350,30,10,5,0,15
05/11/16,3,25,542,375,53,5,1,0,6
05/11/16,3,27,542,360,49,14,1,0,15
05/11/16,3,29,737,270,25,7,3,0,10
05/12/16,1,1,726,305,115,21,3,6,30
05/12/16,1,2,738,315,110,20,6,2,28
05/12/16,1,3,996,300,87,23,18,5,46
05/12/16,1,4,999,310,81,21,16,5,42
05/12/16,1,6,774,370,118,9,10,3,22
05/12/16,1,7,7742,345,23,1,2,8,11
05/12/16,1,8,92,350,113,10,13,1,24
05/12/16,1,9,7601,350,144,10,0,4,14
05/12/16,1,10,3062,380,132,24,3,3,30
05/12/16,1,11,7652,355,98,6,20,3,29
05/12/16,1,12,7393,350,96,23,16,2,41
05/12/16,1,16,285,350,96,32,6,3,41
05/12/16,1,17,542,370,146,6,8,0,14
05/12/16,1,21,775,350,8,1,8,0,9
05/12/16,1,22,542,350,126,15,10,0,25
05/12/16,1,23,542,350,110,28,12,1,41
05/12/16,1,24,1001,360,55,28,2,17,47
05/12/16,1,25,542,375,104,28,11,0,39
05/12/16,1,27,542,360,147,31,5,1,37
05/12/16,1,28,8032,375,66,13,28,1,42
05/12/16,1,29,737,270,39,26,10,0,36
05/12/16,2,1,726,305,92,15,10,1,26
05/12/16,2,2,738,315,107,13,5,2,20
05/12/16,2,3,996,300,84,23,18,3,44
05/12/16,2,4,999,310,86,24,11,4,39
05/12/16,2,6,774,370,144,1,2,1,4
05/12/16,2,7,7742,345,120,11,9,2,22
05/12/16,2,8,92,350,95,8,17,1,26
05/12/16,2,9,7601,350,122,16,1,2,19
05/12/16,2,10,3062,380,168,5,3,0,8
05/12/16,2,11,7652,355,118,10,22,1,33
05/12/16,2,12,7393,350,118,18,12,5,35
05/12/16,2,16,285,350,120,25,4,6,35
05/12/16,2,17,542,370,138,6,10,1,17
05/12/16,2,21,775,350,9,0,12,0,12
05/12/16,2,22,542,350,113,22,12,0,34
05/12/16,2,23,542,350,106,39,4,0,43
05/12/16,2,24,1001,360,100,39,5,7,51
05/12/16,2,25,542,375,91,36,7,0,43
05/12/16,2,27,542,360,141,24,4,0,28
05/12/16,2,29,737,270,91,28,15,0,43
05/12/16,3,1,726,305,118,13,4,6,23
05/12/16,3,2,738,315,121,18,13,3,34
05/12/16,3,3,996,300,99,19,24,5,48
05/12/16,3,4,999,310,20,5,5,3,13
05/12/16,3,6,774,370,132,10,14,8,32
05/12/16,3,7,7742,345,156,7,2,4,13
05/12/16,3,8,92,350,133,0,15,2,17
05/12/16,3,9,7601,350,145,11,4,2,17
05/12/16,3,10,3062,380,153,18,9,4,31
05/12/16,3,11,7652,355,71,0,10,6,16
05/12/16,3,12,7393,350,108,46,9,5,60
05/12/16,3,16,285,350,129,21,3,9,33
05/12/16,3,17,542,370,77,6,4,0,10
05/12/16,3,19,997,360,16,10,5,0,15
05/12/16,3,21,775,350,13,0,16,0,16
05/12/16,3,22,542,350,44,6,4,0,10
05/12/16,3,23,542,350,38,8,3,0,11
05/12/16,3,24,1001,360,32,10,0,3,13
05/12/16,3,25,542,375,48,2,3,0,5
05/12/16,3,27,542,360,43,4,4,0,8
05/12/16,3,29,737,270,24,0,0,0,0
05/13/16,1,1,726,305,20,13,5,5,23
05/13/16,1,2,738,315,129,15,10,2,27
05/13/16,1,3,996,300,95,35,16,5,56
05/13/16,1,5,765,400,33,0,1,5,6
05/13/16,1,6,774,370,134,15,14,5,34
05/13/16,1,7,7742,345,119,16,9,4,29
05/13/16,1,8,92,350,129,10,9,1,20
05/13/16,1,9,7601,350,139,10,4,4,18
05/13/16,1,10,3062,380,163,11,5,0,16
05/13/16,1,12,7393,350,106,27,19,8,54
05/13/16,1,14,8030,360,6,1,0,2,3
05/13/16,1,15,641,140,125,4,8,0,12
05/13/16,1,16,285,350,117,38,3,6,47
05/13/16,1,17,542,370,119,5,25,1,31
05/13/16,1,18,542,350,44,18,2,0,20
05/13/16,1,21,775,350,22,1,16,0,17
05/13/16,1,22,542,350,59,6,10,0,16
05/13/16,1,23,542,350,108,41,1,0,42
05/13/16,1,24,1001,360,106,36,2,12,50
05/13/16,1,25,542,375,110,16,12,0,28
05/13/16,1,27,542,360,104,15,16,1,32
05/13/16,1,29,737,270,85,12,6,0,18
05/13/16,2,1,726,305,122,12,3,4,19
05/13/16,2,2,738,315,119,14,8,4,26
05/13/16,2,3,996,300,41,9,9,4,22
05/13/16,2,4,999,310,29,38,7,3,48
05/13/16,2,5,765,400,156,2,3,2,7
05/13/16,2,6,774,370,132,12,11,2,25
05/13/16,2,7,7742,345,128,17,5,1,23
05/13/16,2,8,92,350,103,10,17,2,29
05/13/16,2,9,7601,350,128,6,2,3,11
05/13/16,2,10,3062,380,172,4,1,0,5
05/13/16,2,12,7393,350,40,17,9,3,29
05/13/16,2,14,8030,360,140,0,4,2,6
05/13/16,2,15,641,140,135,7,8,0,15
05/13/16,2,16,285,350,111,10,4,5,19
05/13/16,2,17,542,370,110,8,8,1,17
05/13/16,2,18,542,350,125,23,4,1,28
05/13/16,2,21,775,350,21,3,21,0,24
05/13/16,2,23,542,350,96,36,8,1,45
05/13/16,2,24,1001,360,98,28,4,6,38
05/13/16,2,25,542,375,108,22,11,0,33
05/13/16,2,27,542,360,134,23,4,1,28
05/13/16,2,28,8032,375,127,4,14,4,22
05/13/16,2,29,737,270,73,15,5,0,20
05/13/16,3,1,726,305,134,12,5,0,17
05/13/16,3,2,738,315,114,11,14,4,29
05/13/16,3,3,996,300,76,63,16,14,93
05/13/16,3,4,999,310,84,60,9,5,74
05/13/16,3,5,765,400,158,2,4,3,9
05/13/16,3,6,774,370,129,24,13,5,42
05/13/16,3,7,7742,345,140,13,9,4,26
05/13/16,3,8,92,350,115,17,19,5,41
05/13/16,3,9,7601,350,155,5,5,3,13
05/13/16,3,10,3062,380,160,9,3,2,14
05/13/16,3,12,7393,350,2,8,24,0,32
05/13/16,3,14,8030,360,160,2,4,2,8
05/13/16,3,16,285,350,20,3,1,1,5
05/23/16,1,1,726,305,113,24,7,2,33
05/23/16,1,2,738,315,108,23,11,3,37
05/23/16,1,4,999,300,29,13,0,4,17
05/23/16,1,7,7742,345,126,33,6,3,42
05/23/16,1,9,3062,350,133,4,14,5,23
05/23/16,1,10,3062,380,131,15,13,3,31
05/23/16,1,13,7740,400,72,12,11,2,25
05/23/16,1,14,8030,360,158,1,0,2,3
05/23/16,1,15,641,350,125,3,4,1,8
05/23/16,1,16,285,350,20,11,4,4,19
05/23/16,1,17,542,370,123,16,13,1,30
05/23/16,1,18,542,350,125,23,2,1,26
05/23/16,1,20,8040,350,76,30,18,9,57
05/23/16,1,21,775,350,44,5,17,0,22
05/23/16,1,22,542,350,104,37,10,1,48
05/23/16,1,24,1001,360,77,29,1,6,36
05/23/16,1,27,542,360,101,13,5,1,19
05/23/16,1,28,8032,375,107,7,11,11,29
05/23/16,2,1,726,305,118,7,3,2,12
05/23/16,2,2,738,315,116,11,10,4,25
05/23/16,2,3,996,310,96,26,7,5,38
05/23/16,2,4,999,300,78,39,9,5,53
05/23/16,2,7,7742,345,128,19,5,2,26
05/23/16,2,9,3062,350,121,8,11,2,21
05/23/16,2,10,3062,380,154,14,7,2,23
05/23/16,2,11,7652,355,1,7,0,4,11
05/23/16,2,13,7740,400,82,7,13,2,22
05/23/16,2,14,8030,360,146,6,2,0,8
05/23/16,2,15,641,350,88,1,22,0,23
05/23/16,2,16,285,350,107,24,9,5,38
05/23/16,2,17,542,370,121,24,9,3,36
05/23/16,2,18,542,350,119,21,7,2,30
05/23/16,2,20,8040,350,104,28,10,2,40
05/23/16,2,21,775,350,66,5,17,0,22
05/23/16,2,24,1001,360,11,45,0,7,52
05/23/16,2,28,8032,375,119,12,15,2,29
05/23/16,3,1,726,305,119,10,7,3,20
05/23/16,3,2,738,315,125,20,7,3,30
05/23/16,3,3,996,310,109,27,12,5,44
05/23/16,3,4,999,300,99,35,9,3,47
05/23/16,3,7,7742,345,143,11,8,2,21
05/23/16,3,9,3062,350,142,9,16,2,27
05/23/16,3,10,3062,380,156,19,11,2,32
05/23/16,3,13,7740,400,115,9,21,4,34
05/23/16,3,14,8030,360,170,1,1,1,3
05/23/16,3,15,641,350,128,8,7,0,15
05/23/16,3,16,285,350,106,45,6,4,55
05/23/16,3,17,542,370,121,22,4,2,28
05/23/16,3,18,542,350,102,23,4,5,32
05/23/16,3,20,8040,350,98,34,7,1,42
05/23/16,3,21,775,350,24,3,18,0,21
05/23/16,3,22,542,350,106,19,10,0,29
05/23/16,3,24,1001,360,9,4,1,0,5
05/23/16,3,27,542,360,11,6,0,0,6
05/23/16,3,28,8032,375,108,11,14,3,28
05/24/16,1,1,726,305,123,15,9,0,24
05/24/16,1,2,738,315,127,21,6,3,30
05/24/16,1,3,996,320,103,22,17,6,45
05/24/16,1,4,999,310,90,61,11,5,77
05/24/16,1,7,7742,345,130,23,9,2,34
05/24/16,1,9,3062,350,133,11,12,4,27
05/24/16,1,10,3062,380,152,25,7,1,33
05/24/16,1,11,7652,355,7,3,3,3,9
05/24/16,1,13,7740,400,135,14,7,2,23
05/24/16,1,14,8030,360,164,1,3,0,4
05/24/16,1,15,641,350,153,4,6,1,11
05/24/16,1,16,285,350,107,14,15,8,37
05/24/16,1,17,542,370,110,29,8,2,39
05/24/16,1,19,542,360,72,24,6,0,30
05/24/16,1,20,8040,350,86,21,13,6,40
05/24/16,1,21,775,350,73,7,26,0,33
05/24/16,1,22,542,350,93,9,12,0,21
05/24/16,1,23,542,350,24,8,1,0,9
05/24/16,1,24,1001,360,52,4,7,11,22
05/24/16,1,27,542,360,103,16,15,1,32
05/24/16,1,28,8032,375,110,17,21,2,40
05/24/16,2,1,726,305,112,11,6,2,19
05/24/16,2,2,738,315,97,15,7,5,27
05/24/16,2,3,996,320,81,9,17,3,29
05/24/16,2,4,999,310,69,28,7,5,40
05/24/16,2,7,7742,345,152,5,6,4,15
05/24/16,2,9,3062,350,126,6,13,3,22
05/24/16,2,10,3062,380,153,13,9,1,23
05/24/16,2,11,7652,355,113,8,11,2,21
05/24/16,2,13,7740,400,88,14,11,4,29
05/24/16,2,14,8030,360,163,1,1,4,6
05/24/16,2,15,641,350,145,3,2,1,6
05/24/16,2,16,285,350,132,4,5,4,13
05/24/16,2,17,542,370,115,31,0,1,32
05/24/16,2,19,542,360,127,28,0,1,29
05/24/16,2,20,8040,350,76,24,9,6,39
05/24/16,2,21,775,350,39,12,7,1,20
05/24/16,2,22,542,350,102,7,6,1,14
05/24/16,2,23,542,350,89,25,4,1,30
05/24/16,2,24,1001,360,130,7,12,9,28
05/24/16,2,25,542,375,66,8,5,0,13
05/24/16,2,27,542,360,87,18,11,0,29
05/24/16,2,28,8032,375,106,5,20,6,31
05/24/16,3,1,726,305,100,20,9,10,39
05/24/16,3,2,738,315,95,29,5,5,39
05/24/16,3,3,996,320,115,13,16,4,33
05/24/16,3,4,999,310,85,51,7,8,66
05/24/16,3,7,7742,345,133,21,14,3,38
05/24/16,3,9,3062,350,142,8,11,5,24
05/24/16,3,10,3062,380,26,3,5,1,9
05/24/16,3,11,7652,355,145,8,11,2,21
05/24/16,3,13,7740,400,110,18,15,2,35
05/24/16,3,14,8030,360,162,0,3,0,3
05/24/16,3,15,641,350,87,6,1,0,7
05/24/16,3,16,285,350,105,13,10,6,29
05/24/16,3,17,542,370,109,17,1,1,19
05/24/16,3,18,542,350,93,15,8,2,25
05/24/16,3,19,542,360,88,22,4,0,26
05/24/16,3,22,542,350,93,6,12,0,18
05/24/16,3,23,542,350,86,9,7,0,16
05/24/16,3,24,1001,360,100,8,3,5,16
05/24/16,3,25,542,375,65,6,10,0,16
05/24/16,3,27,542,360,72,10,10,0,20
05/24/16,3,28,8032,375,104,12,12,2,26
05/25/16,1,1,726,305,122,16,6,2,24
05/25/16,1,2,738,315,99,39,8,7,54
05/25/16,1,3,996,320,111,25,15,4,44
05/25/16,1,4,999,310,83,63,7,3,73
05/25/16,1,7,7742,345,136,8,11,2,21
05/25/16,1,9,3062,350,133,8,4,3,15
05/25/16,1,10,3062,380,68,7,8,6,21
05/25/16,1,11,7652,355,124,13,11,5,29
05/25/16,1,13,7740,400,109,10,15,3,28
05/25/16,1,14,8030,360,159,5,4,1,10
05/25/16,1,15,641,350,42,1,10,1,12
05/25/16,1,16,285,350,131,12,8,6,26
05/25/16,1,17,542,370,134,7,12,1,20
05/25/16,1,18,542,350,130,23,8,3,34
05/25/16,1,19,542,360,76,14,16,1,31
05/25/16,1,20,8040,350,26,9,8,10,27
05/25/16,1,21,775,350,72,10,22,0,32
05/25/16,1,22,542,350,107,9,17,1,27
05/25/16,1,23,542,350,134,15,8,2,25
05/25/16,1,24,1001,360,112,12,5,9,26
05/25/16,1,25,542,375,133,13,9,1,23
05/25/16,1,27,542,360,88,16,13,1,30
05/25/16,1,28,8032,375,104,9,24,2,35
05/25/16,2,1,726,305,119,10,3,0,13
05/25/16,2,2,738,315,106,28,6,2,36
05/25/16,2,3,996,320,127,7,16,9,32
05/25/16,2,4,999,310,87,33,9,5,47
05/25/16,2,7,7742,345,127,14,9,4,27
05/25/16,2,10,3062,380,125,13,16,4,33
05/25/16,2,11,7652,355,108,15,9,2,26
05/25/16,2,13,7740,400,105,17,11,2,30
05/25/16,2,14,8030,360,160,4,0,0,4
05/25/16,2,16,285,350,143,11,0,4,15
05/25/16,2,17,542,370,144,14,3,1,18
05/25/16,2,18,542,350,122,18,11,1,30
05/25/16,2,19,542,360,122,18,6,1,25
05/25/16,2,20,8040,350,109,37,9,1,47
05/25/16,2,21,775,350,36,3,16,0,19
05/25/16,2,22,542,350,124,22,9,1,32
05/25/16,2,23,542,350,120,13,6,1,20
05/25/16,2,25,542,375,129,11,7,1,19
05/25/16,2,27,542,360,92,19,10,1,30
05/25/16,2,28,8032,375,104,7,19,3,29
05/25/16,3,1,726,305,122,13,11,2,26
05/25/16,3,2,738,315,115,32,7,6,45
05/25/16,3,3,996,320,86,7,11,6,24
05/25/16,3,4,999,310,13,14,4,0,18
05/25/16,3,7,7742,345,135,16,9,3,28
05/25/16,3,10,3062,380,152,14,8,3,25
05/25/16,3,11,7652,355,136,19,8,2,29
05/25/16,3,13,7740,400,38,5,11,1,17
05/25/16,3,14,8030,360,157,1,3,1,5
05/25/16,3,16,285,350,111,7,8,7,22
05/25/16,3,17,542,370,128,11,4,2,17
05/25/16,3,18,542,350,110,17,4,1,22
05/25/16,3,19,542,360,92,18,5,0,23
05/25/16,3,20,8040,350,69,26,7,3,36
05/25/16,3,21,775,350,13,0,2,0,2
05/25/16,3,22,542,350,91,13,9,0,22
05/25/16,3,23,542,350,93,15,4,1,20
05/25/16,3,24,1001,360,35,3,3,4,10
05/25/16,3,25,542,375,64,13,8,0,21
05/25/16,3,27,542,360,56,24,6,0,30
05/25/16,3,28,8032,375,69,7,16,2,25
05/26/16,1,1,726,305,85,23,2,7,32
05/26/16,1,2,738,315,122,32,4,3,39
05/26/16,1,3,996,330,114,7,22,7,36
05/26/16,1,4,999,310,33,51,3,6,60
05/26/16,1,5,8030,400,25,0,6,8,14
05/26/16,1,7,7742,345,124,40,12,4,56
05/26/16,1,10,3062,380,139,18,9,3,30
05/26/16,1,11,7652,355,139,18,7,6,31
05/26/16,1,14,8030,360,167,1,3,0,4
05/26/16,1,17,542,370,78,13,6,1,20
05/26/16,1,18,542,350,110,10,12,5,27
05/26/16,1,19,542,360,117,26,5,1,32
05/26/16,1,20,8040,350,97,39,11,5,55
05/26/16,1,21,775,350,66,4,18,0,22
05/26/16,1,22,542,350,122,9,10,2,21
05/26/16,1,23,542,350,101,45,6,1,52
05/26/16,1,24,1001,360,125,16,5,9,30
05/26/16,1,25,542,375,127,12,7,1,20
05/26/16,1,27,542,360,93,29,12,1,42
05/26/16,1,28,8032,375,109,7,19,5,31
05/26/16,2,1,726,305,88,26,5,6,37
05/26/16,2,2,738,315,128,19,7,3,29
05/26/16,2,3,996,330,25,5,1,1,7
05/26/16,2,4,999,310,36,60,9,1,70
05/26/16,2,5,8030,400,126,6,7,3,16
05/26/16,2,7,7742,345,142,1,0,0,1
05/26/16,2,10,3062,380,152,9,7,2,18
05/26/16,2,11,7652,355,146,10,7,3,20
05/26/16,2,12,7393,350,12,26,2,10,38
05/26/16,2,14,8030,360,141,0,5,1,6
05/26/16,2,18,542,350,108,14,12,2,28
05/26/16,2,19,542,360,109,20,5,0,25
05/26/16,2,20,8040,350,101,42,9,2,53
05/26/16,2,21,775,350,6,0,7,0,7
05/26/16,2,22,542,350,95,10,12,0,22
05/26/16,2,23,542,350,127,22,5,0,27
05/26/16,2,24,1001,360,114,1,0,2,3
05/26/16,2,25,542,375,121,15,3,0,18
05/26/16,2,27,542,360,80,23,6,0,29
05/26/16,2,28,8032,375,95,9,15,4,28
05/26/16,3,1,726,305,109,25,4,3,32
05/26/16,3,2,738,315,126,14,11,1,26
05/26/16,3,3,996,330,68,20,8,11,39
05/26/16,3,4,999,310,48,23,23,3,49
05/26/16,3,5,8030,400,150,5,2,1,8
05/26/16,3,7,7742,345,139,16,9,2,27
05/26/16,3,10,3062,380,162,6,9,3,18
05/26/16,3,11,7652,355,137,13,3,1,17
05/26/16,3,12,542,350,87,81,13,15,109
05/26/16,3,14,8030,360,162,4,2,3,9
05/26/16,3,17,542,370,23,8,7,1,16
05/26/16,3,18,542,350,112,11,6,2,19
05/26/16,3,19,542,360,92,22,5,0,27
05/26/16,3,20,8040,350,50,28,10,3,41
05/26/16,3,22,542,350,78,12,9,0,21
05/26/16,3,23,542,350,61,18,6,0,24
05/26/16,3,24,1001,360,114,14,2,9,25
05/26/16,3,25,542,375,91,14,6,0,20
05/26/16,3,27,542,360,65,19,7,0,26
05/26/16,3,28,8032,375,102,9,18,1,28
05/27/16,1,1,726,305,101,19,6,21,46
05/27/16,1,2,738,315,122,21,12,2,35
05/27/16,1,3,996,330,116,36,9,5,50
05/27/16,1,4,999,310,65,111,7,7,125
05/27/16,1,5,8030,400,8,0,2,2,4
05/27/16,1,7,7742,345,143,16,6,2,24
05/27/16,1,10,3062,380,154,8,7,2,17
05/27/16,1,11,7652,355,126,17,13,5,35
05/27/16,1,12,542,350,115,29,10,4,43
05/27/16,1,14,8030,360,169,1,0,1,2
05/27/16,1,17,542,370,94,56,15,5,76
05/27/16,1,18,542,350,142,26,6,1,33
05/27/16,1,19,542,360,133,24,10,1,35
05/27/16,1,20,8040,350,98,32,17,4,53
05/27/16,1,22,542,350,126,23,7,1,31
05/27/16,1,24,1001,360,6,1,0,1,2
05/27/16,1,27,542,360,101,16,15,1,32
05/27/16,1,28,8032,375,115,9,21,1,31
05/27/16,2,1,726,305,115,14,9,4,27
05/27/16,2,2,738,315,52,10,3,1,14
05/27/16,2,3,996,330,105,43,8,5,56
05/27/16,2,4,999,310,68,66,10,3,79
05/27/16,2,5,8030,400,133,3,0,0,3
05/27/16,2,7,7742,345,117,12,8,2,22
05/27/16,2,10,3062,380,160,6,8,3,17
05/27/16,2,11,7652,355,133,7,9,2,18
05/27/16,2,12,542,350,112,24,14,1,39
05/27/16,2,14,8030,360,166,4,1,0,5
05/27/16,2,17,542,370,66,60,5,0,65
05/27/16,2,18,542,350,107,7,19,1,27
05/27/16,2,19,542,360,95,11,9,0,20
05/27/16,2,20,8040,350,70,44,13,1,58
05/27/16,2,22,542,350,101,7,13,0,20
05/27/16,2,24,1001,360,52,13,5,7,25
05/27/16,2,27,542,360,76,10,13,0,23
05/27/16,2,28,8032,375,96,18,15,3,36
05/27/16,3,1,726,305,100,16,8,3,27
05/27/16,3,3,996,330,95,18,9,4,31
05/27/16,3,4,999,310,45,47,9,2,58
05/27/16,3,5,8030,400,152,2,2,1,5
05/27/16,3,7,7742,345,58,16,8,2,26
05/27/16,3,10,3062,380,140,8,6,4,18
05/27/16,3,11,7652,355,100,30,5,1,36
05/27/16,3,12,542,350,97,28,7,0,35
05/27/16,3,14,8030,360,149,9,2,2,13
05/27/16,3,17,542,370,27,15,9,0,24
05/27/16,3,18,542,350,61,4,3,3,10
05/27/16,3,19,542,360,48,12,3,0,15
05/27/16,3,20,8040,350,33,33,7,0,40
05/27/16,3,22,542,350,30,2,4,0,6
05/27/16,3,23,542,350,37,9,2,0,11
05/27/16,3,24,1001,360,52,7,12,3,22
05/27/16,3,27,542,360,51,4,6,0,10
05/27/16,3,28,8032,375,55,11,7,3,21
05/16/16,1,1,726,305,126,17,2,3,22
05/16/16,1,2,738,315,115,28,7,17,52
05/16/16,1,3,996,300,13,8,4,2,14
05/16/16,1,4,999,310,54,54,6,4,64
05/16/16,1,5,765,400,148,8,8,2,18
05/16/16,1,6,774,370,146,14,14,6,34
05/16/16,1,7,7742,345,27,1,3,0,4
05/16/16,1,8,92,350,123,16,7,2,25
05/16/16,1,9,7601,350,133,15,7,3,25
05/16/16,1,10,3062,380,164,12,6,3,21
05/16/16,1,14,8030,360,122,0,1,1,2
05/16/16,1,15,641,140,129,4,17,0,21
05/16/16,1,17,542,370,142,7,8,4,19
05/16/16,1,18,542,350,116,19,10,4,33
05/16/16,1,20,8040,350,65,14,4,2,20
05/16/16,1,21,775,350,3,2,3,0,5
05/16/16,1,22,542,350,4,1,0,1,2
05/16/16,1,23,542,350,114,38,7,0,45
05/16/16,1,25,542,375,74,14,8,0,22
05/16/16,1,27,542,400,159,14,2,0,16
05/16/16,1,28,8032,375,103,8,20,2,30
05/16/16,2,1,726,305,69,5,4,6,15
05/16/16,2,2,738,315,110,16,9,5,30
05/16/16,2,3,996,300,95,25,21,5,51
05/16/16,2,4,999,300,98,54,6,3,63
05/16/16,2,5,765,400,154,1,5,1,7
05/16/16,2,6,774,370,146,7,18,3,28
05/16/16,2,8,92,350,126,16,7,2,25
05/16/16,2,9,7601,350,135,2,11,3,16
05/16/16,2,10,3062,380,152,8,7,1,16
05/16/16,2,11,7652,355,15,1,3,0,4
05/16/16,2,15,641,350,113,3,3,0,6
05/16/16,2,17,542,370,111,9,15,1,25
05/16/16,2,18,542,350,128,19,8,1,28
05/16/16,2,20,8040,109,109,18,9,7,34
05/16/16,2,21,775,350,21,2,10,0,12
05/16/16,2,22,542,350,95,11,8,0,19
05/16/16,2,23,542,350,10,6,2,0,8
05/16/16,2,25,542,375,127,19,6,0,25
05/16/16,2,27,542,400,137,13,7,0,20
05/16/16,2,28,8032,375,121,7,17,3,27
05/16/16,3,1,726,305,98,18,8,1,27
05/16/16,3,2,738,315,123,9,13,1,23
05/16/16,3,3,996,300,106,24,15,6,45
05/16/16,3,4,999,300,97,45,10,0,55
05/16/16,3,5,765,400,145,6,6,2,14
05/16/16,3,6,774,370,138,2,16,5,23
05/16/16,3,8,92,350,125,10,24,1,35
05/16/16,3,9,7601,350,157,4,4,2,10
05/16/16,3,10,3062,380,174,8,1,0,9
05/16/16,3,11,7652,355,30,3,5,2,10
05/16/16,3,15,641,350,90,9,6,0,15
05/16/16,3,17,542,370,111,14,20,1,35
05/16/16,3,18,542,350,119,23,9,1,33
05/16/16,3,20,8040,350,113,17,10,1,28
05/16/16,3,21,775,350,25,6,19,0,25
05/16/16,3,22,542,350,124,6,15,0,21
05/16/16,3,25,542,375,49,7,7,0,14
05/16/16,3,27,542,400,41,26,1,0,27
05/16/16,3,28,8032,375,107,3,21,2,26
05/17/16,1,1,726,305,122,8,8,4,20
05/17/16,1,2,738,315,127,14,8,2,24
05/17/16,1,3,996,300,81,27,14,8,49
05/17/16,1,4,999,300,85,28,9,9,46
05/17/16,1,5,765,400,149,5,4,3,12
05/17/16,1,6,774,370,139,11,17,10,38
05/17/16,1,8,92,350,114,20,9,3,32
05/17/16,1,9,3062,350,89,0,2,7,9
05/17/16,1,10,3062,380,157,16,8,1,25
05/17/16,1,15,641,350,98,7,16,0,23
05/17/16,1,17,542,370,109,14,23,3,40
05/17/16,1,18,542,350,113,24,12,3,39
05/17/16,1,20,8040,350,114,15,11,6,32
05/17/16,1,21,775,350,8,0,8,0,8
05/17/16,1,22,542,350,150,11,7,1,19
05/17/16,1,24,1001,360,6,1,2,7,10
05/17/16,1,25,542,375,6,3,2,0,5
05/17/16,1,27,542,405,81,35,3,0,38
05/17/16,1,28,8032,375,102,1,22,17,40
05/17/16,2,1,726,305,125,22,6,3,31
05/17/16,2,2,738,315,132,5,15,2,22
05/17/16,2,3,996,300,46,44,7,1,52
05/17/16,2,4,999,300,94,41,8,3,52
05/17/16,2,5,765,400,153,5,5,6,16
05/17/16,2,6,774,370,133,8,19,1,28
05/17/16,2,10,3062,380,40,3,3,0,6
05/17/16,2,15,641,350,106,4,18,1,23
05/17/16,2,17,542,370,140,14,23,3,40
05/17/16,2,18,542,350,113,19,8,2,29
05/17/16,2,20,8040,350,123,11,11,4,26
05/17/16,2,21,775,350,25,1,22,0,23
05/17/16,2,22,542,350,129,11,7,1,19
05/17/16,2,24,1001,360,93,22,15,9,46
05/17/16,2,27,542,405,72,51,0,0,51
05/17/16,2,28,8032,375,50,6,2,2,10
05/17/16,3,1,726,305,127,20,3,4,27
05/17/16,3,2,738,315,127,11,15,2,28
05/17/16,3,3,999,300,58,79,6,14,99
05/17/16,3,4,996,300,18,14,2,1,17
05/17/16,3,5,765,400,142,2,13,5,20
05/17/16,3,6,774,370,24,2,4,0,6
05/17/16,3,15,641,350,123,1,8,0,9
05/17/16,3,16,285,350,20,3,1,1,5
05/17/16,3,17,542,370,120,20,8,1,29
05/17/16,3,18,542,350,104,18,10,2,30
05/17/16,3,20,8040,350,91,23,5,8,36
05/17/16,3,21,775,350,37,8,15,0,23
05/17/16,3,22,542,350,118,15,10,0,25
05/17/16,3,24,1001,360,90,9,25,9,43
05/17/16,3,25,542,375,15,0,2,0,2
05/17/16,3,27,542,405,6,10,0,1,11
05/17/16,3,28,8032,375,105,11,10,6,27
05/18/16,1,1,726,305,121,32,6,5,43
05/18/16,1,2,738,315,102,20,7,4,31
05/18/16,1,3,996,300,83,61,12,7,80
05/18/16,1,4,999,300,7,4,1,3,8
05/18/16,1,5,765,400,92,6,8,2,16
05/18/16,1,7,7742,345,110,12,5,4,21
05/18/16,1,8,92,350,54,6,2,9,17
05/18/16,1,9,3062,350,15,0,0,12,12
05/18/16,1,10,3062,380,74,9,3,4,16
05/18/16,1,15,641,350,157,2,13,0,15
05/18/16,1,17,542,370,71,4,16,2,22
05/18/16,1,20,8040,350,120,31,5,8,44
05/18/16,1,21,775,350,3,0,5,0,5
05/18/16,1,22,542,350,106,30,14,1,45
05/18/16,1,24,1001,350,87,13,18,4,35
05/18/16,1,25,542,375,97,10,17,0,27
05/18/16,1,27,542,360,84,20,3,0,23
05/18/16,1,28,8032,375,97,15,14,6,35
05/18/16,1,29,737,270,66,21,6,0,27
05/18/16,2,1,726,305,129,9,4,3,16
05/18/16,2,2,738,315,102,20,23,10,53
05/18/16,2,3,996,300,63,46,10,4,60
05/18/16,2,4,999,300,76,53,2,5,60
05/18/16,2,7,7742,345,145,8,8,3,19
05/18/16,2,8,92,350,141,4,5,1,10
05/18/16,2,9,3062,350,144,2,9,2,13
05/18/16,2,10,3062,380,155,13,3,3,19
05/18/16,2,11,7652,355,15,3,5,1,9
05/18/16,2,15,641,350,98,1,9,0,10
05/18/16,2,20,8040,350,102,24,8,11,43
05/18/16,2,21,775,350,10,0,7,0,7
05/18/16,2,22,542,350,106,9,18,1,28
05/18/16,2,24,1001,360,74,10,13,9,32
05/18/16,2,25,542,375,103,13,13,1,27
05/18/16,2,27,542,360,110,6,8,0,14
05/18/16,2,28,8032,375,111,10,9,1,20
05/18/16,2,29,737,270,40,15,5,0,20
05/18/16,3,1,726,305,116,19,8,1,28
05/18/16,3,2,738,315,114,21,11,1,33
05/18/16,3,3,996,300,12,7,4,1,12
05/18/16,3,4,999,300,87,57,7,6,70
05/18/16,3,7,7742,345,133,15,8,2,25
05/18/16,3,8,92,350,138,11,9,2,22
05/18/16,3,9,3062,350,148,2,10,2,14
05/18/16,3,10,3062,380,155,18,7,2,27
05/18/16,3,13,7740,400,10,0,15,4,19
05/18/16,3,15,641,350,118,1,11,0,12
05/18/16,3,18,542,350,10,2,4,0,6
05/18/16,3,19,997,360,16,10,5,0,15
05/18/16,3,20,8040,350,94,26,10,3,39
05/18/16,3,21,775,350,14,1,21,0,22
05/18/16,3,22,542,350,116,8,13,0,21
05/18/16,3,24,1001,360,30,1,8,3,12
05/18/16,3,25,542,375,100,18,14,0,32
05/18/16,3,27,542,360,122,6,5,0,11
05/18/16,3,28,8032,375,121,13,16,3,32
05/19/16,1,1,726,305,122,12,6,0,18
05/19/16,1,2,738,315,107,34,12,2,48
05/19/16,1,3,996,300,41,22,14,8,44
05/19/16,1,4,999,300,87,88,3,5,96
05/19/16,1,7,7742,345,133,13,9,4,26
05/19/16,1,8,92,350,141,13,3,3,19
05/19/16,1,9,3062,350,124,9,15,4,28
05/19/16,1,10,3062,380,115,15,9,3,27
05/19/16,1,15,641,350,111,2,17,0,19
05/19/16,1,18,542,350,132,13,11,3,27
05/19/16,1,20,8040,350,117,36,6,6,48
05/19/16,1,21,775,350,5,0,10,0,10
05/19/16,1,22,542,350,127,8,14,2,24
05/19/16,1,23,542,350,51,16,2,0,18
05/19/16,1,25,542,375,130,24,9,1,34
05/19/16,1,27,542,360,143,13,11,0,24
05/19/16,1,28,8032,375,106,18,13,5,36
05/19/16,2,1,726,305,105,22,8,2,32
05/19/16,2,2,738,315,103,12,16,5,33
05/19/16,2,3,996,300,67,76,2,4,82
05/19/16,2,4,999,300,76,49,4,3,56
05/19/16,2,7,7742,345,10,1,1,0,2
05/19/16,2,8,92,350,131,10,6,2,18
05/19/16,2,9,3062,350,119,6,16,3,25
05/19/16,2,10,3062,380,129,14,18,1,33
05/19/16,2,15,641,350,109,4,3,1,8
05/19/16,2,17,542,370,81,10,10,5,25
05/19/16,2,18,542,350,14,1,3,0,4
05/19/16,2,20,8040,350,120,24,5,3,32
05/19/16,2,21,775,350,6,0,9,0,9
05/19/16,2,22,542,350,115,10,7,1,18
05/19/16,2,23,542,350,111,30,3,1,34
05/19/16,2,24,1001,360,85,14,16,5,35
05/19/16,2,25,542,375,110,5,16,1,22
05/19/16,2,27,542,360,109,13,2,0,15
05/19/16,2,28,8032,375,114,7,16,2,25
05/19/16,3,1,726,305,119,19,6,3,28
05/19/16,3,2,738,315,130,10,15,2,27
05/19/16,3,3,996,300,115,22,6,9,37
05/19/16,3,4,999,300,67,81,5,6,92
05/19/16,3,8,92,350,134,27,6,4,37
05/19/16,3,9,3062,350,137,4,14,3,21
05/19/16,3,10,3062,380,128,9,5,3,17
05/19/16,3,14,8030,360,121,3,1,2,6
05/19/16,3,15,641,350,101,2,21,0,23
05/19/16,3,16,285,350,20,3,1,1,5
05/19/16,3,17,542,370,103,27,13,1,41
05/19/16,3,20,8040,350,91,17,6,6,29
05/19/16,3,21,775,350,36,5,35,0,40
05/19/16,3,22,542,350,101,5,9,0,14
05/19/16,3,23,542,350,56,23,6,0,29
05/19/16,3,24,1001,360,98,5,14,8,27
05/19/16,3,25,542,375,66,18,14,0,32
05/19/16,3,27,542,360,44,17,1,0,18
05/19/16,3,28,8032,375,93,2,20,2,24
05/20/16,1,1,726,305,110,14,8,8,30
05/20/16,1,2,738,315,103,10,14,3,27
05/20/16,1,3,996,310,112,22,7,6,35
05/20/16,1,4,999,300,55,87,4,2,93
05/20/16,1,7,7742,345,133,13,9,4,26
05/20/16,1,8,92,350,142,13,7,5,25
05/20/16,1,9,3062,350,106,17,11,1,29
05/20/16,1,10,3062,380,153,6,12,0,18
05/20/16,1,14,8030,360,155,4,3,0,7
05/20/16,1,15,641,350,143,6,11,0,17
05/20/16,1,16,285,350,7,4,1,7,12
05/20/16,1,17,542,370,113,25,8,4,37
05/20/16,1,18,542,350,99,25,10,8,43
05/20/16,1,20,8040,350,109,35,6,4,45
05/20/16,1,21,775,350,10,0,18,0,18
05/20/16,1,22,542,350,95,24,11,1,36
05/20/16,1,23,542,350,99,29,3,1,33
05/20/16,1,24,1001,360,62,7,11,6,24
05/20/16,1,25,542,375,96,16,19,1,36
05/20/16,1,27,542,360,75,28,7,0,35
05/20/16,2,1,726,305,49,14,0,5,19
05/20/16,2,2,738,315,124,19,2,4,25
05/20/16,2,3,996,310,114,16,6,6,28
05/20/16,2,4,999,300,82,40,6,4,50
05/20/16,2,7,7742,345,118,24,6,1,31
05/20/16,2,8,92,350,138,16,6,3,25
05/20/16,2,9,3062,350,125,8,14,2,24
05/20/16,2,10,3062,380,149,6,13,1,20
05/20/16,2,11,7652,355,12,0,11,4,15
05/20/16,2,14,8030,360,162,1,3,1,5
05/20/16,2,15,641,350,139,1,6,0,7
05/20/16,2,16,285,350,49,2,3,2,7
05/20/16,2,17,542,370,107,37,8,3,48
05/20/16,2,18,542,350,121,22,2,7,31
05/20/16,2,19,542,360,13,12,0,0,12
05/20/16,2,20,8040,350,112,14,11,4,29
05/20/16,2,21,775,350,8,0,12,0,12
05/20/16,2,22,542,350,115,13,7,1,21
05/20/16,2,23,542,350,105,39,3,0,42
05/20/16,2,24,1001,360,35,6,3,3,12
05/20/16,2,25,542,375,70,7,6,0,13
05/20/16,2,27,542,360,114,16,3,0,19
05/20/16,3,1,726,305,119,17,10,2,29
05/20/16,3,2,738,315,104,35,11,3,49
05/20/16,3,3,996,310,37,3,2,2,7
05/20/16,3,4,999,300,41,18,2,3,23
05/20/16,3,7,7742,345,133,26,6,3,35
05/20/16,3,8,92,350,114,14,4,3,21
05/20/16,3,9,3062,350,133,2,18,2,22
05/20/16,3,10,3062,380,146,10,13,2,25
05/20/16,3,14,8030,360,156,13,2,1,16
05/20/16,3,15,641,140,130,1,12,0,13
05/20/16,3,17,542,370,90,55,6,2,63
05/20/16,3,18,542,350,104,24,2,1,27
05/20/16,3,19,542,360,7,26,3,0,29
05/20/16,3,20,8040,350,84,22,19,4,45
05/20/16,3,22,542,350,79,6,6,0,12
05/20/16,3,23,542,350,9,3,4,0,7
05/20/16,3,24,1001,360,61,15,2,8,25
05/20/16,3,27,542,360,102,20,4,0,24
05/31/16,1,1,726,302,96,31,7,6,44
05/31/16,1,2,738,314,33,11,10,3,24
05/31/16,1,3,996,330,106,43,9,7,59
05/31/16,1,4,999,290,66,76,10,3,89
05/31/16,1,5,8030,345,146,4,5,0,9
05/31/16,1,7,7742,339,120,7,13,3,23
05/31/16,1,10,3062,376,118,6,7,3,16
05/31/16,1,11,7652,347,129,17,7,4,28
05/31/16,1,14,8030,360,153,3,4,0,7
05/31/16,1,15,715,354,9,0,6,0,6
05/31/16,1,17,542,345,81,22,18,1,41
05/31/16,1,18,542,345,118,13,6,1,20
05/31/16,1,19,542,366,158,13,10,1,24
05/31/16,1,20,8040,344,93,25,10,7,42
05/31/16,1,22,542,353,113,12,12,1,25
05/31/16,1,23,542,372,141,16,3,1,20
05/31/16,1,24,1001,339,79,18,10,5,33
05/31/16,1,25,542,375,53,10,8,0,18
05/31/16,1,27,542,368,116,9,12,1,22
05/31/16,1,28,8032,325,81,13,17,3,33
05/31/16,2,1,726,302,41,73,8,1,82
05/31/16,2,2,738,314,116,26,13,1,40
05/31/16,2,3,996,330,114,45,6,3,54
05/31/16,2,4,999,290,51,55,8,5,68
05/31/16,2,5,8030,345,155,0,5,1,6
05/31/16,2,6,774,349,88,8,6,6,20
05/31/16,2,7,7742,339,54,4,7,1,12
05/31/16,2,10,3062,376,126,5,7,3,15
05/31/16,2,11,7652,347,144,11,7,2,20
05/31/16,2,14,8030,360,70,4,8,2,14
05/31/16,2,15,715,354,115,2,7,0,9
05/31/16,2,17,542,345,98,16,18,1,35
05/31/16,2,18,542,345,119,10,6,2,18
05/31/16,2,19,542,366,86,13,4,0,17
05/31/16,2,20,8040,344,95,21,12,4,37
05/31/16,2,22,542,353,87,4,17,0,21
05/31/16,2,23,542,372,88,25,6,1,32
05/31/16,2,24,1001,339,44,12,8,6,26
05/31/16,2,25,542,375,68,13,10,1,24
05/31/16,2,27,542,368,84,10,14,1,25
05/31/16,2,28,8032,325,67,18,9,2,29
05/31/16,3,2,738,314,116,24,15,1,40
05/31/16,3,3,996,330,119,38,13,5,56
05/31/16,3,4,999,290,27,38,9,5,52
05/31/16,3,5,8030,345,155,4,5,0,9
05/31/16,3,6,774,349,143,21,4,7,32
05/31/16,3,10,3062,376,163,5,5,2,12
05/31/16,3,11,7652,347,119,10,4,4,18
05/31/16,3,15,715,354,115,0,12,0,12
05/31/16,3,17,542,345,80,4,17,1,22
05/31/16,3,18,542,345,131,12,2,1,15
05/31/16,3,19,542,366,74,15,7,0,22
05/31/16,3,20,8040,344,66,22,7,7,36
05/31/16,3,22,542,353,100,8,10,0,18
05/31/16,3,23,542,372,91,11,4,0,15
05/31/16,3,24,1001,339,59,8,8,6,22
05/31/16,3,25,542,375,58,11,7,0,18
05/31/16,3,27,542,368,60,13,6,0,19
05/31/16,3,28,8032,325,76,11,14,0,25
06/01/16,1,2,738,314,132,20,8,2,30
06/01/16,1,3,996,330,123,44,6,7,57
06/01/16,1,4,999,290,76,62,15,8,85
06/01/16,1,5,8030,345,157,2,3,2,7
06/01/16,1,6,774,349,156,13,3,5,21
06/01/16,1,10,3062,376,151,12,12,5,29
06/01/16,1,12,542,350,20,2,5,7,14
06/01/16,1,13,715,346,140,6,5,3,14
06/01/16,1,14,8030,360,13,0,0,0,0
06/01/16,1,15,715,354,143,0,13,0,13
06/01/16,1,17,542,345,84,21,21,3,45
06/01/16,1,18,542,345,124,16,10,2,28
06/01/16,1,19,542,366,99,11,10,1,22
06/01/16,1,20,8040,344,84,26,16,10,52
06/01/16,1,22,542,353,69,3,15,1,19
06/01/16,1,23,542,372,118,17,9,1,27
06/01/16,1,24,1001,339,103,17,13,6,36
06/01/16,1,25,542,375,21,3,5,0,8
06/01/16,1,27,542,368,76,12,14,1,27
06/01/16,1,28,8032,325,93,9,17,1,27
06/01/16,2,2,738,314,108,29,12,2,43
06/01/16,2,3,996,330,111,41,11,4,56
06/01/16,2,4,999,290,67,11,9,6,26
06/01/16,2,5,8030,345,146,0,8,1,9
06/01/16,2,6,774,349,146,10,8,4,22
06/01/16,2,10,3062,376,59,3,3,4,10
06/01/16,2,11,7652,347,68,1,5,2,8
06/01/16,2,12,542,350,105,26,11,1,38
06/01/16,2,13,715,346,142,1,7,1,9
06/01/16,2,14,8030,360,151,2,1,1,4
06/01/16,2,15,715,354,130,1,13,1,15
06/01/16,2,17,542,345,99,23,16,3,42
06/01/16,2,18,542,345,86,2,10,1,13
06/01/16,2,19,542,366,38,5,4,0,9
06/01/16,2,20,8040,344,109,23,12,6,41
06/01/16,2,22,542,353,36,2,1,0,3
06/01/16,2,23,542,372,114,25,3,1,29
06/01/16,2,24,1001,339,96,12,13,11,36
06/01/16,2,27,542,368,90,19,12,1,32
06/01/16,2,28,8032,325,103,11,15,3,29
06/01/16,3,2,738,314,66,13,9,1,23
06/01/16,3,3,996,330,9,8,5,1,14
06/01/16,3,4,999,290,63,6,19,9,34
06/01/16,3,5,8030,345,132,3,5,2,10
06/01/16,3,6,774,349,149,15,2,6,23
06/01/16,3,10,3062,376,105,6,11,4,21
06/01/16,3,11,7652,347,104,19,4,2,25
06/01/16,3,12,542,350,5,0,1,0,1
06/01/16,3,13,715,346,130,0,14,1,15
06/01/16,3,14,8030,360,171,1,0,1,2
06/01/16,3,15,715,354,79,0,17,0,17
06/01/16,3,17,542,345,82,15,17,0,32
06/01/16,3,20,8040,344,77,22,11,6,39
06/01/16,3,21,747,350,5,3,4,2,9
06/01/16,3,23,542,372,54,31,3,0,34
06/01/16,3,24,1001,339,70,7,7,14,28
06/01/16,3,27,542,368,97,13,8,0,21
06/01/16,3,28,8032,325,114,11,10,1,22
06/02/16,1,2,738,314,92,22,14,13,49
06/02/16,1,3,996,330,49,18,2,4,24
06/02/16,1,4,999,290,14,4,0,0,4
06/02/16,1,5,8030,345,156,2,3,0,5
06/02/16,1,6,774,349,149,22,5,2,29
06/02/16,1,7,7742,339,11,1,1,6,8
06/02/16,1,11,7652,347,146,13,6,6,25
06/02/16,1,12,542,350,1,5,0,1,6
06/02/16,1,13,715,346,161,0,6,0,6
06/02/16,1,14,8030,360,170,0,1,1,2
06/02/16,1,15,715,354,143,3,13,1,17
06/02/16,1,17,542,345,66,13,31,4,48
06/02/16,1,20,8040,344,122,25,16,4,45
06/02/16,1,21,747,350,1,0,0,0,0
06/02/16,1,23,542,372,118,46,5,1,52
06/02/16,1,24,1001,339,95,16,6,7,29
06/02/16,1,25,542,375,100,15,14,1,30
06/02/16,1,27,542,368,108,13,13,1,27
06/02/16,1,28,8032,325,49,5,14,1,20
06/02/16,2,2,738,314,114,20,15,3,38
06/02/16,2,3,996,330,117,22,2,6,30
06/02/16,2,4,999,290,107,49,4,3,56
06/02/16,2,5,8030,345,145,0,6,2,8
06/02/16,2,6,774,349,150,9,7,2,18
06/02/16,2,7,7742,339,100,17,7,3,27
06/02/16,2,11,7652,347,142,4,12,4,20
06/02/16,2,12,542,350,73,34,14,0,48
06/02/16,2,13,715,346,118,0,4,3,7
06/02/16,2,14,8030,360,164,2,1,1,4
06/02/16,2,15,715,354,116,0,19,1,20
06/02/16,2,17,542,345,25,9,10,1,20
06/02/16,2,20,8040,344,114,25,23,1,49
06/02/16,2,21,747,350,109,19,8,0,27
06/02/16,2,23,542,372,108,40,9,1,50
06/02/16,2,24,1001,339,3,0,1,1,2
06/02/16,2,25,542,375,107,24,16,1,41
06/02/16,2,27,542,368,43,7,3,0,10
06/02/16,3,2,738,314,101,332,19,2,353
06/02/16,3,3,996,330,105,35,9,7,51
06/02/16,3,4,999,290,101,48,5,7,60
06/02/16,3,5,8030,345,156,2,5,1,8
06/02/16,3,6,774,349,143,17,1,7,25
06/02/16,3,7,7742,339,124,112,11,3,126
06/02/16,3,10,3062,376,124,17,21,3,41
06/02/16,3,11,7652,347,125,17,21,3,41
06/02/16,3,12,542,350,87,60,8,2,70
06/02/16,3,13,715,346,158,1,4,1,6
06/02/16,3,14,8030,360,156,7,7,0,14
06/02/16,3,15,715,354,105,1,20,0,21
06/02/16,3,20,8040,344,83,19,16,6,41
06/02/16,3,21,747,350,119,4,6,1,11
06/02/16,3,23,542,372,93,24,5,1,30
06/02/16,3,25,542,375,57,17,6,1,24
06/06/16,1,1,996,302,90,23,23,4,50
06/06/16,1,2,738,314,91,25,14,8,47
06/06/16,1,3,996,330,9,7,4,2,13
06/06/16,1,4,999,290,49,20,5,6,31
06/06/16,1,5,8030,345,149,1,2,0,3
06/06/16,1,7,7742,339,107,29,14,4,47
06/06/16,1,9,1005,350,124,19,4,16,39
06/06/16,1,10,3062,376,148,10,6,2,18
06/06/16,1,11,7652,347,137,14,7,2,23
06/06/16,1,12,542,350,111,27,10,1,38
06/06/16,1,13,715,346,140,1,5,1,7
06/06/16,1,14,8030,360,147,2,4,0,6
06/06/16,1,15,715,354,134,1,10,1,12
06/06/16,1,17,513,345,27,8,8,8,24
06/06/16,1,18,542,345,108,32,3,1,36
06/06/16,1,19,542,366,147,16,6,1,23
06/06/16,1,20,8040,344,94,28,13,7,48
06/06/16,1,21,747,350,120,16,8,0,24
06/06/16,1,23,542,372,81,6,8,1,15
06/06/16,1,24,1001,339,14,4,1,9,14
06/06/16,1,28,8032,325,65,5,12,3,20
06/06/16,2,1,996,302,96,26,9,5,40
06/06/16,2,2,738,314,99,31,10,2,43
06/06/16,2,3,996,330,92,26,16,5,47
06/06/16,2,5,8030,345,160,1,3,1,5
06/06/16,2,7,7742,339,117,21,14,2,37
06/06/16,2,9,1005,350,141,1,10,13,24
06/06/16,2,10,3062,376,152,12,10,3,25
06/06/16,2,11,7652,347,139,17,5,2,24
06/06/16,2,12,542,350,120,15,9,1,25
06/06/16,2,13,715,346,157,1,2,1,4
06/06/16,2,14,8030,360,152,5,5,1,11
06/06/16,2,15,715,354,92,1,5,0,6
06/06/16,2,17,513,345,94,25,16,3,44
06/06/16,2,18,542,345,89,51,4,8,63
06/06/16,2,19,542,366,124,15,6,0,21
06/06/16,2,20,8040,344,102,4,1,0,5
06/06/16,2,21,747,350,55,0,5,0,5
06/06/16,2,23,542,372,115,19,8,0,27
06/06/16,2,28,8032,325,110,2,1,1,4
06/06/16,3,1,996,302,89,35,14,5,54
06/06/16,3,2,738,314,94,38,15,3,56
06/06/16,3,3,996,330,96,32,16,4,52
06/06/16,3,4,999,330,41,16,6,6,28
06/06/16,3,5,8030,345,155,0,4,0,4
06/06/16,3,7,7742,339,144,9,10,3,22
06/06/16,3,9,1005,350,53,5,6,9,20
06/06/16,3,10,3062,376,152,9,14,2,25
06/06/16,3,11,7652,347,139,13,5,2,20
06/06/16,3,12,542,350,119,15,20,1,36
06/06/16,3,13,715,346,147,0,8,0,8
06/06/16,3,14,8030,360,169,0,2,0,2
06/06/16,3,15,715,354,97,1,6,0,7
06/06/16,3,17,513,345,91,22,13,4,39
06/06/16,3,18,542,345,77,61,5,1,67
06/06/16,3,19,542,366,135,13,3,0,16
06/06/16,3,20,8040,344,54,11,11,1,23
06/06/16,3,23,542,372,106,16,6,0,22
06/06/16,3,28,8032,325,94,13,20,2,35
06/07/16,1,1,996,302,90,41,18,4,63
06/07/16,1,2,738,314,95,30,13,6,49
06/07/16,1,3,996,330,101,47,19,8,74
06/07/16,1,4,999,330,105,41,4,4,49
06/07/16,1,5,8030,345,124,12,5,1,18
06/07/16,1,7,7742,339,112,43,4,3,50
06/07/16,1,8,781,350,9,2,1,12,15
06/07/16,1,9,1005,350,59,7,4,13,24
06/07/16,1,10,3062,376,167,9,12,3,24
06/07/16,1,11,7652,347,138,13,12,2,27
06/07/16,1,12,542,350,133,17,11,1,29
06/07/16,1,13,715,346,160,0,4,1,5
06/07/16,1,14,8030,360,164,2,1,1,4
06/07/16,1,15,715,354,142,0,11,1,12
06/07/16,1,17,513,345,104,26,20,3,49
06/07/16,1,18,542,345,117,57,1,3,61
06/07/16,1,19,542,366,152,17,5,2,24
06/07/16,1,23,542,372,18,2,3,0,5
06/07/16,1,24,1001,339,19,6,2,7,15
06/07/16,1,28,8032,325,114,9,24,0,33
06/07/16,2,1,996,302,58,38,7,6,51
06/07/16,2,2,738,314,104,20,11,2,33
06/07/16,2,3,996,330,80,29,21,4,54
06/07/16,2,4,999,330,58,48,6,2,56
06/07/16,2,5,8030,345,150,2,3,0,5
06/07/16,2,7,7742,339,117,13,10,1,24
06/07/16,2,8,781,350,113,10,1,1,12
06/07/16,2,9,1005,350,127,8,4,16,28
06/07/16,2,10,3062,376,144,10,10,3,23
06/07/16,2,11,7652,347,124,18,8,2,28
06/07/16,2,12,542,350,55,9,4,14,27
06/07/16,2,13,715,346,155,0,4,1,5
06/07/16,2,14,8030,360,101,1,5,0,6
06/07/16,2,15,715,354,139,1,11,1,13
06/07/16,2,17,513,345,109,21,14,2,37
06/07/16,2,18,542,345,130,22,8,2,32
06/07/16,2,19,542,366,147,10,6,1,17
06/07/16,2,22,542,353,30,1,5,0,6
06/07/16,2,28,8032,325,125,13,17,1,31
06/07/16,3,2,738,314,124,19,11,1,31
06/07/16,3,3,996,330,95,17,46,6,69
06/07/16,3,4,999,330,87,53,9,7,69
06/07/16,3,7,7742,339,137,10,19,3,32
06/07/16,3,8,781,350,120,20,6,1,27
06/07/16,3,9,1005,350,114,15,16,13,44
06/07/16,3,10,3062,376,162,21,9,3,33
06/07/16,3,11,7652,347,144,21,4,4,29
06/07/16,3,13,715,346,161,1,3,2,6
06/07/16,3,14,8030,360,102,2,0,2,4
06/07/16,3,15,715,354,145,1,8,0,9
06/07/16,3,17,513,345,115,18,21,2,41
06/07/16,3,18,542,345,133,17,4,1,22
06/07/16,3,19,542,366,123,16,6,0,22
06/07/16,3,22,542,353,133,4,17,0,21
06/07/16,3,28,8032,325,110,9,19,2,30
06/08/16,1,1,996,302,52,15,4,2,21
06/08/16,1,2,738,314,102,47,13,3,63
06/08/16,1,3,996,330,112,44,16,4,64
06/08/16,1,4,999,330,102,57,8,5,70
06/08/16,1,7,7742,339,139,18,11,4,33
06/08/16,1,8,781,350,132,23,3,1,27
06/08/16,1,9,1005,350,106,16,8,14,38
06/08/16,1,10,3062,376,144,7,16,3,26
06/08/16,1,11,7652,347,133,21,3,2,26
06/08/16,1,12,542,350,87,17,8,1,26
06/08/16,1,13,715,346,159,0,4,1,5
06/08/16,1,14,8030,360,109,3,9,3,15
06/08/16,1,15,715,354,157,2,8,0,10
06/08/16,1,16,exp,350,2,0,2,9,11
06/08/16,1,17,513,345,121,32,17,4,53
06/08/16,1,18,542,345,127,45,10,4,59
06/08/16,1,19,542,366,143,22,4,0,26
06/08/16,1,22,542,353,119,12,20,1,33
06/08/16,1,23,542,372,2,1,0,0,1
06/08/16,1,28,8032,325,119,12,16,4,32
06/08/16,2,1,996,302,90,24,9,4,37
06/08/16,2,2,738,314,97,16,11,2,29
06/08/16,2,3,996,330,88,32,12,4,48
06/08/16,2,4,999,330,66,44,5,3,52
06/08/16,2,7,7742,339,126,8,9,3,20
06/08/16,2,8,781,350,119,9,5,2,16
06/08/16,2,9,1005,350,114,16,5,11,32
06/08/16,2,10,3062,376,131,8,10,1,19
06/08/16,2,11,7652,347,123,12,6,1,19
06/08/16,2,12,542,350,104,18,8,1,27
06/08/16,2,13,715,346,157,0,2,1,3
06/08/16,2,14,8030,360,155,2,2,0,4
06/08/16,2,15,715,354,135,4,11,1,16
06/08/16,2,16,exp,350,28,6,18,3,27
06/08/16,2,17,513,345,97,37,14,2,53
06/08/16,2,18,542,345,3,19,3,0,22
06/08/16,2,19,542,366,133,22,4,1,27
06/08/16,2,22,542,353,108,4,23,1,28
06/08/16,2,23,542,108,108,17,3,1,21
06/08/16,2,24,7625,339,21,8,3,5,16
06/08/16,2,28,8032,325,108,14,20,2,36
06/08/16,3,1,996,302,98,40,8,4,52
06/08/16,3,2,738,314,58,21,4,4,29
06/08/16,3,3,996,310,106,32,26,7,65
06/08/16,3,4,999,310,105,42,14,5,61
06/08/16,3,5,8030,345,108,0,13,2,15
06/08/16,3,7,7742,339,134,21,14,3,38
06/08/16,3,8,781,350,115,36,4,1,41
06/08/16,3,9,1005,350,4,0,1,1,2
06/08/16,3,10,3062,376,152,10,19,4,33
06/08/16,3,11,7652,347,142,23,3,4,30
06/08/16,3,12,542,350,104,40,16,4,60
06/08/16,3,13,715,346,164,0,3,0,3
06/08/16,3,14,8030,360,153,1,6,2,9
06/08/16,3,15,715,354,152,1,13,0,14
06/08/16,3,17,513,345,127,22,14,1,37
06/08/16,3,18,542,345,6,4,1,1,6
06/08/16,3,19,542,366,139,12,5,0,17
06/08/16,3,22,542,353,122,9,23,0,32
06/08/16,3,23,542,372,109,0,40,0,40
06/08/16,3,28,8032,325,118,17,21,2,40
06/09/16,1,1,996,302,93,41,11,7,59
06/09/16,1,2,738,314,41,41,6,5,52
06/09/16,1,3,996,310,63,27,13,10,50
06/09/16,1,4,999,310,25,12,6,2,20
06/09/16,1,5,8030,345,70,0,12,3,15
06/09/16,1,7,7742,339,133,6,14,3,23
06/09/16,1,8,781,350,118,28,4,1,33
06/09/16,1,10,3062,376,50,6,10,2,18
06/09/16,1,11,7652,347,140,20,5,3,28
06/09/16,1,12,542,350,88,62,5,1,68
06/09/16,1,13,715,346,157,0,5,1,6
06/09/16,1,14,8030,360,156,0,6,0,6
06/09/16,1,15,715,354,127,1,8,1,10
06/09/16,1,17,513,345,93,21,13,2,36
06/09/16,1,18,542,345,113,43,5,2,50
06/09/16,1,19,542,366,120,10,10,1,21
06/09/16,1,20,8040,344,28,8,2,13,23
06/09/16,1,22,542,353,112,6,24,1,31
06/09/16,1,23,542,372,135,38,5,1,44
06/09/16,1,24,7625,339,23,3,1,4,8
06/09/16,1,25,542,375,99,12,18,1,31
06/09/16,1,28,8032,325,102,8,28,3,39
06/09/16,2,1,996,302,76,42,7,6,55
06/09/16,2,2,738,314,71,31,20,0,51
06/09/16,2,3,996,310,31,24,4,3,31
06/09/16,2,4,999,310,1,0,2,2,4
06/09/16,2,5,8030,345,146,4,4,5,13
06/09/16,2,7,7742,339,136,9,4,1,14
06/09/16,2,8,781,350,118,28,4,1,33
06/09/16,2,11,7652,347,121,16,5,3,24
06/09/16,2,12,542,350,92,27,18,1,46
06/09/16,2,13,715,346,155,1,2,1,4
06/09/16,2,14,8030,360,128,2,8,1,11
06/09/16,2,15,715,354,137,0,12,0,12
06/09/16,2,17,513,345,89,30,13,3,46
06/09/16,2,18,542,345,109,44,4,1,49
06/09/16,2,19,542,366,12,1,0,0,1
06/09/16,2,20,8040,344,95,21,11,3,35
06/09/16,2,22,542,353,80,2,21,0,23
06/09/16,2,23,542,372,125,36,5,1,42
06/09/16,2,25,542,375,78,6,10,1,17
06/09/16,2,27,542,368,72,19,4,0,23
06/09/16,2,28,8032,325,108,7,16,2,25
06/09/16,3,1,996,302,87,56,12,6,74
06/09/16,3,2,738,314,90,33,21,5,59
06/09/16,3,3,996,300,86,69,6,9,84
06/09/16,3,4,999,330,99,21,14,6,41
06/09/16,3,5,8030,345,157,6,2,0,8
06/09/16,3,7,7742,339,134,7,9,2,18
06/09/16,3,8,781,350,137,14,3,2,19
06/09/16,3,11,7652,347,134,21,10,1,32
06/09/16,3,12,542,350,129,23,7,9,39
06/09/16,3,13,715,346,144,1,8,6,15
06/09/16,3,14,8030,360,133,2,20,1,23
06/09/16,3,15,715,354,117,0,10,0,10
06/09/16,3,17,513,345,95,18,9,2,29
06/09/16,3,18,542,345,110,26,5,1,32
06/09/16,3,20,8040,344,101,28,10,2,40
06/09/16,3,22,542,353,104,4,18,0,22
06/09/16,3,23,542,372,87,28,1,0,29
06/09/16,3,25,542,375,86,12,15,0,27
06/09/16,3,27,542,368,68,19,13,0,32
06/09/16,3,28,8032,325,92,8,30,1,39
06/10/16,1,1,996,302,111,34,9,4,47
06/10/16,1,2,738,314,99,20,16,2,38
06/10/16,1,3,996,300,73,91,9,7,107
06/10/16,1,4,999,330,124,20,11,6,37
06/10/16,1,5,8030,345,145,3,5,2,10
06/10/16,1,8,781,350,139,13,4,1,18
06/10/16,1,10,3062,376,98,4,12,8,24
06/10/16,1,11,7652,347,72,31,8,5,44
06/10/16,1,12,542,350,113,27,11,1,39
06/10/16,1,13,715,346,6,1,4,1,6
06/10/16,1,14,8030,360,123,4,1,0,5
06/10/16,1,15,715,354,123,0,10,1,11
06/10/16,1,17,513,345,103,29,18,5,52
06/10/16,1,18,542,345,113,38,7,1,46
06/10/16,1,20,8040,344,63,19,6,5,30
06/10/16,1,22,542,353,122,16,15,2,33
06/10/16,1,23,542,372,128,35,2,1,38
06/10/16,1,24,7625,339,22,5,5,7,17
06/10/16,1,25,542,375,56,3,13,1,17
06/10/16,1,27,542,368,65,32,10,0,42
06/10/16,1,28,8032,325,90,2,25,1,28
06/10/16,2,1,996,302,5,5,1,2,8
06/10/16,2,2,738,314,98,20,16,2,38
06/10/16,2,3,996,300,84,46,7,3,56
06/10/16,2,4,999,330,119,30,8,6,44
06/10/16,2,5,8030,345,156,1,2,0,3
06/10/16,2,8,781,350,74,5,3,2,10
06/10/16,2,9,8035,350,76,13,15,9,37
06/10/16,2,10,3062,376,145,10,17,1,28
06/10/16,2,11,7652,347,27,4,5,3,12
06/10/16,2,12,542,350,115,17,14,2,33
06/10/16,2,13,715,346,55,1,4,1,6
06/10/16,2,14,8030,360,98,1,6,5,12
06/10/16,2,15,715,354,51,0,6,0,6
06/10/16,2,17,513,345,120,21,13,1,35
06/10/16,2,18,542,345,91,20,7,2,29
06/10/16,2,20,8040,344,108,16,12,1,29
06/10/16,2,22,542,353,102,11,15,1,27
06/10/16,2,23,542,372,96,31,6,1,38
06/10/16,2,25,542,375,91,11,15,1,27
06/10/16,2,27,542,368,93,24,13,1,38
06/10/16,2,28,8032,325,102,16,16,2,34
06/10/16,3,2,738,314,113,23,17,0,40
06/10/16,3,3,996,300,68,30,14,3,47
06/10/16,3,4,999,330,97,22,15,4,41
06/10/16,3,5,8030,345,138,5,3,0,8
06/10/16,3,8,781,350,61,10,1,1,12
06/10/16,3,9,8035,350,108,14,25,1,40
06/10/16,3,10,3062,376,149,11,15,2,28
06/10/16,3,12,542,350,85,8,26,2,36
06/10/16,3,13,715,346,149,0,7,2,9
06/10/16,3,17,513,345,104,22,10,1,33
06/10/16,3,20,8040,344,74,29,5,1,35
06/10/16,3,22,542,353,91,10,12,0,22
06/10/16,3,23,542,372,112,27,3,0,30
06/10/16,3,24,7625,339,22,7,5,4,16
06/10/16,3,25,542,375,98,12,11,0,23
06/10/16,3,27,542,368,70,20,10,0,30
06/10/16,3,28,8032,325,100,10,15,2,27
06/03/16,1,1,996,302,5,1,5,4,10
06/03/16,1,2,738,314,104,30,13,1,44
06/03/16,1,3,996,330,108,55,6,5,66
06/03/16,1,4,999,290,112,41,0,5,46
06/03/16,1,5,8030,345,155,4,3,2,9
06/03/16,1,6,774,349,147,17,7,3,27
06/03/16,1,7,7742,339,140,7,13,3,23
06/03/16,1,10,3062,376,148,12,13,2,27
06/03/16,1,11,7652,347,146,9,7,3,19
06/03/16,1,12,542,350,112,44,5,1,50
06/03/16,1,13,715,346,160,2,4,1,7
06/03/16,1,14,8030,360,161,3,2,2,7
06/03/16,1,15,715,354,142,2,8,1,11
06/03/16,1,18,542,345,95,46,7,1,54
06/03/16,1,19,542,366,56,7,1,0,8
06/03/16,1,20,8040,344,108,28,14,9,51
06/03/16,1,21,747,350,159,2,7,1,10
06/03/16,1,23,542,372,125,23,9,1,33
06/03/16,1,24,1001,339,14,5,2,10,17
06/03/16,2,1,996,302,89,21,10,4,35
06/03/16,2,2,738,314,81,32,15,1,48
06/03/16,2,3,996,330,115,30,5,8,43
06/03/16,2,4,999,290,101,23,7,4,34
06/03/16,2,5,8030,345,155,1,2,0,3
06/03/16,2,6,774,349,135,13,5,1,19
06/03/16,2,7,7742,339,125,10,11,2,23
06/03/16,2,9,1005,350,80,11,5,19,35
06/03/16,2,10,3062,376,148,6,14,3,23
06/03/16,2,11,7652,347,122,17,7,2,26
06/03/16,2,12,542,350,116,19,11,2,32
06/03/16,2,13,715,346,151,0,6,1,7
06/03/16,2,14,8030,360,169,2,1,0,3
06/03/16,2,15,715,354,157,2,4,1,7
06/03/16,2,18,542,345,115,55,6,3,64
06/03/16,2,19,542,366,145,18,3,1,22
06/03/16,2,20,8040,344,84,26,24,5,55
06/03/16,2,21,747,350,131,8,7,0,15
06/03/16,2,23,542,372,104,27,6,1,34
06/03/16,3,1,996,302,85,31,16,3,50
06/03/16,3,2,738,314,73,43,21,4,68
06/03/16,3,3,996,330,113,18,4,8,30
06/03/16,3,4,999,290,105,49,4,3,56
06/03/16,3,5,8030,345,158,1,5,2,8
06/03/16,3,6,774,349,92,32,0,1,33
06/03/16,3,7,7742,339,110,54,9,4,67
06/03/16,3,9,1005,350,128,22,11,16,49
06/03/16,3,10,3062,376,165,10,12,4,26
06/03/16,3,11,7652,347,134,30,2,2,34
06/03/16,3,12,542,350,132,29,4,3,36
06/03/16,3,13,715,346,154,0,4,3,7
06/03/16,3,14,8030,360,164,2,0,2,4
06/03/16,3,15,715,354,159,2,5,1,8
06/03/16,3,18,542,345,102,45,1,1,47
06/03/16,3,19,542,366,55,5,2,0,7
06/03/16,3,20,8040,344,80,29,14,4,47
06/03/16,3,21,747,350,90,30,7,1,38
06/03/16,3,23,542,372,125,12,1,1,14
06/13/16,1,1,996,302,61,20,12,3,35
06/13/16,1,2,738,314,100,19,12,10,41
06/13/16,1,3,996,300,75,81,11,38,130
06/13/16,1,4,999,330,104,29,12,11,52
06/13/16,1,5,8030,345,150,2,3,1,6
06/13/16,1,7,7742,339,101,10,10,3,23
06/13/16,1,9,8035,350,101,2,23,6,31
06/13/16,1,10,3062,376,123,16,16,2,34
06/13/16,1,13,715,346,149,1,5,1,7
06/13/16,1,17,513,345,115,22,13,1,36
06/13/16,1,18,542,345,12,11,1,4,16
06/13/16,1,20,8040,344,124,15,10,3,28
06/13/16,1,22,542,353,115,10,18,2,30
06/13/16,1,23,542,372,83,49,1,1,51
06/13/16,1,25,542,375,75,10,20,0,30
06/13/16,1,27,542,368,44,4,5,0,9
06/13/16,1,28,8032,325,105,11,21,4,36
06/13/16,2,1,996,302,74,38,10,3,51
06/13/16,2,2,738,314,93,22,13,6,41
06/13/16,2,3,996,300,60,44,6,7,57
06/13/16,2,4,999,330,101,28,14,5,47
06/13/16,2,5,8030,345,135,9,4,2,15
06/13/16,2,7,7742,339,138,11,11,3,25
06/13/16,2,8,781,350,58,11,5,1,17
06/13/16,2,9,8035,350,121,1,21,1,23
06/13/16,2,10,3062,376,134,16,16,2,34
06/13/16,2,11,7652,347,33,4,0,6,10
06/13/16,2,13,715,346,159,1,3,1,5
06/13/16,2,17,513,345,88,34,13,2,49
06/13/16,2,18,542,345,57,49,5,1,55
06/13/16,2,19,542,366,73,7,9,0,16
06/13/16,2,20,8040,344,100,27,13,4,44
06/13/16,2,22,542,353,96,7,19,0,26
06/13/16,2,23,542,372,37,29,0,0,29
06/13/16,2,24,7625,339,82,9,4,3,16
06/13/16,2,25,542,375,84,8,15,1,24
06/13/16,2,27,542,368,65,15,1,1,17
06/13/16,2,28,8032,325,91,14,18,1,33
06/13/16,3,1,996,302,104,31,11,6,48
06/13/16,3,2,738,314,87,43,13,14,70
06/13/16,3,3,996,300,80,54,12,12,78
06/13/16,3,5,8030,345,1,0,0,4,4
06/13/16,3,7,7742,339,118,9,6,1,16
06/13/16,3,8,781,350,32,10,0,2,12
06/13/16,3,9,8035,350,138,3,18,4,25
06/13/16,3,10,3062,376,137,9,16,4,29
06/13/16,3,11,7652,347,132,14,5,5,24
06/13/16,3,13,715,346,157,0,3,1,4
06/13/16,3,15,715,354,87,0,14,0,14
06/13/16,3,17,513,345,101,15,12,2,29
06/13/16,3,18,542,345,74,22,8,1,31
06/13/16,3,19,542,366,109,13,8,0,21
06/13/16,3,20,8040,344,75,20,7,1,28
06/13/16,3,22,542,353,98,4,17,0,21
06/13/16,3,23,542,372,29,22,0,0,22
06/13/16,3,24,7625,339,92,13,5,7,25
06/13/16,3,25,542,375,81,7,19,0,26
06/13/16,3,27,542,368,24,8,2,0,10
06/13/16,3,28,8032,325,43,4,10,1,15
06/14/16,1,1,996,302,108,33,15,6,54
06/14/16,1,2,738,314,120,27,12,4,43
06/14/16,1,3,996,300,121,21,13,11,45
06/14/16,1,4,999,330,32,11,4,5,20
06/14/16,1,7,7742,339,127,12,17,6,35
06/14/16,1,8,781,350,95,21,2,4,27
06/14/16,1,9,8035,350,146,6,11,1,18
06/14/16,1,10,3062,376,148,12,8,3,23
06/14/16,1,11,7652,347,120,16,16,3,35
06/14/16,1,13,715,346,163,0,4,1,5
06/14/16,1,15,715,354,119,0,13,1,14
06/14/16,1,17,513,345,123,20,10,2,32
06/14/16,1,18,542,345,119,37,6,1,44
06/14/16,1,19,542,366,131,16,9,1,26
06/14/16,1,20,8040,344,95,25,21,5,51
06/14/16,1,22,542,353,104,11,16,1,28
06/14/16,1,23,542,372,103,37,3,0,40
06/14/16,1,24,7625,339,120,14,3,11,28
06/14/16,1,25,542,375,102,14,18,0,32
06/14/16,1,27,542,368,86,18,7,1,26
06/14/16,1,28,8032,325,48,5,13,3,21
06/14/16,2,1,996,302,101,36,12,4,52
06/14/16,2,2,738,314,101,24,17,1,42
06/14/16,2,3,996,300,99,20,9,7,36
06/14/16,2,4,999,330,99,13,14,6,33
06/14/16,2,5,8030,345,77,1,1,2,4
06/14/16,2,7,7742,339,129,16,14,1,31
06/14/16,2,8,781,350,91,23,2,2,27
06/14/16,2,9,8035,350,157,3,5,1,9
06/14/16,2,10,3062,376,68,2,8,2,12
06/14/16,2,11,7652,347,121,10,17,3,30
06/14/16,2,13,715,346,152,2,1,1,4
06/14/16,2,15,715,354,127,0,13,0,13
06/14/16,2,16,7393,350,25,22,3,13,38
06/14/16,2,17,513,345,79,17,15,0,32
06/14/16,2,18,542,345,79,37,3,1,41
06/14/16,2,19,542,366,102,11,6,1,18
06/14/16,2,20,8040,344,104,14,11,2,27
06/14/16,2,22,542,353,84,6,12,1,19
06/14/16,2,23,542,372,62,30,3,0,33
06/14/16,2,24,7625,339,98,11,6,3,20
06/14/16,2,25,542,375,70,10,11,1,22
06/14/16,2,27,542,368,86,20,5,1,26
06/14/16,2,28,8032,325,85,5,23,5,33
06/14/16,3,1,996,302,90,52,9,6,67
06/14/16,3,2,738,314,87,14,22,6,42
06/14/16,3,3,996,300,11,7,2,1,10
06/14/16,3,4,999,330,120,21,11,5,37
06/14/16,3,5,8030,345,159,0,4,1,5
06/14/16,3,7,7742,339,135,14,17,3,34
06/14/16,3,8,781,350,113,29,7,1,37
06/14/16,3,10,3062,376,102,24,3,7,34
06/14/16,3,11,7652,347,130,24,7,8,39
06/14/16,3,13,715,346,158,0,9,0,9
06/14/16,3,15,715,354,139,0,7,0,7
06/14/16,3,16,7393,350,9,6,1,0,7
06/14/16,3,17,513,345,20,1,2,1,4
06/14/16,3,18,542,345,77,27,4,0,31
06/14/16,3,19,542,366,100,8,6,0,14
06/14/16,3,20,8040,344,50,18,21,1,40
06/14/16,3,22,542,353,52,4,13,0,17
06/14/16,3,23,542,372,47,26,8,0,34
06/14/16,3,24,7625,339,106,17,2,10,29
06/14/16,3,25,542,375,84,8,13,0,21
06/14/16,3,27,542,368,58,15,7,0,22
06/14/16,3,28,8032,325,18,3,2,2,7
06/15/16,1,1,996,302,99,35,22,5,62
06/15/16,1,2,738,314,106,31,15,3,49
06/15/16,1,3,996,300,49,10,5,13,28
06/15/16,1,4,999,330,116,39,14,6,59
06/15/16,1,5,8030,345,138,2,6,3,11
06/15/16,1,7,7742,339,69,8,10,3,21
06/15/16,1,8,781,350,47,9,2,1,12
06/15/16,1,10,3062,376,139,10,14,1,25
06/15/16,1,11,7652,347,117,23,6,2,31
06/15/16,1,13,715,346,160,2,3,1,6
06/15/16,1,15,715,354,124,1,19,1,21
06/15/16,1,16,7393,350,104,22,7,13,42
06/15/16,1,17,513,345,7,3,1,4,8
06/15/16,1,18,542,345,110,48,8,4,60
06/15/16,1,19,542,366,149,14,6,2,22
06/15/16,1,20,8040,344,110,27,14,3,44
06/15/16,1,21,542,350,10,3,0,2,5
06/15/16,1,23,542,372,106,21,5,1,27
06/15/16,1,24,7625,339,123,14,4,16,34
06/15/16,1,25,542,375,99,12,16,0,28
06/15/16,1,27,542,368,103,32,8,1,41
06/15/16,1,28,8032,325,67,2,17,3,22
06/15/16,2,1,996,302,87,34,9,3,46
06/15/16,2,2,738,314,101,29,16,1,46
06/15/16,2,3,996,300,98,25,6,4,35
06/15/16,2,4,999,330,100,21,8,4,33
06/15/16,2,5,8030,345,157,3,2,0,5
06/15/16,2,9,8035,350,11,0,2,1,3
06/15/16,2,10,3062,376,143,9,15,2,26
06/15/16,2,11,7652,347,136,23,5,2,30
06/15/16,2,13,715,346,148,3,4,1,8
06/15/16,2,15,715,354,121,2,15,0,17
06/15/16,2,16,7393,350,95,31,8,3,42
06/15/16,2,17,513,345,103,18,15,2,35
06/15/16,2,18,542,345,57,67,4,2,73
06/15/16,2,19,542,366,124,10,14,1,25
06/15/16,2,20,8040,344,137,23,10,2,35
06/15/16,2,21,542,350,62,20,4,19,43
06/15/16,2,23,542,372,8,2,0,0,2
06/15/16,2,24,7625,339,137,10,8,7,25
06/15/16,2,25,542,375,22,2,5,1,8
06/15/16,2,27,542,368,92,26,12,0,38
06/15/16,2,28,8032,325,57,1,14,2,17
06/15/16,3,1,996,302,78,68,8,5,81
06/15/16,3,2,738,314,120,23,7,3,33
06/15/16,3,3,996,300,96,16,7,10,33
06/15/16,3,4,999,330,106,14,15,6,35
06/15/16,3,5,8030,345,160,2,4,1,7
06/15/16,3,8,781,350,73,12,3,4,19
06/15/16,3,9,8035,350,148,4,9,2,15
06/15/16,3,10,3062,376,130,6,23,3,32
06/15/16,3,11,7652,347,130,22,6,2,30
06/15/16,3,13,715,346,150,4,5,1,10
06/15/16,3,15,715,354,115,0,16,0,16
06/15/16,3,16,7393,350,108,25,6,3,34
06/15/16,3,17,513,345,78,8,16,3,27
06/15/16,3,18,542,345,68,27,9,4,40
06/15/16,3,19,542,366,21,3,2,0,5
06/15/16,3,20,8040,344,60,17,18,1,36
06/15/16,3,21,542,350,41,19,8,0,27
06/15/16,3,22,542,353,52,4,13,0,17
06/15/16,3,23,542,372,72,30,0,0,30
06/15/16,3,24,7625,339,111,12,6,9,27
06/15/16,3,27,542,368,78,12,6,0,18
06/16/16,1,1,996,302,88,55,12,4,71
06/16/16,1,2,738,314,85,24,12,2,38
06/16/16,1,3,996,300,37,11,5,9,25
06/16/16,1,4,999,330,77,7,17,4,28
06/16/16,1,5,8030,345,144,3,2,1,6
06/16/16,1,8,781,350,123,28,6,1,35
06/16/16,1,9,8035,350,149,7,5,4,16
06/16/16,1,10,3062,376,136,14,13,2,29
06/16/16,1,11,7652,347,116,24,3,5,32
06/16/16,1,13,715,346,161,0,4,1,5
06/16/16,1,15,715,354,146,0,3,1,4
06/16/16,1,16,7393,350,106,19,13,4,36
06/16/16,1,17,513,345,145,19,10,1,30
06/16/16,1,18,542,345,54,67,8,2,77
06/16/16,1,21,542,350,37,46,3,0,49
06/16/16,1,22,542,353,5,3,3,0,6
06/16/16,1,23,542,372,117,29,7,1,37
06/16/16,1,24,7625,339,110,12,9,7,28
06/16/16,1,25,542,375,6,1,1,0,2
06/16/16,1,27,542,368,94,22,4,1,27
06/16/16,2,1,996,302,97,18,16,6,40
06/16/16,2,2,738,314,67,8,13,1,22
06/16/16,2,3,996,300,94,9,12,6,27
06/16/16,2,4,999,330,49,13,14,6,33
06/16/16,2,5,8030,345,161,2,2,1,5
06/16/16,2,8,781,350,114,18,8,1,27
06/16/16,2,9,8035,350,131,0,9,1,10
06/16/16,2,10,3062,376,151,9,16,3,28
06/16/16,2,11,7652,347,120,12,7,2,21
06/16/16,2,12,8032,350,21,7,8,5,20
06/16/16,2,13,715,346,150,1,5,2,8
06/16/16,2,15,715,354,140,0,11,0,11
06/16/16,2,16,7393,350,114,23,5,8,36
06/16/16,2,17,513,345,86,30,16,1,47
06/16/16,2,18,542,345,64,59,4,0,63
06/16/16,2,21,542,350,18,25,0,0,25
06/16/16,2,22,542,353,81,22,13,0,35
06/16/16,2,23,542,372,70,36,5,1,42
06/16/16,2,24,7625,339,94,13,9,7,29
06/16/16,2,25,542,375,81,20,12,0,32
06/16/16,2,27,542,368,59,24,6,0,30
06/16/16,3,2,738,314,78,15,10,6,31
06/16/16,3,3,996,300,99,19,7,8,34
06/16/16,3,4,999,330,78,48,9,4,61
06/16/16,3,5,8030,345,155,1,3,0,4
06/16/16,3,8,781,350,125,17,8,2,27
06/16/16,3,9,8035,350,153,0,5,1,6
06/16/16,3,10,3062,376,111,4,14,2,20
06/16/16,3,11,7652,347,105,20,5,2,27
06/16/16,3,12,8032,350,112,23,6,1,30
06/16/16,3,13,715,346,141,0,1,1,2
06/16/16,3,15,715,354,137,3,10,0,13
06/16/16,3,17,513,345,95,5,21,2,28
06/16/16,3,18,542,345,63,44,5,3,52
06/16/16,3,20,8040,344,22,13,5,0,18
06/16/16,3,21,542,350,22,26,1,0,27
06/16/16,3,22,542,353,88,17,11,0,28
06/16/16,3,23,542,372,18,7,1,0,8
06/16/16,3,24,7625,339,86,11,11,20,42
06/16/16,3,25,542,375,82,14,5,0,19
06/16/16,3,27,542,368,63,24,4,0,28
06/17/16,1,2,738,314,114,10,18,5,33
06/17/16,1,3,996,300,91,13,7,7,27
06/17/16,1,4,999,330,91,49,10,3,62
06/17/16,1,5,8030,345,147,0,6,6,12
06/17/16,1,7,92,339,79,4,9,3,16
06/17/16,1,8,781,350,125,20,8,2,30
06/17/16,1,9,8035,350,150,0,10,1,11
06/17/16,1,11,7652,347,135,16,18,8,42
06/17/16,1,12,8032,350,134,16,16,2,34
06/17/16,1,13,715,346,151,2,5,1,8
06/17/16,1,15,715,354,125,0,13,1,14
06/17/16,1,17,513,345,123,22,20,1,43
06/17/16,1,18,542,345,83,57,12,3,72
06/17/16,1,19,542,366,54,7,4,0,11
06/17/16,1,20,8040,344,63,33,21,4,58
06/17/16,1,21,542,350,65,43,7,0,50
06/17/16,1,22,542,353,102,15,17,1,33
06/17/16,1,24,7625,339,123,6,5,8,19
06/17/16,1,25,542,375,116,20,9,1,30
06/17/16,1,27,542,368,95,18,7,1,26
06/17/16,2,1,999,302,5,28,4,3,35
06/17/16,2,2,738,314,108,23,6,4,33
06/17/16,2,3,996,300,100,19,13,4,36
06/17/16,2,4,999,330,71,52,11,2,65
06/17/16,2,5,8030,345,147,1,6,1,8
06/17/16,2,7,92,339,141,11,8,3,22
06/17/16,2,8,781,350,136,14,5,1,20
06/17/16,2,9,8035,350,152,0,9,1,10
06/17/16,2,11,7652,347,104,23,19,3,45
06/17/16,2,12,8032,350,137,14,6,1,21
06/17/16,2,13,715,346,158,4,4,1,9
06/17/16,2,15,715,354,134,1,14,0,15
06/17/16,2,17,513,345,117,12,16,0,28
06/17/16,2,18,542,345,14,66,3,0,69
06/17/16,2,19,542,366,107,30,3,1,34
06/17/16,2,20,8040,344,76,45,10,1,56
06/17/16,2,21,542,350,60,44,5,0,49
06/17/16,2,22,542,353,78,17,6,1,24
06/17/16,2,24,7625,339,28,3,3,5,11
06/17/16,2,25,542,375,76,26,11,1,38
06/17/16,2,27,542,368,77,11,10,1,22
06/17/16,3,1,999,302,42,26,2,1,29
06/17/16,3,2,738,314,26,22,6,1,29
06/17/16,3,3,996,300,73,13,15,5,33
06/17/16,3,4,999,330,30,53,3,2,58
06/17/16,3,5,8030,345,149,0,0,0,0
06/17/16,3,7,92,339,98,19,14,4,37
06/17/16,3,8,781,350,109,9,7,1,17
06/17/16,3,9,8035,350,122,0,9,0,9
06/17/16,3,11,7652,347,90,15,11,3,29
06/17/16,3,12,8032,350,119,8,19,1,28
06/17/16,3,13,715,346,151,2,1,1,4
06/17/16,3,15,715,354,122,1,12,0,13
06/17/16,3,17,513,345,97,14,14,2,30
06/17/16,3,18,542,345,15,45,2,2,49
06/17/16,3,19,542,366,89,20,6,0,26
06/17/16,3,20,8040,344,86,47,3,4,54
06/17/16,3,21,542,350,51,37,7,0,44
06/17/16,3,22,542,353,89,24,8,0,32
06/17/16,3,25,542,375,80,31,10,0,41
06/17/16,3,27,542,368,100,15,10,0,25
06/20/16,1,1,999,302,80,45,14,4,63
06/20/16,1,2,738,314,100,31,6,12,49
06/20/16,1,3,996,300,56,12,8,4,24
06/20/16,1,4,999,330,41,96,4,3,103
06/20/16,1,5,8030,345,148,1,5,0,6
06/20/16,1,7,92,339,131,10,9,3,22
06/20/16,1,8,781,350,132,16,8,0,24
06/20/16,1,11,7652,347,114,31,4,2,37
06/20/16,1,12,8032,350,134,9,13,2,24
06/20/16,1,13,715,346,150,2,3,1,6
06/20/16,1,14,641,360,123,4,1,0,5
06/20/16,1,15,715,354,118,2,14,0,16
06/20/16,1,17,513,345,114,10,20,1,31
06/20/16,1,18,542,345,62,55,6,2,63
06/20/16,1,19,542,366,74,43,1,0,44
06/20/16,1,20,8040,344,99,29,10,3,42
06/20/16,1,21,542,350,63,31,9,0,40
06/20/16,1,22,542,353,57,23,7,0,30
06/20/16,1,23,542,372,27,12,3,0,15
06/20/16,1,25,542,375,105,19,3,0,22
06/20/16,1,27,542,368,63,14,9,0,23
06/20/16,2,1,999,302,90,21,4,6,31
06/20/16,2,2,738,314,110,17,12,1,30
06/20/16,2,4,999,330,64,44,9,4,57
06/20/16,2,5,8030,345,136,9,5,1,15
06/20/16,2,7,92,339,128,6,9,4,19
06/20/16,2,8,781,350,118,11,6,2,19
06/20/16,2,9,8035,350,143,2,7,6,15
06/20/16,2,11,7652,347,107,11,14,2,27
06/20/16,2,12,8032,350,140,4,12,4,20
06/20/16,2,13,715,346,157,2,1,1,4
06/20/16,2,15,715,354,136,0,11,0,11
06/20/16,2,17,513,345,135,6,17,3,26
06/20/16,2,18,542,345,54,65,2,0,67
06/20/16,2,19,542,366,106,26,4,0,30
06/20/16,2,20,8040,344,103,36,9,1,46
06/20/16,2,21,542,350,46,39,8,0,47
06/20/16,2,22,542,353,91,22,6,0,28
06/20/16,2,23,542,372,94,19,0,0,19
06/20/16,2,25,542,375,89,21,9,0,30
06/20/16,2,27,542,368,46,7,0,0,7
06/20/16,3,1,999,302,105,16,9,5,30
06/20/16,3,2,738,314,112,26,8,2,36
06/20/16,3,3,996,300,57,10,7,4,21
06/20/16,3,4,999,330,81,39,12,5,56
06/20/16,3,5,8030,345,90,2,5,2,9
06/20/16,3,7,92,339,150,6,11,3,20
06/20/16,3,8,781,350,112,15,7,2,24
06/20/16,3,9,8035,350,153,5,6,1,12
06/20/16,3,11,7652,347,151,10,5,3,18
06/20/16,3,12,8032,350,132,19,5,2,26
06/20/16,3,13,715,346,153,4,2,2,8
06/20/16,3,14,641,360,41,3,20,6,29
06/20/16,3,15,715,354,65,0,10,0,10
06/20/16,3,17,513,345,106,3,13,2,18
06/20/16,3,18,542,345,28,60,3,1,64
06/20/16,3,19,542,366,71,12,2,0,14
06/20/16,3,20,8040,344,47,29,6,2,37
06/20/16,3,21,542,350,48,14,8,0,22
06/20/16,3,22,542,353,61,7,8,0,15
06/20/16,3,23,542,372,50,20,3,0,23
06/20/16,3,25,542,375,70,10,6,0,16
06/21/16,1,1,999,302,101,28,9,5,42
06/21/16,1,2,738,314,119,23,6,2,31
06/21/16,1,3,996,300,107,15,22,9,46
06/21/16,1,4,999,330,81,39,21,5,65
06/21/16,1,7,92,339,145,8,4,2,14
06/21/16,1,8,781,350,99,17,2,1,20
06/21/16,1,9,8035,350,162,1,4,3,8
06/21/16,1,10,3062,376,45,10,4,4,18
06/21/16,1,11,7652,347,123,22,6,3,31
06/21/16,1,12,8032,350,123,19,7,3,29
06/21/16,1,13,715,346,163,0,2,0,2
06/21/16,1,14,641,360,101,2,13,6,21
06/21/16,1,15,715,354,145,1,9,1,11
06/21/16,1,17,513,345,100,9,23,1,33
06/21/16,1,18,542,345,76,72,3,3,78
06/21/16,1,19,542,366,110,29,6,1,36
06/21/16,1,20,8040,344,76,71,12,1,84
06/21/16,1,21,542,350,67,28,10,0,38
06/21/16,1,22,542,353,81,26,10,0,36
06/21/16,1,23,542,372,79,37,5,1,43
06/21/16,1,25,542,375,86,27,7,1,35
06/21/16,1,27,542,368,43,6,1,0,7
06/21/16,2,1,999,302,93,34,14,8,56
06/21/16,2,2,738,314,117,11,8,0,19
06/21/16,2,3,996,300,99,27,20,3,50
06/21/16,2,7,92,339,137,5,7,2,14
06/21/16,2,8,781,350,127,12,7,2,21
06/21/16,2,9,8035,350,157,0,8,3,11
06/21/16,2,10,3062,376,157,10,9,3,22
06/21/16,2,11,7652,347,121,9,15,6,30
06/21/16,2,12,8032,350,126,11,14,2,27
06/21/16,2,13,715,346,65,1,8,1,10
06/21/16,2,14,641,360,155,0,6,1,7
06/21/16,2,15,715,354,122,1,10,0,11
06/21/16,2,17,513,345,91,16,11,2,29
06/21/16,2,18,542,345,81,48,4,2,54
06/21/16,2,19,542,366,100,39,5,1,45
06/21/16,2,20,8040,344,73,67,4,5,76
06/21/16,2,21,542,350,59,32,8,0,40
06/21/16,2,22,542,353,86,8,16,1,25
06/21/16,2,23,542,372,55,44,3,0,47
06/21/16,2,24,7675,339,73,4,3,4,11
06/21/16,2,25,542,375,83,22,2,0,24
06/21/16,2,27,542,368,103,11,6,1,18
06/21/16,3,1,999,302,87,55,13,4,72
06/21/16,3,2,738,314,116,17,11,5,33
06/21/16,3,3,996,300,94,22,16,6,44
06/21/16,3,4,999,330,11,142,4,14,160
06/21/16,3,7,92,339,136,0,11,4,15
06/21/16,3,8,781,350,138,8,10,1,19
06/21/16,3,9,8035,350,159,1,7,1,9
06/21/16,3,10,3062,376,151,10,10,2,22
06/21/16,3,11,7652,347,125,22,8,5,35
06/21/16,3,12,8032,350,134,14,8,2,24
06/21/16,3,14,641,360,107,0,1,1,2
06/21/16,3,15,715,354,112,0,9,0,9
06/21/16,3,17,513,345,126,10,10,1,21
06/21/16,3,18,542,345,78,37,0,4,41
06/21/16,3,19,542,366,114,13,6,0,19
06/21/16,3,20,8040,344,57,38,5,2,45
06/21/16,3,21,542,350,34,26,4,0,30
06/21/16,3,22,542,353,45,4,9,0,13
06/21/16,3,23,542,372,75,35,1,0,36
06/21/16,3,25,542,375,63,35,3,0,38
06/21/16,3,27,542,368,65,13,5,0,18
06/22/16,1,1,999,302,12,8,25,3,36
06/22/16,1,2,738,314,100,25,13,2,40
06/22/16,1,3,996,300,90,31,11,7,49
06/22/16,1,4,999,330,105,25,8,3,36
06/22/16,1,7,92,339,136,5,9,2,16
06/22/16,1,8,781,350,125,9,10,4,23
06/22/16,1,9,8035,350,150,3,8,3,14
06/22/16,1,10,3062,376,142,7,13,2,22
06/22/16,1,11,7652,347,138,15,7,3,25
06/22/16,1,12,8032,350,90,9,6,4,19
06/22/16,1,13,715,346,53,3,4,4,11
06/22/16,1,14,641,360,145,1,15,2,18
06/22/16,1,15,715,354,150,0,13,1,14
06/22/16,1,17,513,345,129,16,16,1,33
06/22/16,1,18,542,345,127,49,11,6,66
06/22/16,1,19,542,366,139,19,8,2,29
06/22/16,1,20,8040,344,64,56,4,3,63
06/22/16,1,21,542,350,70,39,13,0,52
06/22/16,1,22,542,353,91,9,14,1,24
06/22/16,1,23,542,372,107,30,4,1,35
06/22/16,1,25,542,375,79,35,4,1,40
06/22/16,1,27,542,368,51,8,0,7,15
06/22/16,2,1,999,302,42,18,28,5,51
06/22/16,2,2,738,314,56,9,3,1,13
06/22/16,2,3,996,300,101,24,13,6,43
06/22/16,2,4,999,330,100,30,9,5,44
06/22/16,2,6,774,349,62,11,19,5,35
06/22/16,2,7,92,339,152,3,7,3,13
06/22/16,2,8,781,350,53,2,11,2,15
06/22/16,2,9,8035,350,142,1,3,1,5
06/22/16,2,10,3062,376,151,10,4,3,17
06/22/16,2,11,7652,347,149,6,6,3,15
06/22/16,2,13,715,346,146,0,6,1,7
06/22/16,2,14,641,360,141,0,8,1,9
06/22/16,2,15,715,354,95,1,23,0,24
06/22/16,2,17,513,345,126,13,8,2,23
06/22/16,2,18,542,345,81,27,13,1,41
06/22/16,2,19,542,366,90,31,3,0,34
06/22/16,2,20,8040,344,80,45,9,1,55
06/22/16,2,21,542,350,63,37,6,0,43
06/22/16,2,22,542,353,58,21,9,0,30
06/22/16,2,23,542,372,48,45,1,0,46
06/22/16,2,24,7675,339,76,14,5,3,22
06/22/16,2,25,542,375,105,26,3,0,29
06/22/16,3,1,999,302,89,43,14,5,62
06/22/16,3,2,738,314,109,27,10,2,39
06/22/16,3,3,996,300,77,49,10,4,63
06/22/16,3,4,999,330,90,24,8,7,39
06/22/16,3,6,774,349,125,10,10,1,21
06/22/16,3,7,92,339,133,15,7,2,24
06/22/16,3,9,8035,350,155,1,5,4,10
06/22/16,3,10,3062,376,154,11,12,3,26
06/22/16,3,11,7652,347,35,12,5,2,19
06/22/16,3,13,715,346,146,1,6,0,7
06/22/16,3,14,641,360,160,0,3,1,4
06/22/16,3,15,715,354,123,0,13,0,13
06/22/16,3,17,513,345,109,19,7,2,28
06/22/16,3,18,542,345,55,14,6,1,21
06/22/16,3,19,542,366,103,19,0,0,19
06/22/16,3,20,8040,344,107,19,4,1,24
06/22/16,3,21,542,350,45,24,8,0,32
06/22/16,3,22,542,353,70,12,13,0,25
06/22/16,3,23,542,372,57,25,4,0,29
06/22/16,3,24,7675,339,86,17,6,8,31
06/22/16,3,25,542,375,89,17,8,0,25
06/23/16,1,1,999,302,72,51,9,4,64
06/23/16,1,2,738,314,120,25,6,2,33
06/23/16,1,3,996,300,86,46,12,5,63
06/23/16,1,4,999,330,92,27,10,5,42
06/23/16,1,6,774,349,109,18,22,2,42
06/23/16,1,7,92,339,131,7,8,2,17
06/23/16,1,9,8035,350,147,1,9,2,12
06/23/16,1,10,3062,376,142,15,7,2,24
06/23/16,1,11,7652,347,10,0,2,0,2
06/23/16,1,12,8032,350,23,5,5,4,14
06/23/16,1,13,715,346,156,0,4,2,6
06/23/16,1,14,641,360,164,1,1,1,3
06/23/16,1,15,715,354,85,0,16,0,16
06/23/16,1,17,513,345,140,6,11,5,22
06/23/16,1,19,542,366,117,23,6,1,30
06/23/16,1,20,8040,344,87,21,8,3,32
06/23/16,1,21,542,350,67,34,14,0,48
06/23/16,1,22,542,353,73,14,11,1,26
06/23/16,1,23,542,372,100,32,4,1,37
06/23/16,1,24,7675,339,99,20,5,6,31
06/23/16,1,25,542,375,66,35,2,0,37
06/23/16,1,27,542,368,26,5,0,0,5
06/23/16,1,28,1001,325,10,7,8,22,37
06/23/16,2,1,999,302,71,35,8,4,47
06/23/16,2,2,738,314,97,31,8,1,40
06/23/16,2,3,996,300,49,57,4,2,63
06/23/16,2,4,999,330,82,19,9,4,32
06/23/16,2,6,774,349,111,14,12,2,28
06/23/16,2,7,92,339,144,4,9,2,15
06/23/16,2,9,8035,350,134,0,13,1,14
06/23/16,2,10,3062,376,136,13,11,4,28
06/23/16,2,11,7652,347,97,14,5,2,21
06/23/16,2,12,8032,350,103,7,23,1,31
06/23/16,2,13,715,346,141,1,6,1,8
06/23/16,2,14,641,360,161,0,4,0,4
06/23/16,2,15,715,354,115,0,10,0,10
06/23/16,2,17,513,345,54,5,4,1,10
06/23/16,2,19,542,366,112,19,3,1,23
06/23/16,2,20,8040,344,99,15,12,1,28
06/23/16,2,21,542,350,51,33,7,0,40
06/23/16,2,22,542,353,91,17,12,0,29
06/23/16,2,23,542,372,59,42,7,1,50
06/23/16,2,24,7675,339,114,17,9,6,32
06/23/16,2,25,542,375,98,22,2,1,25
06/23/16,2,27,542,368,136,9,4,1,14
06/23/16,2,28,1001,325,108,9,14,8,31
06/23/16,3,1,999,302,78,38,14,8,60
06/23/16,3,2,738,314,101,32,7,1,40
06/23/16,3,3,996,300,70,75,8,7,90
06/23/16,3,4,999,330,88,30,10,6,46
06/23/16,3,6,774,349,128,16,25,1,42
06/23/16,3,7,92,339,144,8,8,2,18
06/23/16,3,9,8035,350,147,0,7,4,11
06/23/16,3,10,3062,376,157,8,6,4,18
06/23/16,3,11,7652,347,122,30,9,4,43
06/23/16,3,12,8032,350,111,17,21,1,39
06/23/16,3,13,715,346,143,0,8,0,8
06/23/16,3,14,641,360,146,2,14,2,18
06/23/16,3,15,715,354,123,0,11,0,11
06/23/16,3,19,542,366,96,14,4,0,18
06/23/16,3,20,8040,344,62,20,6,2,28
06/23/16,3,21,542,350,44,26,4,0,30
06/23/16,3,22,542,353,68,13,7,0,20
06/23/16,3,23,542,372,48,31,3,0,34
06/23/16,3,24,7675,339,99,16,2,4,22
06/23/16,3,25,542,375,76,20,5,0,25
06/23/16,3,27,542,368,63,31,0,0,31
06/23/16,3,28,1001,325,80,10,7,10,27
06/24/16,1,1,999,302,83,35,13,6,54
06/24/16,1,2,738,314,26,7,0,4,11
06/24/16,1,3,996,300,77,72,12,3,87
06/24/16,1,4,999,330,25,8,13,3,24
06/24/16,1,6,774,349,104,13,8,2,23
06/24/16,1,7,92,339,144,0,0,1,1
06/24/16,1,9,8035,350,149,0,11,1,12
06/24/16,1,10,3062,376,160,8,7,2,17
06/24/16,1,11,7652,347,134,23,6,2,31
06/24/16,1,12,8032,350,119,16,17,3,36
06/24/16,1,13,715,346,149,3,6,2,11
06/24/16,1,14,641,360,26,0,7,1,8
06/24/16,1,15,715,354,134,0,18,4,22
06/24/16,1,17,513,345,9,2,1,3,6
06/24/16,1,18,542,345,52,11,2,0,13
06/24/16,1,19,542,366,135,20,4,1,25
06/24/16,1,20,8040,344,94,27,15,2,44
06/24/16,1,21,542,350,58,48,8,0,56
06/24/16,1,22,542,353,81,17,12,1,30
06/24/16,1,23,542,372,99,33,5,1,39
06/24/16,1,24,7675,339,128,15,5,9,29
06/24/16,1,25,542,375,83,22,7,1,30
06/24/16,1,27,542,368,33,28,2,0,30
06/24/16,1,28,1001,325,89,29,10,7,46
06/24/16,2,1,999,302,82,23,13,2,38
06/24/16,2,3,996,300,51,52,6,7,65
06/24/16,2,4,999,330,86,9,36,3,48
06/24/16,2,6,774,349,118,12,22,3,37
06/24/16,2,7,92,339,144,4,8,2,14
06/24/16,2,10,3062,376,146,12,9,2,23
06/24/16,2,11,7652,347,119,26,8,2,36
06/24/16,2,12,8032,350,103,20,17,1,38
06/24/16,2,13,715,346,126,0,9,1,10
06/24/16,2,15,715,354,19,0,3,0,3
06/24/16,2,17,513,345,105,37,7,1,45
06/24/16,2,18,542,345,79,33,12,1,46
06/24/16,2,19,542,366,9,1,1,0,2
06/24/16,2,20,8040,344,2,0,0,1,1
06/24/16,2,21,542,350,42,45,3,0,48
06/24/16,2,22,542,353,76,36,4,0,40
06/24/16,2,23,542,372,64,38,7,0,45
06/24/16,2,24,7675,339,138,7,6,6,19
06/24/16,2,25,542,375,94,35,4,0,39
06/24/16,2,27,542,368,110,17,2,0,19
06/24/16,2,28,1001,325,116,15,7,3,25
06/24/16,3,1,999,302,89,20,19,8,47
06/24/16,3,3,996,300,19,9,6,5,20
06/24/16,3,4,999,330,94,14,23,5,42
06/24/16,3,6,774,349,136,9,14,3,26
06/24/16,3,7,92,339,35,1,6,10,17
06/24/16,3,10,3062,376,62,11,1,3,15
06/24/16,3,11,7652,347,59,13,3,1,17
06/24/16,3,12,8032,350,103,20,19,2,41
06/24/16,3,13,715,346,153,0,5,2,7
06/24/16,3,17,513,345,97,37,7,2,46
06/24/16,3,18,542,345,96,38,8,6,52
06/24/16,3,21,542,350,45,29,5,0,34
06/24/16,3,22,542,353,71,22,11,0,33
06/24/16,3,23,542,372,106,28,3,0,31
06/24/16,3,24,7675,339,112,7,11,11,29
06/24/16,3,27,542,368,118,14,0,0,14
06/24/16,3,28,1001,325,118,13,7,11,31
06/27/16,1,1,999,302,53,13,11,24,48
06/27/16,1,2,738,314,12,3,10,2,15
06/27/16,1,3,996,300,53,22,3,5,30
06/27/16,1,4,999,330,77,18,29,2,49
06/27/16,1,6,774,349,104,23,16,1,40
06/27/16,1,10,3062,376,101,13,17,2,32
06/27/16,1,11,7652,347,82,20,12,1,33
06/27/16,1,12,8032,350,103,7,7,1,15
06/27/16,1,13,715,346,137,2,10,0,12
06/27/16,1,15,715,354,26,0,11,0,11
06/27/16,1,17,513,345,120,38,5,3,46
06/27/16,1,18,542,345,125,29,6,1,36
06/27/16,1,21,542,350,106,23,13,0,36
06/27/16,1,22,542,353,110,11,11,1,23
06/27/16,1,23,542,372,125,36,5,1,42
06/27/16,1,24,7675,339,4,0,1,0,1
06/27/16,1,27,542,368,45,7,0,0,7
06/27/16,1,28,1001,325,90,8,9,6,23
06/27/16,2,2,738,314,67,25,11,23,59
06/27/16,2,3,996,300,74,32,7,8,47
06/27/16,2,4,999,330,81,11,31,7,49
06/27/16,2,6,774,349,118,12,14,0,26
06/27/16,2,10,3062,376,118,16,4,5,25
06/27/16,2,11,7652,347,83,24,15,5,44
06/27/16,2,12,8032,350,108,19,16,1,36
06/27/16,2,13,715,346,159,1,3,1,5
06/27/16,2,15,715,354,125,0,18,0,18
06/27/16,2,17,513,345,127,35,7,1,43
06/27/16,2,18,542,345,145,23,6,2,31
06/27/16,2,19,542,366,74,5,3,1,9
06/27/16,2,21,542,350,124,7,22,0,29
06/27/16,2,23,542,372,125,36,5,1,42
06/27/16,2,27,542,368,148,17,5,1,23
06/27/16,2,28,1001,325,114,13,13,8,34
06/27/16,3,2,738,314,83,25,10,3,38
06/27/16,3,3,996,300,104,28,3,3,34
06/27/16,3,4,999,330,70,7,22,0,29
06/27/16,3,6,774,349,127,11,16,0,27
06/27/16,3,7,92,339,35,1,6,10,17
06/27/16,3,10,3062,376,39,2,2,3,7
06/27/16,3,11,7652,347,81,19,23,6,48
06/27/16,3,12,8032,350,109,12,16,2,30
06/27/16,3,13,715,346,150,0,4,1,5
06/27/16,3,15,715,354,124,1,14,0,15
06/27/16,3,17,513,345,121,18,7,2,27
06/27/16,3,18,542,345,100,29,9,2,40
06/27/16,3,19,542,366,76,32,6,0,38
06/27/16,3,21,542,350,81,5,16,0,21
06/27/16,3,23,542,372,99,44,3,0,47
06/27/16,3,27,542,368,107,12,5,0,17
06/27/16,3,28,1001,325,71,3,14,4,21
06/28/16,1,2,738,314,95,25,17,4,46
06/28/16,1,3,996,300,100,23,8,5,36
06/28/16,1,4,999,330,101,12,24,5,41
06/28/16,1,6,774,349,121,9,15,0,24
06/28/16,1,11,7652,347,96,15,12,4,31
06/28/16,1,12,8032,350,118,15,13,1,29
06/28/16,1,13,715,346,160,0,5,1,6
06/28/16,1,15,715,354,126,1,13,1,15
06/28/16,1,17,513,345,136,33,13,1,47
06/28/16,1,18,542,345,123,43,9,1,53
06/28/16,1,19,542,366,147,15,8,2,25
06/28/16,1,21,542,350,138,4,33,0,37
06/28/16,1,22,542,353,12,6,1,0,7
06/28/16,1,23,542,372,101,48,9,1,58
06/28/16,1,24,7675,339,82,9,7,11,27
06/28/16,1,27,542,368,137,15,5,2,22
06/28/16,1,28,1001,325,7,3,1,2,6
06/28/16,2,2,738,314,98,14,7,3,24
06/28/16,2,3,996,300,100,18,7,4,29
06/28/16,2,4,999,330,71,13,30,6,49
06/28/16,2,6,774,349,90,10,21,0,31
06/28/16,2,11,7652,347,98,16,10,1,27
06/28/16,2,12,8032,350,127,10,14,2,26
06/28/16,2,13,715,346,117,0,11,0,11
06/28/16,2,15,715,354,130,3,9,0,12
06/28/16,2,17,513,345,109,62,5,4,71
06/28/16,2,18,542,345,125,39,2,2,43
06/28/16,2,19,542,366,133,10,10,0,20
06/28/16,2,21,542,350,87,2,22,0,24
06/28/16,2,22,542,353,79,28,16,0,44
06/28/16,2,23,542,372,75,57,3,0,60
06/28/16,2,24,7675,339,119,12,3,6,21
06/28/16,2,27,542,368,145,13,6,0,19
06/28/16,2,28,1001,325,115,13,3,2,18
06/28/16,3,2,738,314,76,28,5,3,36
06/28/16,3,3,996,300,101,17,8,6,31
06/28/16,3,6,774,349,120,14,21,3,38
06/28/16,3,11,7652,347,115,31,7,3,41
06/28/16,3,12,8032,350,109,6,24,4,34
06/28/16,3,13,715,346,135,1,10,3,14
06/28/16,3,15,715,354,110,0,14,0,14
06/28/16,3,17,513,345,106,26,4,2,32
06/28/16,3,18,542,345,97,34,6,2,42
06/28/16,3,19,542,366,119,13,6,0,19
06/28/16,3,21,542,350,9,1,3,0,4
06/28/16,3,22,542,353,65,28,11,0,39
06/28/16,3,23,542,372,61,48,0,0,48
06/28/16,3,24,7675,339,51,26,4,10,40
06/28/16,3,25,542,375,52,11,6,0,17
06/28/16,3,27,542,368,80,31,3,0,34
06/28/16,3,28,1001,325,102,24,3,3,30
06/29/16,1,2,738,314,114,18,10,0,28
06/29/16,1,3,996,300,107,12,6,9,27
06/29/16,1,4,999,330,46,8,9,11,28
06/29/16,1,6,774,349,135,9,22,3,34
06/29/16,1,11,7652,347,152,18,3,2,23
06/29/16,1,12,8032,350,128,15,18,4,37
06/29/16,1,13,715,346,160,0,7,1,8
06/29/16,1,15,715,354,112,0,12,0,12
06/29/16,1,17,513,345,138,27,6,1,34
06/29/16,1,18,542,345,134,43,7,1,51
06/29/16,1,19,542,366,151,15,7,1,23
06/29/16,1,22,542,353,110,41,16,1,58
06/29/16,1,23,542,372,2,1,1,0,2
06/29/16,1,24,7675,339,110,17,8,13,38
06/29/16,1,25,542,375,123,27,8,1,36
06/29/16,1,26,495,360,62,11,6,0,17
06/29/16,1,27,542,368,141,17,3,1,21
06/29/16,1,28,1001,325,129,21,5,2,28
06/29/16,2,2,738,314,95,16,19,0,35
06/29/16,2,3,996,300,97,13,5,0,18
06/29/16,2,4,999,330,98,13,9,14,36
06/29/16,2,6,774,349,101,22,16,2,40
06/29/16,2,11,7652,347,86,18,12,1,31
06/29/16,2,12,8032,350,114,3,19,2,24
06/29/16,2,13,715,346,154,0,5,1,6
06/29/16,2,15,715,354,124,0,13,1,14
06/29/16,2,17,513,345,132,19,5,2,26
06/29/16,2,18,542,345,94,56,7,1,64
06/29/16,2,19,542,366,146,18,5,1,24
06/29/16,2,22,542,353,65,10,14,1,25
06/29/16,2,24,7675,339,131,10,2,2,14
06/29/16,2,25,542,375,116,19,12,1,32
06/29/16,2,26,495,360,57,8,4,0,12
06/29/16,2,27,542,368,110,11,2,1,14
06/29/16,2,28,1001,325,135,14,3,4,21
06/29/16,3,2,738,314,106,13,13,2,28
06/29/16,3,3,996,300,109,11,7,6,24
06/29/16,3,4,999,330,102,10,10,17,37
06/29/16,3,6,774,349,124,9,23,2,34
06/29/16,3,11,7652,347,80,17,38,3,58
06/29/16,3,12,8032,350,120,4,21,3,28
06/29/16,3,13,715,346,160,0,3,0,3
06/29/16,3,15,715,354,147,1,8,0,9
06/29/16,3,17,513,345,122,24,11,2,37
06/29/16,3,18,542,345,94,60,3,1,64
06/29/16,3,19,542,366,134,12,8,0,20
06/29/16,3,24,7675,339,82,24,7,3,34
06/29/16,3,25,542,375,92,29,5,0,34
06/29/16,3,27,542,368,8,3,0,0,3
06/29/16,3,28,1001,325,38,15,6,2,23
06/30/16,1,2,738,314,93,9,12,3,24
06/30/16,1,3,996,300,103,21,5,8,34
06/30/16,1,4,999,330,75,7,10,17,34
06/30/16,1,5,7113,345,86,13,4,9,26
06/30/16,1,6,774,349,140,14,11,0,25
06/30/16,1,7,642,339,5,1,6,13,20
06/30/16,1,11,7652,347,95,12,32,12,56
06/30/16,1,12,8032,350,125,6,15,2,23
06/30/16,1,13,715,346,158,2,7,2,11
06/30/16,1,15,715,354,155,0,10,1,11
06/30/16,1,17,513,345,146,27,6,1,34
06/30/16,1,18,542,345,147,36,6,1,43
06/30/16,1,19,542,366,150,12,6,0,18
06/30/16,1,24,7675,339,62,19,2,6,27
06/30/16,1,25,542,375,111,26,11,1,38
06/30/16,2,2,738,314,98,20,6,0,26
06/30/16,2,3,996,300,22,3,4,2,9
06/30/16,2,4,999,330,103,9,11,15,35
06/30/16,2,5,7113,345,106,27,7,2,36
06/30/16,2,6,774,349,101,12,19,0,31
06/30/16,2,7,642,339,91,28,4,0,32
06/30/16,2,11,7652,347,95,15,19,3,37
06/30/16,2,12,8032,350,116,7,16,3,26
06/30/16,2,13,715,346,165,0,2,1,3
06/30/16,2,15,715,354,112,0,19,0,19
06/30/16,2,17,513,345,135,28,4,2,34
06/30/16,2,18,542,345,122,28,11,2,41
06/30/16,2,19,542,366,148,8,9,1,18
06/30/16,2,21,542,350,13,3,3,0,6
06/30/16,2,24,7675,339,132,14,7,1,22
06/30/16,2,25,542,375,120,23,7,1,31
06/30/16,3,2,738,314,101,13,14,1,28
06/30/16,3,4,999,330,87,15,14,14,43
06/30/16,3,5,7113,345,112,16,4,2,22
06/30/16,3,6,774,349,110,15,8,0,23
06/30/16,3,7,642,339,120,17,0,2,19
06/30/16,3,11,7652,347,98,28,4,1,33
06/30/16,3,12,8032,350,93,7,28,2,37
06/30/16,3,13,715,346,122,0,4,1,5
06/30/16,3,15,715,354,97,0,7,1,8
06/30/16,3,17,513,345,97,31,9,0,40
06/30/16,3,18,542,345,73,44,31,0,75
06/30/16,3,19,542,366,41,3,0,0,3
06/30/16,3,21,542,350,88,8,16,0,24
06/30/16,3,23,542,372,25,33,0,0,33
06/30/16,3,24,7675,339,82,10,5,5,20
06/30/16,3,25,542,375,66,28,3,0,31
07/01/16,1,1,726,302,48,25,8,12,45
07/01/16,1,2,738,314,60,10,6,2,18
07/01/16,1,3,996,300,13,3,2,2,7
07/01/16,1,4,999,330,70,12,11,24,47
07/01/16,1,5,7113,345,124,26,1,4,31
07/01/16,1,6,774,349,120,22,17,2,41
07/01/16,1,7,642,339,100,7,6,4,17
07/01/16,1,11,7652,347,124,25,11,1,37
07/01/16,1,12,8032,350,113,11,20,4,35
07/01/16,1,13,715,346,166,0,1,1,2
07/01/16,1,15,715,354,78,13,4,0,17
07/01/16,1,17,513,345,129,31,10,5,46
07/01/16,1,18,542,345,30,7,4,1,12
07/01/16,1,19,542,366,33,5,2,1,8
07/01/16,1,21,542,350,95,20,40,0,60
07/01/16,1,22,542,353,66,18,12,0,30
07/01/16,1,23,542,372,101,44,4,0,48
07/01/16,1,24,7675,339,117,16,6,8,30
07/01/16,1,25,542,375,133,23,9,1,33
07/01/16,1,27,542,368,8,5,2,0,7
07/01/16,2,1,726,302,59,32,11,6,49
07/01/16,2,2,738,314,80,23,7,2,32
07/01/16,2,3,996,300,57,20,3,20,43
07/01/16,2,5,7113,345,85,29,3,1,33
07/01/16,2,6,774,349,65,32,8,4,44
07/01/16,2,7,642,339,100,19,1,1,21
07/01/16,2,9,776,350,45,16,4,0,20
07/01/16,2,11,7652,347,85,17,7,0,24
07/01/16,2,12,8032,350,72,6,15,1,22
07/01/16,2,13,715,346,32,0,2,1,3
07/01/16,2,15,715,354,129,7,13,1,21
07/01/16,2,17,513,345,136,20,5,1,26
07/01/16,2,19,542,366,142,6,9,1,16
07/01/16,2,21,542,350,102,8,22,0,30
07/01/16,2,22,542,353,96,23,14,1,38
07/01/16,2,23,542,372,84,39,3,1,43
07/01/16,2,24,7675,339,49,11,3,3,17
07/01/16,2,25,542,375,94,14,11,1,26
07/01/16,2,26,7649,360,18,7,1,0,8
07/01/16,2,28,1001,325,88,19,14,6,39
07/01/16,3,1,726,302,91,24,12,0,36
07/01/16,3,2,738,314,12,4,4,0,8
07/01/16,3,3,996,300,90,29,2,4,35
07/01/16,3,5,7113,345,120,16,0,1,17
07/01/16,3,6,774,349,103,10,17,3,30
07/01/16,3,7,642,339,128,5,21,1,27
07/01/16,3,9,776,350,78,37,3,0,40
07/01/16,3,11,7652,347,125,16,0,0,16
07/01/16,3,15,715,354,61,7,9,0,16
07/05/16,1,1,726,302,42,9,5,8,22
07/05/16,1,3,996,300,95,17,4,7,28
07/05/16,1,5,7113,345,81,27,3,6,36
07/05/16,1,6,774,349,127,13,24,1,38
07/05/16,1,7,642,339,141,23,4,1,28
07/05/16,1,9,776,350,110,32,29,1,62
07/05/16,1,11,7652,347,134,21,5,1,27
07/05/16,1,14,641,360,44,14,5,6,25
07/05/16,1,15,715,354,112,0,13,1,14
07/05/16,1,17,513,345,67,22,6,3,31
07/05/16,1,19,542,366,98,9,4,1,14
07/05/16,1,21,542,350,87,9,25,0,34
07/05/16,1,22,542,353,121,20,15,1,36
07/05/16,1,23,542,372,114,39,5,1,45
07/05/16,1,25,542,375,107,19,7,1,27
07/05/16,1,28,1001,325,110,33,13,6,52
07/05/16,2,1,726,302,73,11,10,3,24
07/05/16,2,3,996,300,108,25,6,6,37
07/05/16,2,5,7113,345,119,27,4,2,33
07/05/16,2,6,774,349,114,19,15,2,36
07/05/16,2,7,642,339,156,2,1,2,5
07/05/16,2,9,776,350,100,21,4,3,28
07/05/16,2,10,3062,376,70,4,15,4,23
07/05/16,2,11,7652,347,115,19,10,0,29
07/05/16,2,14,641,360,125,16,3,0,19
07/05/16,2,15,715,354,116,2,15,0,17
07/05/16,2,21,542,350,90,9,24,0,33
07/05/16,2,22,542,353,80,36,8,1,45
07/05/16,2,23,542,372,125,20,8,1,29
07/05/16,2,25,542,375,125,18,11,2,31
07/05/16,2,28,1001,325,111,19,14,2,35
07/05/16,3,2,738,314,26,9,20,2,31
07/05/16,3,3,996,300,81,20,6,7,33
07/05/16,3,5,7113,345,116,18,1,2,21
07/05/16,3,6,774,349,98,5,20,2,27
07/05/16,3,7,642,339,156,2,2,0,4
07/05/16,3,9,776,350,128,19,7,1,27
07/05/16,3,10,3062,376,104,15,17,2,34
07/05/16,3,11,7652,347,104,15,17,1,33
07/05/16,3,12,8032,350,61,17,23,1,41
07/05/16,3,14,641,360,60,23,4,2,29
07/05/16,3,15,715,354,105,0,8,1,9
07/05/16,3,21,542,350,57,17,7,0,24
07/05/16,3,22,542,353,73,22,9,1,32
07/05/16,3,23,542,372,83,17,6,1,24
07/05/16,3,25,542,375,88,19,6,0,25
07/05/16,3,28,1001,325,87,5,7,4,16
07/06/16,1,2,738,314,114,7,22,7,36
07/06/16,1,3,996,300,111,21,6,11,38
07/06/16,1,5,7113,345,129,25,4,5,34
07/06/16,1,7,642,339,150,6,1,1,8
07/06/16,1,9,776,350,141,12,10,3,25
07/06/16,1,10,3062,376,148,13,22,2,37
07/06/16,1,11,7652,347,121,22,14,2,38
07/06/16,1,12,8032,350,121,18,18,3,39
07/06/16,1,13,8035,346,19,3,6,22,31
07/06/16,1,14,641,360,92,13,4,0,17
07/06/16,1,15,715,354,135,1,14,0,15
07/06/16,1,18,542,345,46,7,2,3,12
07/06/16,1,21,542,350,110,16,17,0,33
07/06/16,1,22,542,353,131,22,20,1,43
07/06/16,1,23,542,372,149,15,12,1,28
07/06/16,1,25,542,375,155,16,9,2,27
07/06/16,1,27,542,368,25,17,2,0,19
07/06/16,1,28,1001,325,115,33,9,5,47
07/06/16,2,2,738,314,83,14,28,2,44
07/06/16,2,3,996,300,52,14,1,5,20
07/06/16,2,5,7113,345,113,19,6,2,27
07/06/16,2,7,642,339,142,5,4,1,10
07/06/16,2,8,7331,350,19,4,2,5,11
07/06/16,2,9,776,350,110,13,15,1,29
07/06/16,2,10,3062,376,123,17,23,2,42
07/06/16,2,11,7652,347,110,16,12,0,28
07/06/16,2,12,8032,350,92,16,21,1,38
07/06/16,2,13,8035,346,111,11,14,1,26
07/06/16,2,14,641,360,126,14,1,1,16
07/06/16,2,15,715,354,141,1,8,1,10
07/06/16,2,18,542,345,96,18,5,1,24
07/06/16,2,19,542,366,36,27,4,0,31
07/06/16,2,21,542,350,100,12,14,0,26
07/06/16,2,22,542,353,94,10,12,1,23
07/06/16,2,23,542,372,143,19,12,0,31
07/06/16,2,25,542,375,92,15,13,1,29
07/06/16,2,27,542,368,105,27,4,1,32
07/06/16,2,28,1001,325,88,13,21,6,40
07/06/16,3,2,738,314,82,11,26,1,38
07/06/16,3,3,996,300,63,7,10,0,17
07/06/16,3,5,7113,345,111,11,3,1,15
07/06/16,3,7,642,339,113,8,5,1,14
07/06/16,3,8,7331,350,84,12,0,2,14
07/06/16,3,9,776,350,76,10,4,3,17
07/06/16,3,10,3062,376,76,5,21,5,31
07/06/16,3,11,7652,347,47,8,23,3,34
07/06/16,3,12,8032,350,58,8,18,1,27
07/06/16,3,13,8035,346,82,3,7,3,13
07/06/16,3,14,641,360,130,6,2,2,10
07/06/16,3,15,715,354,135,0,9,0,9
07/06/16,3,18,542,345,76,12,3,2,17
07/06/16,3,19,542,366,36,32,2,0,34
07/06/16,3,21,542,350,27,7,1,0,8
07/06/16,3,22,542,353,47,18,8,0,26
07/06/16,3,23,542,372,79,16,3,1,20
07/06/16,3,25,542,375,54,7,8,0,15
07/06/16,3,27,542,368,61,13,4,0,17
07/06/16,3,28,1001,325,34,9,8,5,22
07/07/16,1,1,726,302,65,9,12,0,21
07/07/16,1,2,738,314,104,21,27,2,50
07/07/16,1,3,996,300,109,34,7,10,51
07/07/16,1,5,7113,345,21,4,4,1,9
07/07/16,1,6,774,349,58,22,5,8,35
07/07/16,1,7,642,339,143,14,0,1,15
07/07/16,1,8,7331,350,119,20,0,2,22
07/07/16,1,9,776,350,88,34,18,0,52
07/07/16,1,10,3062,376,117,39,10,3,52
07/07/16,1,11,7652,347,26,1,0,3,4
07/07/16,1,12,8032,350,113,15,18,4,37
07/07/16,1,13,8035,346,116,11,9,4,24
07/07/16,1,14,641,360,125,7,9,2,18
07/07/16,1,15,715,354,154,0,11,1,12
07/07/16,1,18,542,345,130,26,6,1,33
07/07/16,1,19,542,366,58,29,5,1,35
07/07/16,1,21,542,350,120,17,15,0,32
07/07/16,1,22,542,353,98,12,15,1,28
07/07/16,1,23,542,372,118,20,7,1,28
07/07/16,1,25,542,375,110,29,9,1,39
07/07/16,1,27,542,368,124,18,11,1,30
07/07/16,2,1,726,302,98,22,15,3,40
07/07/16,2,2,738,314,99,7,28,2,37
07/07/16,2,3,996,300,74,34,8,4,46
07/07/16,2,6,774,349,120,33,5,0,38
07/07/16,2,7,642,339,144,9,1,2,12
07/07/16,2,8,7331,350,148,7,2,4,13
07/07/16,2,9,776,350,103,16,12,3,31
07/07/16,2,10,3062,376,127,22,21,3,46
07/07/16,2,12,8032,350,87,29,27,2,58
07/07/16,2,13,8035,346,130,2,8,0,10
07/07/16,2,14,641,360,137,7,8,3,18
07/07/16,2,15,715,354,142,2,11,0,13
07/07/16,2,18,542,345,132,20,4,1,25
07/07/16,2,19,542,366,85,45,3,0,48
07/07/16,2,20,8040,344,82,22,25,6,53
07/07/16,2,21,542,350,123,19,6,0,25
07/07/16,2,22,542,353,106,25,12,1,38
07/07/16,2,23,542,372,122,33,6,1,40
07/07/16,2,27,542,368,115,20,9,1,30
07/07/16,3,1,726,302,96,20,14,2,36
07/07/16,3,2,738,314,97,9,21,0,30
07/07/16,3,3,996,300,45,25,2,8,35
07/07/16,3,6,774,349,50,53,3,0,56
07/07/16,3,7,642,339,126,5,6,0,11
07/07/16,3,8,7331,350,88,14,3,2,19
07/07/16,3,9,776,350,53,15,6,1,22
07/07/16,3,10,3062,376,66,13,11,1,25
07/07/16,3,12,8032,350,54,7,15,0,22
07/07/16,3,13,8035,346,114,11,4,3,18
07/07/16,3,14,641,360,103,5,10,1,16
07/07/16,3,15,715,354,119,0,6,0,6
07/07/16,3,18,542,345,95,18,10,2,30
07/07/16,3,19,542,366,48,41,5,0,46
07/07/16,3,20,8040,344,56,22,18,3,43
07/07/16,3,21,542,350,74,20,3,0,23
07/07/16,3,22,542,353,56,17,11,0,28
07/07/16,3,23,542,372,82,23,3,0,26
07/07/16,3,27,542,368,98,10,3,1,14
07/08/16,1,1,726,302,85,15,13,1,29
07/08/16,1,2,738,314,109,13,26,0,39
07/08/16,1,3,996,300,105,29,10,5,44
07/08/16,1,5,8030,345,6,0,2,7,9
07/08/16,1,6,774,349,100,10,6,0,16
07/08/16,1,7,642,339,154,1,4,1,6
07/08/16,1,8,7331,350,140,10,7,4,21
07/08/16,1,9,776,350,126,19,11,1,31
07/08/16,1,10,3062,376,137,29,12,1,42
07/08/16,1,11,7652,347,16,6,13,4,23
07/08/16,1,12,8032,350,98,19,29,4,52
07/08/16,1,13,8035,346,135,4,11,1,16
07/08/16,1,14,641,360,131,3,7,4,14
07/08/16,1,15,715,354,161,0,6,0,6
07/08/16,1,18,542,345,118,44,4,2,50
07/08/16,1,19,542,366,98,52,5,0,57
07/08/16,1,20,8040,344,82,22,27,5,54
07/08/16,1,21,542,350,104,8,13,0,21
07/08/16,1,22,542,353,65,19,6,0,25
07/08/16,1,23,542,372,84,35,7,0,42
07/08/16,1,25,542,375,8,0,2,0,2
07/08/16,1,27,542,368,111,31,10,0,41
07/08/16,2,1,726,302,85,13,22,2,37
07/08/16,2,2,738,314,100,9,30,0,39
07/08/16,2,3,996,300,74,30,7,5,42
07/08/16,2,5,8030,345,144,1,4,2,7
07/08/16,2,6,774,349,117,24,5,0,29
07/08/16,2,7,642,339,126,0,7,1,8
07/08/16,2,8,7331,350,86,5,6,1,12
07/08/16,2,9,776,350,127,15,9,4,28
07/08/16,2,10,3062,376,125,26,15,2,43
07/08/16,2,11,7652,347,81,1,5,0,6
07/08/16,2,12,8032,350,99,13,21,1,35
07/08/16,2,13,8035,346,115,4,9,0,13
07/08/16,2,14,641,360,132,11,7,0,18
07/08/16,2,15,715,354,156,0,10,0,10
07/08/16,2,17,513,345,116,8,1,1,10
07/08/16,2,18,542,345,111,19,8,0,27
07/08/16,2,19,542,366,84,42,4,0,46
07/08/16,2,20,8040,344,77,17,25,1,43
07/08/16,2,21,542,350,61,35,10,0,45
07/08/16,2,22,542,353,83,15,14,0,29
07/08/16,2,23,542,372,70,39,8,0,47
07/08/16,2,25,542,375,118,132,4,0,136
07/08/16,2,27,542,368,93,29,2,0,31
07/08/16,3,1,726,302,66,16,12,11,39
07/08/16,3,2,738,314,72,24,17,2,43
07/08/16,3,3,996,300,72,24,4,4,32
07/08/16,3,5,8030,345,118,6,7,9,22
07/08/16,3,6,774,349,100,27,6,1,34
07/08/16,3,7,642,339,158,4,0,0,4
07/08/16,3,9,776,350,79,26,12,1,39
07/08/16,3,10,3062,376,100,23,9,1,33
07/08/16,3,11,7652,347,83,15,9,0,24
07/08/16,3,12,8032,350,85,11,12,1,24
07/08/16,3,13,8035,346,108,2,9,0,11
07/08/16,3,14,641,360,77,36,5,2,43
07/08/16,3,15,715,354,30,0,32,0,32
07/08/16,3,17,513,345,45,6,3,2,11
07/08/16,3,18,542,345,15,0,1,1,2
07/08/16,3,19,542,366,27,10,1,0,11
07/08/16,3,20,8040,344,18,3,7,1,11
07/08/16,3,21,542,350,7,6,1,0,7
07/08/16,3,22,542,353,21,2,4,0,6
07/08/16,3,23,542,372,20,15,1,0,16
07/08/16,3,25,542,375,39,2,1,0,3
07/08/16,3,27,542,368,17,7,0,0,7
07/11/16,1,1,726,302,74,36,9,16,61
07/11/16,1,2,738,314,86,19,21,9,49
07/11/16,1,3,996,300,64,16,12,7,35
07/11/16,1,5,8030,345,152,4,1,1,6
07/11/16,1,6,774,349,137,23,11,0,34
07/11/16,1,7,642,339,154,1,3,1,5
07/11/16,1,9,776,350,112,27,7,3,37
07/11/16,1,10,3062,376,100,25,15,1,41
07/11/16,1,11,7652,347,125,25,3,0,28
07/11/16,1,12,8032,350,104,18,21,3,42
07/11/16,1,13,8035,346,135,2,4,2,8
07/11/16,1,14,641,360,54,39,8,1,48
07/11/16,1,16,770,350,18,10,0,6,16
07/11/16,1,17,513,345,141,14,6,1,21
07/11/16,1,19,542,366,101,24,8,1,33
07/11/16,1,21,542,350,132,19,13,0,32
07/11/16,1,22,542,353,122,7,15,1,23
07/11/16,1,23,542,372,129,37,5,1,43
07/11/16,1,25,542,375,124,22,10,1,33
07/11/16,1,27,542,368,104,36,10,1,47
07/11/16,2,1,726,302,76,21,16,11,48
07/11/16,2,2,738,314,111,11,16,0,27
07/11/16,2,5,8030,345,151,1,4,2,7
07/11/16,2,6,774,349,34,7,0,2,9
07/11/16,2,7,642,339,159,6,0,1,7
07/11/16,2,8,7331,350,109,1,4,3,8
07/11/16,2,9,776,350,101,32,18,1,51
07/11/16,2,10,3062,376,145,16,13,3,32
07/11/16,2,11,7652,347,107,15,4,0,19
07/11/16,2,12,8032,350,116,7,21,2,30
07/11/16,2,13,8035,346,133,1,15,1,17
07/11/16,2,14,641,360,63,25,9,1,35
07/11/16,2,16,770,350,52,35,6,2,43
07/11/16,2,17,513,345,120,21,7,3,31
07/11/16,2,19,542,366,125,23,7,0,30
07/11/16,2,20,8040,344,52,5,15,9,29
07/11/16,2,21,542,350,79,7,11,0,18
07/11/16,2,22,542,353,102,13,13,1,27
07/11/16,2,23,542,372,112,28,12,0,40
07/11/16,2,25,542,375,142,12,4,0,16
07/11/16,2,27,542,368,92,28,6,0,34
07/11/16,3,1,726,302,107,21,13,2,36
07/11/16,3,2,738,314,103,18,21,0,39
07/11/16,3,3,996,300,48,26,6,0,32
07/11/16,3,5,8030,345,182,1,4,2,7
07/11/16,3,7,642,339,158,0,1,2,3
07/11/16,3,8,7331,350,141,11,4,2,17
07/11/16,3,9,776,350,122,25,13,3,41
07/11/16,3,10,3062,376,131,14,26,4,44
07/11/16,3,11,7652,347,133,24,4,0,28
07/11/16,3,12,8032,350,99,16,24,1,41
07/11/16,3,13,8035,346,143,9,8,0,17
07/11/16,3,16,770,350,28,30,7,1,38
07/11/16,3,17,513,345,107,10,3,1,14
07/11/16,3,19,542,366,99,24,8,0,32
07/11/16,3,20,8040,344,98,12,22,1,35
07/11/16,3,23,542,372,85,28,8,0,36
07/11/16,3,25,542,375,66,12,5,0,17
07/11/16,3,27,542,368,73,31,1,0,32
07/11/16,3,28,ex,325,2,19,9,4,32
07/12/16,1,1,726,302,97,27,11,5,43
07/12/16,1,2,738,314,78,29,17,0,46
07/12/16,1,3,996,300,72,57,9,5,71
07/12/16,1,5,8030,345,142,1,4,2,7
07/12/16,1,7,642,339,148,10,0,1,11
07/12/16,1,8,7331,350,119,3,5,2,10
07/12/16,1,9,776,350,104,27,9,1,37
07/12/16,1,10,3062,376,124,13,21,2,36
07/12/16,1,11,7652,347,122,34,0,0,34
07/12/16,1,12,8032,350,98,17,18,5,40
07/12/16,1,13,8035,346,139,3,3,9,15
07/12/16,1,16,770,350,93,24,11,4,39
07/12/16,1,17,513,345,128,15,6,1,22
07/12/16,1,18,542,345,54,17,3,6,26
07/12/16,1,19,542,366,111,38,7,0,45
07/12/16,1,20,8040,344,133,7,25,16,48
07/12/16,1,23,542,372,105,27,4,1,32
07/12/16,1,25,542,375,106,6,6,1,13
07/12/16,1,27,542,368,136,21,10,1,32
07/12/16,1,28,ex,325,10,45,12,7,64
07/12/16,2,1,726,302,111,13,11,1,25
07/12/16,2,2,738,314,29,10,14,1,25
07/12/16,2,5,8030,345,149,4,2,2,8
07/12/16,2,7,642,339,145,8,0,3,11
07/12/16,2,8,7331,350,135,9,3,4,16
07/12/16,2,9,776,350,99,25,9,3,37
07/12/16,2,10,3062,376,150,9,19,7,35
07/12/16,2,11,7652,347,110,52,6,2,60
07/12/16,2,12,8032,350,112,21,28,2,51
07/12/16,2,13,8035,346,148,2,10,1,13
07/12/16,2,16,770,350,113,49,8,3,60
07/12/16,2,17,513,345,132,15,9,1,25
07/12/16,2,18,542,345,124,18,5,4,27
07/12/16,2,19,542,366,95,41,7,1,49
07/12/16,2,22,542,353,77,16,14,0,30
07/12/16,2,23,542,372,100,31,7,0,38
07/12/16,2,25,542,375,103,23,8,1,32
07/12/16,2,26,7649,360,39,4,4,0,8
07/12/16,2,27,542,368,122,14,6,2,22
07/12/16,2,28,ex,325,8,39,9,1,49
07/12/16,3,1,726,302,109,12,8,2,22
07/12/16,3,5,8030,345,161,1,5,3,9
07/12/16,3,7,642,339,155,1,6,1,8
07/12/16,3,8,7331,350,129,11,2,2,15
07/12/16,3,9,776,350,97,19,11,0,30
07/12/16,3,10,3062,376,127,21,25,4,50
07/12/16,3,11,7652,347,154,8,8,0,16
07/12/16,3,12,8032,350,13,5,8,1,14
07/12/16,3,13,8035,346,157,3,8,3,14
07/12/16,3,16,770,350,86,37,3,3,43
07/12/16,3,17,513,345,131,14,1,2,17
07/12/16,3,18,542,345,114,19,6,6,31
07/12/16,3,19,542,366,92,19,6,6,31
07/12/16,3,22,542,353,106,10,12,0,22
07/12/16,3,25,542,375,113,13,6,0,19
07/12/16,3,27,542,368,111,21,4,0,25
07/13/16,1,1,726,302,109,30,14,3,47
07/13/16,1,4,999,330,37,18,8,3,29
07/13/16,1,5,8030,345,165,1,1,1,3
07/13/16,1,7,642,339,89,15,2,2,19
07/13/16,1,8,7331,350,119,7,10,2,19
07/13/16,1,9,776,350,33,5,6,1,12
07/13/16,1,10,3062,376,16,3,4,2,9
07/13/16,1,11,7652,347,130,7,10,4,21
07/13/16,1,13,8035,346,74,0,10,1,11
07/13/16,1,16,770,350,117,45,2,1,48
07/13/16,1,17,513,345,154,11,7,2,20
07/13/16,1,18,542,345,98,17,18,9,44
07/13/16,1,19,542,366,110,33,6,0,39
07/13/16,1,20,8040,344,30,2,5,1,8
07/13/16,1,22,542,353,145,13,14,2,29
07/13/16,1,23,542,372,115,21,12,0,33
07/13/16,1,24,7675,339,4,1,3,17,21
07/13/16,1,25,542,375,120,20,5,1,26
07/13/16,1,27,542,368,139,23,10,1,34
07/13/16,2,1,726,302,119,14,18,2,34
07/13/16,2,2,738,314,55,29,21,3,53
07/13/16,2,4,999,330,80,35,7,11,53
07/13/16,2,5,8030,345,164,0,3,0,3
07/13/16,2,8,7331,350,16,1,5,1,7
07/13/16,2,10,3062,376,150,10,14,2,26
07/13/16,2,11,7652,347,159,3,7,2,12
07/13/16,2,16,770,350,83,43,5,1,49
07/13/16,2,17,513,345,143,13,7,5,25
07/13/16,2,18,542,345,42,6,5,5,16
07/13/16,2,19,542,366,133,24,5,0,29
07/13/16,2,22,542,353,135,15,4,0,19
07/13/16,2,23,542,372,31,7,3,0,10
07/13/16,2,24,7675,339,101,11,9,6,26
07/13/16,2,25,542,375,133,22,3,0,25
07/13/16,2,27,542,368,110,27,7,0,34
07/13/16,2,28,ex,325,85,12,0,1,13
07/13/16,3,1,726,302,120,17,14,1,32
07/13/16,3,2,738,314,82,38,28,2,68
07/13/16,3,4,999,330,104,8,21,16,45
07/13/16,3,5,8030,345,155,1,4,1,6
07/13/16,3,10,3062,376,144,16,24,1,41
07/13/16,3,11,7652,347,149,8,8,0,16
07/13/16,3,16,770,350,55,39,1,1,41
07/13/16,3,17,513,345,105,11,10,1,22
07/13/16,3,18,542,345,85,35,10,1,46
07/13/16,3,19,542,366,109,15,6,0,21
07/13/16,3,22,542,353,101,3,10,0,13
07/13/16,3,24,7675,339,79,20,4,0,24
07/13/16,3,25,542,375,103,8,5,0,13
07/13/16,3,27,542,368,41,8,5,0,13
07/13/16,3,28,ex,325,16,71,7,3,81
07/14/16,1,1,726,302,106,19,18,6,43
07/14/16,1,2,738,314,108,20,22,1,43
07/14/16,1,3,996,300,74,62,5,8,75
07/14/16,1,4,999,330,96,27,15,6,48
07/14/16,1,5,8030,345,154,1,3,3,7
07/14/16,1,9,774,350,89,6,2,2,10
07/14/16,1,10,3062,376,94,11,14,2,27
07/14/16,1,11,7652,347,133,7,10,0,17
07/14/16,1,16,770,350,84,53,3,1,57
07/14/16,1,17,513,345,145,9,6,2,17
07/14/16,1,18,542,345,132,31,16,3,50
07/14/16,1,19,542,366,121,32,6,1,39
07/14/16,1,22,542,353,129,23,12,1,36
07/14/16,1,24,7675,339,126,25,8,1,34
07/14/16,1,25,542,375,145,17,9,1,27
07/14/16,1,26,7649,360,46,4,13,0,17
07/14/16,2,1,726,302,124,10,13,3,26
07/14/16,2,2,738,314,113,13,20,2,35
07/14/16,2,3,996,300,64,55,9,3,67
07/14/16,2,4,999,330,107,18,11,8,37
07/14/16,2,5,8030,345,162,3,1,1,5
07/14/16,2,7,642,339,12,1,0,3,4
07/14/16,2,9,774,350,137,17,6,3,26
07/14/16,2,10,3062,376,130,8,25,4,37
07/14/16,2,11,7652,347,106,15,18,1,34
07/14/16,2,16,770,350,77,26,4,2,32
07/14/16,2,17,513,345,145,11,3,1,15
07/14/16,2,18,542,345,89,69,9,1,79
07/14/16,2,19,542,366,50,25,3,0,28
07/14/16,2,22,542,353,135,7,19,1,27
07/14/16,2,23,542,372,45,16,9,0,25
07/14/16,2,24,7675,339,106,20,5,0,25
07/14/16,2,25,542,375,130,10,9,1,20
07/14/16,2,27,542,368,68,17,6,0,23
07/14/16,2,28,7625,325,1,3,1,3,7
07/14/16,3,1,726,302,127,10,10,2,22
07/14/16,3,2,738,314,99,23,24,4,51
07/14/16,3,3,996,300,91,34,12,8,54
07/14/16,3,4,999,330,87,18,14,16,48
07/14/16,3,5,8030,345,156,5,4,0,9
07/14/16,3,7,642,339,84,7,2,1,10
07/14/16,3,9,774,350,106,64,3,1,68
07/14/16,3,10,3062,376,150,9,18,2,29
07/14/16,3,11,7652,347,109,7,8,6,21
07/14/16,3,16,770,350,73,42,6,0,48
07/14/16,3,17,513,345,131,11,4,1,16
07/14/16,3,18,542,345,71,20,4,2,26
07/14/16,3,22,542,353,14,2,4,0,6
07/14/16,3,23,542,372,72,32,6,0,38
07/14/16,3,24,7675,339,64,9,8,0,17
07/14/16,3,25,542,375,93,7,8,0,15
07/14/16,3,27,542,368,93,14,7,0,21
07/14/16,3,28,7625,325,87,17,6,6,29
07/15/16,1,1,726,302,105,14,15,3,32
07/15/16,1,2,738,314,106,23,17,4,44
07/15/16,1,3,996,300,97,15,12,11,38
07/15/16,1,4,999,330,73,20,6,12,38
07/15/16,1,5,8030,345,139,4,5,1,10
07/15/16,1,7,642,339,154,8,0,2,10
07/15/16,1,8,285,350,5,1,2,15,18
07/15/16,1,9,774,350,126,38,1,2,41
07/15/16,1,10,3062,376,137,20,19,2,41
07/15/16,1,11,7652,347,39,4,3,2,9
07/15/16,1,16,770,350,76,69,4,8,81
07/15/16,1,17,513,345,158,9,3,2,14
07/15/16,1,18,542,345,136,41,4,1,46
07/15/16,1,19,542,366,54,7,7,0,14
07/15/16,1,22,542,353,9,0,2,0,2
07/15/16,1,23,542,372,117,54,13,1,68
07/15/16,1,24,7675,339,93,8,9,5,22
07/15/16,1,27,542,368,136,25,14,1,40
07/15/16,1,28,7625,325,150,20,1,0,21
07/15/16,2,1,726,302,82,14,15,3,32
07/15/16,2,2,738,314,105,20,26,3,49
07/15/16,2,3,996,300,111,17,10,13,40
07/15/16,2,5,8030,345,159,1,1,1,3
07/15/16,2,7,642,339,133,9,1,0,10
07/15/16,2,8,285,350,50,9,4,3,16
07/15/16,2,9,774,350,127,35,1,2,38
07/15/16,2,10,3062,376,128,11,17,5,33
07/15/16,2,16,770,350,101,17,7,3,27
07/15/16,2,17,513,345,125,19,3,2,24
07/15/16,2,18,542,345,127,45,5,2,52
07/15/16,2,19,542,366,139,22,7,1,30
07/15/16,2,22,542,353,112,14,11,1,26
07/15/16,2,23,542,372,128,63,12,1,76
07/15/16,2,24,7675,339,103,19,3,0,22
07/15/16,2,27,542,368,134,19,12,2,33
07/15/16,2,28,7625,325,151,12,4,1,17
07/15/16,3,1,726,302,116,17,16,2,35
07/15/16,3,2,738,314,93,27,25,5,57
07/15/16,3,3,996,300,96,14,9,12,35
07/15/16,3,5,8030,345,159,4,4,1,9
07/15/16,3,7,642,339,150,3,4,6,13
07/15/16,3,8,285,350,136,9,9,5,23
07/15/16,3,9,774,350,132,43,3,2,48
07/15/16,3,10,3062,376,139,15,20,2,37
07/15/16,3,16,770,350,119,14,6,5,25
07/15/16,3,18,542,345,97,36,6,3,45
07/15/16,3,19,542,366,105,18,10,0,28
07/15/16,3,22,542,353,91,11,13,0,24
07/15/16,3,23,542,372,78,38,9,0,47
07/15/16,3,24,7675,339,79,13,2,0,15
07/15/16,3,27,542,368,96,22,7,0,29
07/15/16,3,28,7625,325,113,23,2,1,26
07/18/16,1,1,726,302,118,12,10,11,33
07/18/16,1,2,738,314,106,26,18,15,59
07/18/16,1,3,996,300,95,16,18,8,42
07/18/16,1,5,8030,345,156,1,5,5,11
07/18/16,1,7,642,339,153,7,0,1,8
07/18/16,1,8,285,350,20,2,2,0,4
07/18/16,1,9,774,350,126,36,4,1,41
07/18/16,1,10,3062,376,126,21,24,2,47
07/18/16,1,11,7652,347,6,3,1,2,6
07/18/16,1,16,770,350,140,34,6,1,41
07/18/16,1,18,542,345,94,87,12,2,101
07/18/16,1,19,542,366,97,40,5,1,46
07/18/16,1,22,542,353,136,16,7,1,24
07/18/16,1,23,542,372,113,34,12,1,47
07/18/16,1,24,7675,339,80,17,5,1,23
07/18/16,1,27,542,368,77,56,5,0,61
07/18/16,1,28,7625,325,120,18,3,5,26
07/18/16,2,1,726,302,103,12,8,3,23
07/18/16,2,2,738,314,108,12,31,0,43
07/18/16,2,3,996,300,90,22,12,4,38
07/18/16,2,5,8030,345,162,0,2,1,3
07/18/16,2,7,642,339,142,17,1,2,20
07/18/16,2,8,285,350,140,10,8,3,21
07/18/16,2,9,774,350,154,5,5,4,14
07/18/16,2,10,3062,376,153,3,14,3,20
07/18/16,2,11,7652,347,102,16,7,1,24
07/18/16,2,16,770,350,128,27,7,0,34
07/18/16,2,18,542,345,102,67,4,5,76
07/18/16,2,19,542,366,128,25,8,2,35
07/18/16,2,22,542,353,136,8,17,1,26
07/18/16,2,23,542,372,113,74,6,1,81
07/18/16,2,24,7675,339,22,7,1,3,11
07/18/16,2,27,542,368,76,37,8,1,46
07/18/16,2,28,7625,325,144,14,4,4,22
07/18/16,3,1,726,302,124,10,9,0,19
07/18/16,3,2,738,314,94,44,22,1,67
07/18/16,3,3,996,300,80,41,11,9,61
07/18/16,3,5,8030,345,157,1,5,0,6
07/18/16,3,7,642,339,159,1,0,0,1
07/18/16,3,8,285,350,129,13,7,6,26
07/18/16,3,9,774,350,151,3,5,4,12
07/18/16,3,10,3062,376,121,19,22,2,43
07/18/16,3,11,7652,347,119,37,16,1,54
07/18/16,3,16,770,350,78,21,5,1,27
07/18/16,3,18,542,345,75,33,3,1,37
07/18/16,3,19,542,366,71,35,6,0,41
07/18/16,3,22,542,353,108,10,8,0,18
07/18/16,3,23,542,372,64,27,6,0,33
07/18/16,3,25,542,375,9,23,4,0,27
07/18/16,3,27,542,368,72,25,3,0,28
07/18/16,3,28,7625,325,87,12,6,1,19
07/19/16,1,1,726,302,107,19,8,0,27
07/19/16,1,2,738,314,65,23,11,3,37
07/19/16,1,3,996,300,54,39,10,6,55
07/19/16,1,5,8030,345,123,2,2,3,7
07/19/16,1,7,642,339,156,6,0,1,7
07/19/16,1,8,285,350,112,18,6,6,30
07/19/16,1,9,774,350,133,18,1,1,20
07/19/16,1,10,3062,376,129,15,16,1,32
07/19/16,1,11,7652,347,34,15,6,1,22
07/19/16,1,15,775,354,30,5,3,0,8
07/19/16,1,16,770,350,107,32,7,1,40
07/19/16,1,18,542,345,115,66,7,4,77
07/19/16,1,19,542,366,120,42,8,1,51
07/19/16,1,22,542,353,152,12,6,2,20
07/19/16,1,23,542,372,95,63,13,0,76
07/19/16,1,25,542,375,90,23,8,0,31
07/19/16,1,27,542,368,100,25,6,1,32
07/19/16,1,28,7625,325,116,21,3,2,26
07/19/16,2,1,726,302,129,9,8,2,19
07/19/16,2,2,738,314,116,21,26,4,51
07/19/16,2,3,996,300,9,7,4,2,13
07/19/16,2,7,642,339,159,5,0,1,6
07/19/16,2,8,285,350,121,6,12,7,25
07/19/16,2,9,774,350,160,11,1,5,17
07/19/16,2,10,3062,376,147,10,20,3,33
07/19/16,2,11,7652,347,41,8,7,1,16
07/19/16,2,15,775,354,133,12,10,1,23
07/19/16,2,16,770,350,149,17,5,4,26
07/19/16,2,17,513,345,94,20,4,3,27
07/19/16,2,18,542,345,94,66,16,1,83
07/19/16,2,19,542,366,122,41,9,1,51
07/19/16,2,22,542,353,131,12,14,1,27
07/19/16,2,23,542,372,106,33,18,1,52
07/19/16,2,25,542,375,130,25,5,2,32
07/19/16,2,27,542,368,114,34,9,1,44
07/19/16,2,28,7625,325,80,10,5,2,17
07/19/16,3,1,726,302,113,12,9,3,24
07/19/16,3,2,738,314,97,21,27,1,49
07/19/16,3,3,996,300,66,31,10,0,41
07/19/16,3,7,642,339,92,56,0,0,56
07/19/16,3,8,285,350,123,18,6,5,29
07/19/16,3,9,774,350,56,2,2,1,5
07/19/16,3,10,3062,376,147,14,17,3,34
07/19/16,3,11,7652,347,139,8,17,1,26
07/19/16,3,15,775,354,104,9,7,0,16
07/19/16,3,16,770,350,108,23,7,1,31
07/19/16,3,17,513,345,109,28,2,3,33
07/19/16,3,19,542,366,98,27,6,0,33
07/19/16,3,22,542,353,108,15,8,0,23
07/19/16,3,23,542,372,85,32,7,0,39
07/19/16,3,25,542,375,100,17,5,0,22
07/19/16,3,27,542,368,75,31,3,0,34
07/20/16,1,1,726,302,118,22,11,0,33
07/20/16,1,2,738,314,111,27,18,2,47
07/20/16,1,3,996,280,83,60,8,8,76
07/20/16,1,7,642,339,143,1,1,1,3
07/20/16,1,8,285,350,91,8,3,11,22
07/20/16,1,9,774,350,20,5,6,2,13
07/20/16,1,10,3062,376,73,9,10,6,25
07/20/16,1,15,775,354,141,5,12,1,18
07/20/16,1,16,770,350,139,35,10,1,46
07/20/16,1,17,513,345,141,18,5,2,25
07/20/16,1,18,542,345,13,8,0,3,11
07/20/16,1,19,542,366,123,37,10,2,49
07/20/16,1,20,8040,344,7,6,3,4,13
07/20/16,1,21,542,350,7,0,1,0,1
07/20/16,1,22,542,353,143,15,7,1,23
07/20/16,1,23,542,372,94,67,12,1,80
07/20/16,1,24,7675,339,91,10,2,7,19
07/20/16,1,25,542,375,131,21,10,1,32
07/20/16,1,27,542,368,119,28,10,1,39
07/20/16,1,28,7625,325,30,6,1,4,11
07/20/16,2,1,726,302,113,20,10,3,33
07/20/16,2,2,738,314,120,18,15,2,35
07/20/16,2,3,996,280,89,43,13,4,60
07/20/16,2,7,642,339,161,1,0,1,2
07/20/16,2,14,641,360,74,13,2,1,16
07/20/16,2,15,775,354,128,3,14,1,18
07/20/16,2,16,770,350,97,8,19,1,28
07/20/16,2,17,513,345,115,10,3,2,15
07/20/16,2,18,542,345,112,40,12,4,56
07/20/16,2,19,542,366,21,9,0,1,10
07/20/16,2,20,8040,344,95,24,36,5,65
07/20/16,2,21,542,350,98,21,13,0,34
07/20/16,2,22,542,353,99,18,13,1,32
07/20/16,2,23,542,372,82,70,6,0,76
07/20/16,2,24,7675,339,120,17,6,1,24
07/20/16,2,25,542,375,118,23,0,1,24
07/20/16,2,27,542,368,120,20,15,1,36
07/20/16,2,28,7625,325,142,12,1,4,17
07/20/16,3,1,726,302,114,18,12,2,32
07/20/16,3,2,738,314,106,30,16,1,47
07/20/16,3,3,996,280,89,19,10,6,35
07/20/16,3,7,642,339,156,4,2,1,7
07/20/16,3,9,774,350,105,8,16,11,35
07/20/16,3,10,3062,376,141,10,15,3,28
07/20/16,3,14,641,360,143,3,11,1,15
07/20/16,3,15,775,354,99,9,9,0,18
07/20/16,3,16,770,350,19,4,3,0,7
07/20/16,3,17,513,345,106,19,2,1,22
07/20/16,3,18,542,345,72,45,5,0,50
07/20/16,3,20,8040,344,48,24,30,5,59
07/20/16,3,21,542,350,67,15,11,0,26
07/20/16,3,22,542,353,97,15,7,0,22
07/20/16,3,23,542,372,22,25,2,0,27
07/20/16,3,24,7675,339,83,12,6,0,18
07/20/16,3,25,542,375,85,19,3,0,22
07/20/16,3,27,542,368,88,19,7,0,26
07/20/16,3,28,7625,325,100,19,2,0,21
07/21/16,1,1,726,302,129,21,10,2,33
07/21/16,1,2,738,314,112,36,30,0,66
07/21/16,1,3,996,280,97,15,23,8,46
07/21/16,1,7,642,339,162,5,1,2,8
07/21/16,1,9,774,350,156,7,8,1,16
07/21/16,1,10,3062,376,154,19,15,2,36
07/21/16,1,14,641,360,52,0,4,1,5
07/21/16,1,15,775,354,150,9,7,1,17
07/21/16,1,17,513,345,133,10,2,2,14
07/21/16,1,18,542,345,106,38,11,3,52
07/21/16,1,20,8040,344,63,19,30,2,51
07/21/16,1,21,542,350,86,11,19,0,30
07/21/16,1,22,542,353,103,12,14,1,27
07/21/16,1,23,542,372,73,43,8,1,52
07/21/16,1,24,7675,339,132,8,7,7,22
07/21/16,1,25,542,375,85,14,5,1,20
07/21/16,1,27,542,368,19,8,4,0,12
07/21/16,1,28,7625,325,149,14,1,1,16
07/21/16,2,1,726,302,12,16,17,3,36
07/21/16,2,2,738,314,111,28,22,0,50
07/21/16,2,3,996,280,93,10,19,16,45
07/21/16,2,7,642,339,155,3,0,2,5
07/21/16,2,9,774,350,148,10,5,2,17
07/21/16,2,10,3062,376,147,11,18,4,33
07/21/16,2,15,775,354,141,6,11,0,17
07/21/16,2,16,770,350,50,5,11,10,26
07/21/16,2,17,513,345,149,18,4,3,25
07/21/16,2,18,542,345,132,40,10,4,54
07/21/16,2,20,8040,344,92,25,48,3,76
07/21/16,2,21,542,350,105,22,14,0,36
07/21/16,2,22,542,353,135,10,7,0,17
07/21/16,2,24,7675,339,150,11,2,2,15
07/21/16,2,25,542,375,127,27,7,0,34
07/21/16,2,28,7625,325,136,17,0,1,18
07/21/16,3,1,726,302,122,18,8,3,29
07/21/16,3,2,738,314,77,53,17,11,81
07/21/16,3,3,996,280,93,16,24,9,49
07/21/16,3,7,642,339,148,9,1,1,11
07/21/16,3,9,774,350,155,5,9,1,15
07/21/16,3,10,3062,376,156,15,11,2,28
07/21/16,3,15,775,354,125,6,5,0,11
07/21/16,3,16,770,350,117,16,5,5,26
07/21/16,3,17,513,345,122,8,4,1,13
07/21/16,3,18,542,345,92,23,7,7,37
07/21/16,3,20,8040,344,58,16,28,2,46
07/21/16,3,21,542,350,78,21,12,0,33
07/21/16,3,22,542,353,103,9,11,1,21
07/21/16,3,24,7675,339,95,7,3,5,15
07/21/16,3,25,542,375,110,10,4,1,15
07/21/16,3,28,7625,325,83,19,3,1,23
07/22/16,1,1,726,302,120,20,12,1,33
07/22/16,1,2,738,314,44,73,7,5,85
07/22/16,1,3,996,280,90,47,18,0,65
07/22/16,1,6,774,349,76,10,4,2,16
07/22/16,1,7,642,339,159,6,0,1,7
07/22/16,1,8,285,350,83,2,7,9,18
07/22/16,1,9,774,350,156,6,5,2,13
07/22/16,1,10,3062,376,152,16,14,2,32
07/22/16,1,14,641,360,102,5,9,2,16
07/22/16,1,15,775,354,142,7,11,1,19
07/22/16,1,16,770,350,144,26,6,3,35
07/22/16,1,17,513,345,126,13,8,2,23
07/22/16,1,18,542,345,131,36,13,3,52
07/22/16,1,20,8040,344,85,9,53,4,66
07/22/16,1,21,542,350,122,22,17,0,39
07/22/16,1,22,542,353,18,0,4,1,5
07/22/16,1,24,7675,339,7,1,0,1,2
07/22/16,1,25,542,375,141,20,6,1,27
07/22/16,1,27,542,368,100,30,16,1,47
07/22/16,1,28,7625,325,140,27,0,2,29
07/22/16,2,1,726,302,36,12,1,11,24
07/22/16,2,3,996,280,79,43,9,5,57
07/22/16,2,6,774,349,152,15,4,1,20
07/22/16,2,7,642,339,153,12,2,2,16
07/22/16,2,8,285,350,134,7,9,5,21
07/22/16,2,9,774,350,157,8,4,3,15
07/22/16,2,10,3062,376,138,8,21,1,30
07/22/16,2,14,641,360,158,6,3,0,9
07/22/16,2,15,775,354,100,24,8,1,33
07/22/16,2,16,770,350,98,43,5,1,49
07/22/16,2,17,513,345,147,14,3,3,20
07/22/16,2,18,542,345,127,51,9,3,63
07/22/16,2,20,8040,344,111,13,32,5,50
07/22/16,2,21,542,350,83,8,11,0,19
07/22/16,2,22,542,353,122,14,8,1,23
07/22/16,2,25,542,375,131,36,4,2,42
07/22/16,2,26,7649,360,11,2,7,1,10
07/22/16,2,27,542,368,114,19,15,1,35
07/22/16,2,28,7625,325,144,9,3,3,15
07/22/16,3,1,726,302,15,4,3,7,14
07/22/16,3,3,996,280,76,43,9,5,57
07/22/16,3,6,774,349,145,12,4,1,17
07/22/16,3,7,642,339,143,5,0,2,7
07/22/16,3,8,285,350,119,9,13,4,26
07/22/16,3,9,774,350,142,9,10,3,22
07/22/16,3,10,3062,376,145,7,13,7,27
07/22/16,3,14,641,360,147,13,4,2,19
07/22/16,3,15,775,354,92,6,15,0,21
07/22/16,3,16,770,350,97,37,9,4,50
07/22/16,3,17,513,345,135,12,3,1,16
07/22/16,3,18,542,345,91,35,7,2,44
07/22/16,3,20,8040,344,80,18,15,3,36
07/22/16,3,22,542,353,96,11,7,1,19
07/22/16,3,25,542,375,104,13,8,0,21
07/22/16,3,26,7649,360,102,4,10,0,14
07/22/16,3,27,542,368,120,11,7,1,19
07/22/16,3,28,7625,325,105,11,2,2,15
07/25/16,1,1,726,302,80,26,6,23,55
07/25/16,1,2,738,314,85,17,13,19,49
07/25/16,1,3,996,250,63,31,14,8,53
07/25/16,1,6,774,349,136,16,8,1,25
07/25/16,1,7,642,339,154,0,1,3,4
07/25/16,1,8,285,350,114,7,13,6,26
07/25/16,1,9,774,350,132,10,4,6,20
07/25/16,1,10,3062,376,102,10,12,4,26
07/25/16,1,14,641,360,130,8,6,2,16
07/25/16,1,15,775,354,118,4,13,1,18
07/25/16,1,16,770,350,92,57,8,1,66
07/25/16,1,17,513,345,27,7,2,2,11
07/25/16,1,18,542,345,64,15,6,1,22
07/25/16,1,20,8040,344,94,22,25,7,54
07/25/16,1,23,542,372,43,16,3,0,19
07/25/16,1,24,7675,339,11,4,0,2,6
07/25/16,1,25,542,375,107,25,10,2,37
07/25/16,1,26,641,360,116,5,12,1,18
07/25/16,1,27,542,368,124,16,10,1,27
07/25/16,1,28,7625,325,16,3,2,6,11
07/25/16,2,1,726,302,81,21,13,22,56
07/25/16,2,2,738,314,103,22,13,0,35
07/25/16,2,3,996,250,63,31,17,5,53
07/25/16,2,6,774,349,147,11,9,0,20
07/25/16,2,7,642,339,155,6,2,1,9
07/25/16,2,8,285,350,84,13,10,0,23
07/25/16,2,9,774,350,139,10,6,1,17
07/25/16,2,10,3062,376,145,6,18,5,29
07/25/16,2,14,641,360,165,1,1,1,3
07/25/16,2,15,775,354,119,8,4,1,13
07/25/16,2,16,770,350,110,18,6,4,28
07/25/16,2,18,542,345,113,39,10,1,50
07/25/16,2,20,8040,344,83,21,17,3,41
07/25/16,2,21,542,350,88,12,5,0,17
07/25/16,2,23,542,372,83,55,9,0,64
07/25/16,2,24,7675,339,59,5,5,7,17
07/25/16,2,25,542,375,133,22,6,0,28
07/25/16,2,26,641,360,147,3,7,1,11
07/25/16,2,27,542,368,100,12,13,1,26
07/25/16,2,28,7625,325,133,12,3,6,21
07/25/16,3,1,726,302,104,20,14,9,43
07/25/16,3,2,738,314,94,43,11,8,62
07/25/16,3,6,774,349,94,12,6,2,20
07/25/16,3,7,642,339,134,2,5,9,16
07/25/16,3,8,285,350,108,9,17,7,33
07/25/16,3,9,774,350,145,6,11,2,19
07/25/16,3,10,3062,376,136,20,21,3,44
07/25/16,3,14,641,360,159,1,5,1,7
07/25/16,3,15,775,354,122,2,10,1,13
07/25/16,3,16,770,350,114,29,5,1,35
07/25/16,3,18,542,345,75,31,16,3,50
07/25/16,3,20,8040,344,54,44,12,1,57
07/25/16,3,21,542,350,105,12,11,0,23
07/25/16,3,23,542,372,15,26,0,0,26
07/25/16,3,24,7675,339,94,11,10,0,21
07/25/16,3,25,542,375,45,14,10,0,24
07/25/16,3,26,641,360,95,10,0,0,10
07/25/16,3,27,542,368,92,12,6,0,18
07/25/16,3,28,7625,325,122,15,4,1,20
07/26/16,1,1,726,302,45,33,5,6,44
07/26/16,1,8,285,350,127,14,7,10,31
07/26/16,1,10,3062,376,145,13,17,6,36
07/26/16,1,14,641,360,149,5,6,1,12
07/26/16,1,16,770,350,145,23,4,3,30
07/26/16,1,18,542,345,119,30,7,2,39
07/26/16,1,20,8040,344,79,62,31,3,96
07/26/16,1,21,542,350,117,8,13,0,21
07/26/16,1,22,542,353,57,6,1,0,7
07/26/16,1,23,542,372,26,39,1,0,40
07/26/16,1,24,7675,339,124,12,17,1,30
07/26/16,1,25,542,375,12,4,1,0,5
07/26/16,1,26,641,360,156,4,4,0,8
07/26/16,1,27,542,368,37,6,1,0,7
07/26/16,1,28,7625,325,131,24,6,2,32
07/26/16,2,1,726,302,121,26,15,4,45
07/26/16,2,6,774,349,130,13,11,6,30
07/26/16,2,8,285,350,140,4,14,5,23
07/26/16,2,9,774,350,12,0,6,4,10
07/26/16,2,10,3062,376,147,14,19,2,35
07/26/16,2,14,641,360,167,0,6,2,8
07/26/16,2,16,770,350,137,21,8,4,33
07/26/16,2,18,542,345,138,21,10,2,33
07/26/16,2,20,8040,344,80,76,13,1,90
07/26/16,2,21,542,350,126,14,11,0,25
07/26/16,2,22,542,353,117,14,8,0,22
07/26/16,2,23,542,372,111,53,8,0,61
07/26/16,2,24,7675,339,127,16,9,0,25
07/26/16,2,25,641,375,93,6,2,0,8
07/26/16,2,26,7649,360,166,4,3,0,7
07/26/16,2,28,7625,325,136,1,0,0,1
07/26/16,3,1,726,302,83,64,8,4,76
07/26/16,3,3,996,250,51,17,11,10,38
07/26/16,3,6,774,349,138,31,12,1,44
07/26/16,3,8,285,350,104,22,8,6,36
07/26/16,3,9,774,350,134,10,15,2,27
07/26/16,3,10,3062,376,142,16,18,2,36
07/26/16,3,14,641,360,143,7,9,1,17
07/26/16,3,16,770,350,115,17,6,1,24
07/26/16,3,18,542,345,100,32,7,2,41
07/26/16,3,20,8040,344,41,45,17,0,62
07/26/16,3,21,542,350,95,9,12,0,21
07/26/16,3,23,542,372,60,21,7,1,29
07/26/16,3,24,7675,339,78,15,13,0,28
07/26/16,3,25,641,375,105,10,5,2,17
07/26/16,3,26,7649,360,97,1,4,1,6
07/26/16,3,28,7625,325,141,10,2,0,12
07/27/16,1,1,726,302,88,19,12,2,33
07/27/16,1,2,738,314,56,58,7,9,74
07/27/16,1,3,996,250,74,14,15,8,37
07/27/16,1,6,774,349,128,24,15,3,42
07/27/16,1,8,285,350,22,1,1,1,3
07/27/16,1,9,774,350,124,9,23,4,36
07/27/16,1,10,3062,376,115,16,19,8,43
07/27/16,1,11,7652,347,33,17,6,1,24
07/27/16,1,12,8032,350,17,7,8,3,18
07/27/16,1,14,641,360,154,5,4,1,10
07/27/16,1,16,770,350,136,11,5,4,20
07/27/16,1,18,542,345,92,24,8,2,34
07/27/16,1,20,8040,344,88,42,22,3,67
07/27/16,1,21,542,350,132,13,10,0,23
07/27/16,1,23,542,372,99,32,4,1,37
07/27/16,1,24,7675,339,114,16,17,2,35
07/27/16,1,25,542,375,133,16,3,1,20
07/27/16,1,26,641,360,129,0,3,0,3
07/27/16,1,28,7625,325,136,26,6,3,35
07/27/16,2,1,726,302,59,39,19,2,60
07/27/16,2,2,738,314,36,40,0,7,47
07/27/16,2,3,996,300,57,23,12,8,43
07/27/16,2,6,774,349,100,12,18,1,31
07/27/16,2,9,774,350,98,8,11,1,20
07/27/16,2,10,3062,376,8,2,6,6,14
07/27/16,2,11,7652,347,58,37,11,1,49
07/27/16,2,12,8032,350,63,21,18,0,39
07/27/16,2,14,641,360,128,13,1,1,15
07/27/16,2,16,770,350,105,27,1,2,30
07/27/16,2,18,542,345,33,9,3,1,13
07/27/16,2,20,8040,344,91,27,25,2,54
07/27/16,2,21,542,350,105,14,14,0,28
07/27/16,2,22,542,353,116,15,10,2,27
07/27/16,2,23,542,372,107,31,4,1,36
07/27/16,2,24,7675,339,127,13,13,2,28
07/27/16,2,25,542,375,109,24,3,1,28
07/27/16,2,26,641,360,164,7,1,1,9
07/27/16,2,28,7625,325,151,8,5,1,14
07/27/16,3,1,726,302,97,37,17,2,56
07/27/16,3,2,738,314,16,29,0,8,37
07/27/16,3,3,996,300,71,34,24,7,65
07/27/16,3,6,774,349,128,29,15,1,45
07/27/16,3,7,642,339,9,1,5,10,16
07/27/16,3,9,774,350,120,12,17,2,31
07/27/16,3,12,8032,350,90,16,28,2,46
07/27/16,3,14,641,360,125,11,5,2,18
07/27/16,3,16,770,350,115,13,2,10,25
07/27/16,3,20,8040,344,44,23,24,4,51
07/27/16,3,21,542,350,73,8,3,0,11
07/27/16,3,22,542,353,102,6,3,0,9
07/27/16,3,23,542,372,87,19,4,0,23
07/27/16,3,24,7675,339,72,13,7,0,20
07/27/16,3,25,542,375,60,23,1,0,24
07/27/16,3,26,641,360,126,10,0,0,10
07/27/16,3,28,7625,325,100,4,12,2,18
07/28/16,1,1,726,302,68,40,7,3,50
07/28/16,1,2,738,300,28,77,1,8,86
07/28/16,1,3,996,300,76,14,20,12,46
07/28/16,1,5,8030,345,50,18,11,6,35
07/28/16,1,6,774,349,133,15,12,2,29
07/28/16,1,7,642,339,103,6,3,5,14
07/28/16,1,8,285,350,16,1,1,2,4
07/28/16,1,9,774,350,101,15,13,2,30
07/28/16,1,10,3062,376,31,5,5,2,12
07/28/16,1,11,7652,347,14,4,1,0,5
07/28/16,1,12,8032,350,107,23,13,2,38
07/28/16,1,14,641,360,118,3,7,2,12
07/28/16,1,15,775,354,157,6,11,1,18
07/28/16,1,16,770,350,109,3,6,2,11
07/28/16,1,18,542,345,24,9,4,0,13
07/28/16,1,22,542,353,132,19,13,0,32
07/28/16,1,23,542,372,142,22,10,1,33
07/28/16,1,24,7675,339,123,16,7,3,26
07/28/16,1,25,542,375,98,29,8,1,38
07/28/16,1,26,641,360,171,9,2,1,12
07/28/16,1,27,542,368,7,4,0,0,4
07/28/16,2,1,726,302,66,28,6,1,35
07/28/16,2,2,738,270,23,40,1,3,44
07/28/16,2,3,996,300,91,8,23,8,39
07/28/16,2,5,8030,345,109,17,5,1,23
07/28/16,2,6,774,349,112,14,10,2,26
07/28/16,2,7,642,339,113,4,7,3,14
07/28/16,2,8,285,350,121,11,5,4,20
07/28/16,2,9,774,350,67,7,10,2,19
07/28/16,2,10,3062,376,121,15,18,1,34
07/28/16,2,11,7652,347,88,17,13,0,30
07/28/16,2,12,8032,350,103,15,16,2,33
07/28/16,2,15,775,354,32,1,8,0,9
07/28/16,2,16,770,350,70,6,6,2,14
07/28/16,2,20,8040,344,30,10,13,9,32
07/28/16,2,22,542,353,126,12,7,0,19
07/28/16,2,23,542,372,113,30,5,1,36
07/28/16,2,24,7675,339,92,10,10,2,22
07/28/16,2,25,542,375,76,15,2,1,18
07/28/16,2,26,641,360,127,7,5,1,13
07/28/16,2,27,542,368,84,36,6,0,42
07/28/16,3,1,726,302,81,45,9,2,56
07/28/16,3,2,738,270,76,56,13,0,69
07/28/16,3,3,996,300,92,19,18,15,52
07/28/16,3,5,8030,345,142,17,7,1,25
07/28/16,3,6,774,349,133,19,14,1,34
07/28/16,3,7,642,339,156,4,1,0,5
07/28/16,3,8,285,350,134,8,8,9,25
07/28/16,3,9,774,350,113,15,29,4,48
07/28/16,3,10,3062,376,128,12,21,9,42
07/28/16,3,12,8032,350,100,17,17,3,37
07/28/16,3,16,770,350,103,15,10,3,28
07/28/16,3,18,542,345,21,3,10,7,20
07/28/16,3,20,8040,344,90,15,25,2,42
07/28/16,3,22,542,353,122,12,5,0,17
07/28/16,3,23,542,372,104,27,2,0,29
07/28/16,3,24,7675,339,24,3,5,1,9
07/28/16,3,25,542,375,105,23,2,0,25
07/28/16,3,26,641,360,155,7,3,0,10
07/28/16,3,27,542,368,99,31,3,0,34
07/29/16,1,1,726,270,82,28,10,3,41
07/29/16,1,2,738,270,41,34,9,1,44
07/29/16,1,3,996,300,70,21,14,11,46
07/29/16,1,5,513,400,135,15,7,2,24
07/29/16,1,6,774,370,123,28,5,2,35
07/29/16,1,7,642,345,155,6,0,2,8
07/29/16,1,8,285,350,126,6,7,5,18
07/29/16,1,9,774,350,96,6,17,1,24
07/29/16,1,10,3062,380,133,16,14,7,37
07/29/16,1,11,7652,355,60,7,13,1,21
07/29/16,1,12,8032,350,96,21,14,2,37
07/29/16,1,15,775,350,49,3,4,0,7
07/29/16,1,16,770,350,130,12,6,3,21
07/29/16,1,18,542,350,124,15,11,3,29
07/29/16,1,20,8040,350,112,20,21,7,48
07/29/16,1,22,542,350,128,9,8,1,18
07/29/16,1,23,542,350,121,40,3,2,45
07/29/16,1,25,542,375,116,34,6,1,41
07/29/16,1,26,641,360,156,6,5,0,11
07/29/16,1,27,542,360,130,31,11,1,43
07/29/16,1,28,7625,375,20,0,4,4,8
07/29/16,2,1,726,270,55,20,9,0,29
07/29/16,2,2,738,270,34,30,7,1,38
07/29/16,2,3,996,300,79,12,16,4,32
07/29/16,2,5,513,400,123,19,3,1,23
07/29/16,2,6,774,370,110,12,14,2,28
07/29/16,2,7,642,345,150,3,4,1,8
07/29/16,2,8,285,350,120,4,6,4,14
07/29/16,2,9,774,350,105,7,16,2,25
07/29/16,2,10,3062,380,115,12,17,1,30
07/29/16,2,11,7652,355,84,24,12,2,38
07/29/16,2,12,8032,350,82,22,16,1,39
07/29/16,2,15,775,350,89,1,16,0,17
07/29/16,2,16,770,350,77,13,5,4,22
07/29/16,2,18,542,350,107,18,9,4,31
07/29/16,2,19,542,360,13,9,0,0,9
07/29/16,2,20,8040,350,80,8,22,3,33
07/29/16,2,22,542,350,122,11,5,0,16
07/29/16,2,23,542,350,65,20,6,0,26
07/29/16,2,24,7675,360,95,19,3,7,29
07/29/16,2,25,542,375,103,18,3,0,21
07/29/16,2,26,641,360,159,6,0,0,6
07/29/16,2,27,542,360,89,26,4,0,30
07/29/16,2,28,7625,375,128,16,1,1,18
07/29/16,3,1,726,270,84,17,23,0,40
07/29/16,3,2,738,270,64,61,10,1,72
07/29/16,3,3,996,300,83,18,20,11,49
07/29/16,3,5,513,400,145,17,4,2,23
07/29/16,3,6,774,370,127,21,13,3,37
07/29/16,3,7,642,345,158,6,0,2,8
07/29/16,3,8,285,350,124,8,4,6,18
07/29/16,3,9,774,350,120,4,28,3,35
07/29/16,3,10,3062,380,141,17,16,2,35
07/29/16,3,11,7652,355,77,25,23,0,48
07/29/16,3,12,8032,350,102,19,23,4,46
07/29/16,3,15,775,140,112,3,8,0,11
07/29/16,3,18,542,350,11,19,9,1,29
07/29/16,3,19,542,360,32,32,4,0,36
07/29/16,3,20,8040,350,77,11,19,6,36
07/29/16,3,22,542,350,90,7,3,0,10
07/29/16,3,24,7675,360,86,12,5,20,37
07/29/16,3,25,542,375,81,28,5,0,33
07/29/16,3,26,641,360,147,3,5,0,8
07/29/16,3,27,542,360,85,20,5,0,25
07/29/16,3,28,7625,375,135,14,1,0,15
08/01/16,1,1,726,270,86,37,8,4,49
08/01/16,1,2,738,270,59,59,10,6,75
08/01/16,1,3,996,300,85,12,19,10,41
08/01/16,1,5,513,400,121,17,6,2,25
08/01/16,1,6,774,370,103,27,16,1,44
08/01/16,1,7,642,345,149,11,1,0,12
08/01/16,1,8,285,350,137,5,10,8,23
08/01/16,1,9,774,350,122,2,20,3,25
08/01/16,1,10,3062,380,125,18,16,2,36
08/01/16,1,11,7652,355,63,19,17,2,38
08/01/16,1,12,8032,350,115,18,17,1,36
08/01/16,1,15,775,350,130,5,6,1,12
08/01/16,1,17,513,370,70,10,0,2,12
08/01/16,1,18,542,350,112,17,10,4,31
08/01/16,1,19,542,360,52,54,1,0,55
08/01/16,1,20,8040,350,79,15,25,7,47
08/01/16,1,21,542,350,37,3,8,0,11
08/01/16,1,22,542,350,54,1,5,0,6
08/01/16,1,23,542,350,32,7,1,0,8
08/01/16,1,24,7675,360,106,19,4,10,33
08/01/16,1,25,542,375,89,15,2,0,17
08/01/16,1,26,641,360,139,2,5,0,7
08/01/16,1,27,542,360,124,20,3,0,23
08/01/16,1,28,7625,375,139,18,0,3,21
08/01/16,2,1,726,270,95,21,16,0,37
08/01/16,2,2,738,270,78,41,18,0,59
08/01/16,2,3,996,300,81,18,17,7,42
08/01/16,2,5,513,400,134,18,2,1,21
08/01/16,2,6,774,370,47,13,4,0,17
08/01/16,2,7,642,345,144,5,7,1,13
08/01/16,2,8,285,350,145,7,7,5,19
08/01/16,2,9,774,350,108,11,25,3,39
08/01/16,2,10,3062,380,112,17,16,5,38
08/01/16,2,11,7652,355,95,22,3,1,26
08/01/16,2,12,8032,350,100,22,15,5,42
08/01/16,2,15,775,350,125,0,5,1,6
08/01/16,2,17,513,370,124,12,4,3,19
08/01/16,2,18,542,350,106,17,13,2,32
08/01/16,2,19,542,360,39,40,2,1,43
08/01/16,2,20,8040,350,95,10,14,3,27
08/01/16,2,21,542,350,103,5,17,0,22
08/01/16,2,22,542,350,100,8,8,1,17
08/01/16,2,23,542,350,70,21,2,0,23
08/01/16,2,24,7675,360,100,11,9,0,20
08/01/16,2,25,542,375,120,7,6,1,14
08/01/16,2,26,641,360,138,3,3,1,7
08/01/16,2,27,542,360,95,18,6,1,25
08/01/16,2,28,7625,375,127,17,1,1,19
08/01/16,3,1,726,270,95,30,9,2,41
08/01/16,3,2,738,270,54,24,7,5,36
08/01/16,3,3,996,300,58,8,21,5,34
08/01/16,3,5,513,400,140,21,6,0,27
08/01/16,3,7,642,345,162,2,0,1,3
08/01/16,3,8,285,350,116,7,6,4,17
08/01/16,3,9,774,350,126,10,20,3,33
08/01/16,3,10,3062,380,112,24,21,4,49
08/01/16,3,11,7652,355,101,24,18,2,44
08/01/16,3,12,8032,350,97,25,24,1,50
08/01/16,3,15,775,350,126,4,6,0,10
08/01/16,3,17,513,370,87,19,4,2,25
08/01/16,3,18,542,350,96,17,4,3,24
08/01/16,3,19,542,360,43,38,3,0,41
08/01/16,3,20,8040,350,70,12,15,5,32
08/01/16,3,21,542,350,85,8,13,0,21
08/01/16,3,22,542,350,117,7,5,0,12
08/01/16,3,23,542,350,105,22,3,0,25
08/01/16,3,24,7675,360,77,12,9,2,23
08/01/16,3,25,542,375,103,10,7,0,17
08/01/16,3,26,641,360,132,1,2,0,3
08/01/16,3,27,542,360,109,15,5,0,20
08/01/16,3,28,7625,375,129,16,1,1,18
08/02/16,1,1,726,270,99,21,14,1,36
08/02/16,1,2,738,270,90,41,9,2,52
08/02/16,1,3,996,300,19,12,2,3,17
08/02/16,1,5,513,400,132,19,7,5,31
08/02/16,1,7,642,345,151,9,1,1,11
08/02/16,1,9,774,350,72,23,19,3,45
08/02/16,1,10,3062,380,143,21,20,4,45
08/02/16,1,11,7652,355,123,21,18,1,40
08/02/16,1,12,8032,350,112,15,20,3,38
08/02/16,1,14,747,360,45,0,2,2,4
08/02/16,1,15,775,350,159,2,6,1,9
08/02/16,1,17,513,370,145,15,2,5,22
08/02/16,1,18,542,350,123,24,10,4,38
08/02/16,1,19,542,360,61,69,2,1,72
08/02/16,1,20,8040,350,94,16,22,3,41
08/02/16,1,21,542,350,105,10,12,0,22
08/02/16,1,22,542,350,76,5,1,1,7
08/02/16,1,23,542,350,85,23,5,1,29
08/02/16,1,24,7675,360,104,15,9,1,25
08/02/16,1,25,542,375,93,12,7,1,20
08/02/16,1,26,641,360,159,3,4,1,8
08/02/16,1,27,542,360,135,13,12,1,26
08/02/16,1,28,7625,375,151,4,1,2,7
08/02/16,2,1,726,270,86,22,11,2,35
08/02/16,2,2,738,270,20,11,0,1,12
08/02/16,2,3,996,300,75,5,1,0,6
08/02/16,2,5,513,400,111,10,4,3,17
08/02/16,2,7,642,345,155,2,5,0,7
08/02/16,2,10,3062,380,141,16,24,2,42
08/02/16,2,11,7652,355,126,20,8,5,33
08/02/16,2,12,8032,350,105,33,20,2,55
08/02/16,2,13,775,400,10,2,16,6,24
08/02/16,2,14,747,360,144,5,2,2,9
08/02/16,2,15,775,350,117,4,7,1,12
08/02/16,2,17,513,370,96,15,6,3,24
08/02/16,2,18,542,350,81,16,6,3,25
08/02/16,2,19,542,360,30,27,1,0,28
08/02/16,2,20,8040,350,88,11,17,1,29
08/02/16,2,21,542,350,59,7,16,0,23
08/02/16,2,22,542,350,86,5,7,1,13
08/02/16,2,23,542,350,98,19,2,1,22
08/02/16,2,24,7675,360,106,15,6,1,22
08/02/16,2,25,542,375,78,10,5,0,15
08/02/16,2,26,641,360,11,0,3,0,3
08/02/16,2,27,542,360,79,16,5,1,22
08/02/16,2,28,7625,375,110,15,4,2,21
08/02/16,3,1,726,270,75,19,11,5,35
08/02/16,3,3,996,300,78,50,10,11,71
08/02/16,3,5,513,400,114,11,8,3,22
08/02/16,3,7,642,345,148,19,2,2,23
08/02/16,3,8,783,350,104,9,7,5,21
08/02/16,3,10,3062,380,140,7,21,1,29
08/02/16,3,11,7652,355,101,31,12,0,43
08/02/16,3,12,8032,350,94,26,21,2,49
08/02/16,3,13,775,400,105,12,6,0,18
08/02/16,3,14,747,360,148,13,2,1,16
08/02/16,3,15,775,350,110,4,4,0,8
08/02/16,3,17,513,370,81,12,2,1,15
08/02/16,3,18,542,350,108,25,2,1,28
08/02/16,3,19,542,360,41,37,0,0,37
08/02/16,3,20,8040,350,69,14,23,3,40
08/02/16,3,21,542,350,98,7,12,0,19
08/02/16,3,23,542,350,78,17,5,0,22
08/02/16,3,24,7675,360,14,0,5,0,5
08/02/16,3,25,542,375,62,18,1,0,19
08/02/16,3,27,542,360,92,16,5,0,21
08/02/16,3,28,7625,375,121,12,4,2,18
08/03/16,1,1,726,270,105,37,7,1,45
08/03/16,1,3,996,300,87,53,9,14,76
08/03/16,1,5,513,400,74,6,3,3,12
08/03/16,1,7,642,345,154,9,3,2,14
08/03/16,1,8,783,350,134,5,13,3,21
08/03/16,1,9,774,350,20,4,11,17,32
08/03/16,1,10,3062,380,145,19,16,3,38
08/03/16,1,11,7652,355,122,32,12,2,46
08/03/16,1,13,775,400,126,8,15,5,28
08/03/16,1,14,747,360,157,11,1,2,14
08/03/16,1,15,775,350,137,7,5,1,13
08/03/16,1,16,770,350,130,12,6,3,21
08/03/16,1,17,513,370,20,2,3,2,7
08/03/16,1,18,542,350,109,18,9,1,28
08/03/16,1,19,542,360,71,78,3,1,82
08/03/16,1,20,8040,350,99,33,23,5,61
08/03/16,1,21,542,350,107,11,0,23,34
08/03/16,1,23,542,350,107,36,7,1,44
08/03/16,1,27,542,360,115,14,6,1,21
08/03/16,2,1,726,270,92,28,10,1,39
08/03/16,2,3,996,300,67,47,8,9,64
08/03/16,2,7,642,345,156,6,1,2,9
08/03/16,2,8,783,350,133,7,2,4,13
08/03/16,2,9,774,350,14,13,8,0,21
08/03/16,2,10,3062,380,131,24,27,2,53
08/03/16,2,11,7652,355,110,30,20,1,51
08/03/16,2,13,775,400,129,8,14,2,24
08/03/16,2,14,747,360,141,5,1,3,9
08/03/16,2,15,775,350,130,4,12,1,17
08/03/16,2,16,770,350,84,22,7,0,29
08/03/16,2,17,513,370,145,15,6,3,24
08/03/16,2,18,542,350,127,11,9,2,22
08/03/16,2,19,542,360,57,56,1,1,58
08/03/16,2,20,8040,350,72,41,21,4,66
08/03/16,2,21,542,350,109,11,15,0,26
08/03/16,2,23,542,350,113,33,4,1,38
08/03/16,2,27,542,360,117,13,10,1,24
08/03/16,3,1,726,270,83,32,11,2,45
08/03/16,3,3,996,300,53,37,18,13,68
08/03/16,3,7,642,345,89,6,1,2,9
08/03/16,3,8,783,350,88,5,6,3,14
08/03/16,3,9,774,350,35,17,8,12,37
08/03/16,3,10,3062,380,11,19,27,1,47
08/03/16,3,11,7652,355,86,21,12,0,33
08/03/16,3,13,775,400,139,3,11,3,17
08/03/16,3,14,747,360,143,13,0,1,14
08/03/16,3,15,775,350,138,3,6,0,9
08/03/16,3,16,770,350,32,8,11,1,20
08/03/16,3,17,513,370,108,18,6,4,28
08/03/16,3,18,542,350,52,8,10,5,23
08/03/16,3,19,542,360,23,27,0,0,27
08/03/16,3,20,8040,350,57,19,19,6,44
08/03/16,3,21,542,350,90,7,19,0,26
08/03/16,3,23,542,350,73,18,1,0,19
08/03/16,3,24,7675,360,9,2,2,1,5
08/03/16,3,26,641,360,22,6,3,0,9
08/03/16,3,27,542,360,12,1,1,0,2
08/04/16,1,1,726,270,97,44,7,2,53
08/04/16,1,3,996,300,85,71,7,17,95
08/04/16,1,6,774,370,20,1,3,11,15
08/04/16,1,7,642,345,150,12,1,3,16
08/04/16,1,8,783,350,137,10,8,3,21
08/04/16,1,10,3062,380,142,12,27,3,42
08/04/16,1,12,8032,350,50,30,7,1,38
08/04/16,1,13,775,400,125,2,15,1,18
08/04/16,1,14,747,360,130,15,5,4,24
08/04/16,1,15,775,350,135,2,10,1,13
08/04/16,1,17,513,370,127,18,5,6,29
08/04/16,1,18,542,350,111,16,18,4,38
08/04/16,1,19,542,360,17,24,0,0,24
08/04/16,1,20,8040,350,101,22,19,2,43
08/04/16,1,21,542,350,93,9,23,0,32
08/04/16,1,23,542,350,58,13,5,0,18
08/04/16,1,24,7675,360,106,17,10,2,29
08/04/16,1,26,641,360,84,6,18,0,24
08/04/16,2,1,726,270,84,31,10,1,42
08/04/16,2,3,996,300,24,13,21,3,37
08/04/16,2,6,774,370,152,3,9,1,13
08/04/16,2,7,642,345,157,9,0,0,9
08/04/16,2,8,783,350,115,8,4,2,14
08/04/16,2,10,3062,380,6,1,3,0,4
08/04/16,2,12,8032,350,109,39,13,1,53
08/04/16,2,13,775,400,142,6,15,2,23
08/04/16,2,14,747,360,153,8,4,2,14
08/04/16,2,15,775,350,128,5,5,1,11
08/04/16,2,17,513,370,146,11,3,2,16
08/04/16,2,18,542,350,125,20,14,3,37
08/04/16,2,20,8040,350,88,33,24,4,61
08/04/16,2,21,542,350,17,8,18,0,26
08/04/16,2,24,7675,360,122,24,6,1,31
08/04/16,2,26,641,360,101,8,12,0,20
08/04/16,2,28,7625,375,52,6,4,4,14
08/04/16,3,1,726,270,96,36,10,0,46
08/04/16,3,6,774,370,143,5,11,1,17
08/04/16,3,7,642,345,158,7,0,1,8
08/04/16,3,8,783,350,111,10,11,4,25
08/04/16,3,12,8032,350,99,25,18,2,45
08/04/16,3,13,775,400,122,5,22,4,31
08/04/16,3,14,747,360,110,7,7,0,14
08/04/16,3,15,775,350,134,7,6,0,13
08/04/16,3,17,513,370,127,21,2,3,26
08/04/16,3,18,542,350,108,23,8,3,34
08/04/16,3,20,8040,350,84,22,17,8,47
08/04/16,3,21,542,350,106,8,18,0,26
08/04/16,3,24,7675,360,89,23,9,1,33
08/04/16,3,26,641,360,127,12,4,0,16
08/04/16,3,28,7625,375,127,8,5,3,16
08/05/16,1,1,726,270,104,33,11,0,44
08/05/16,1,3,996,300,20,5,4,4,13
08/05/16,1,6,774,370,153,15,9,1,25
08/05/16,1,7,642,345,158,11,1,1,13
08/05/16,1,8,783,350,146,8,10,3,21
08/05/16,1,12,8032,350,124,32,16,3,51
08/05/16,1,14,747,360,158,0,7,3,10
08/05/16,1,15,775,350,78,4,2,0,6
08/05/16,1,16,294,350,33,32,23,30,85
08/05/16,1,17,513,370,148,16,3,1,20
08/05/16,1,18,542,350,37,6,2,1,9
08/05/16,1,20,8040,350,95,30,28,4,62
08/05/16,1,21,542,350,112,7,28,0,35
08/05/16,1,24,7675,360,125,28,5,2,35
08/05/16,1,25,542,375,12,15,3,0,18
08/05/16,1,26,641,360,143,7,6,0,13
08/05/16,1,28,7625,375,141,15,1,6,22
08/05/16,2,1,726,270,95,27,10,3,40
08/05/16,2,3,996,300,85,29,7,6,42
08/05/16,2,6,774,370,141,11,8,2,21
08/05/16,2,7,642,345,150,11,2,1,14
08/05/16,2,8,783,350,126,5,14,2,21
08/05/16,2,10,3062,380,29,0,4,3,7
08/05/16,2,11,7652,355,29,3,7,4,14
08/05/16,2,12,8032,350,103,38,20,5,63
08/05/16,2,14,747,360,151,3,2,2,7
08/05/16,2,16,294,350,35,14,16,4,34
08/05/16,2,17,513,370,134,38,3,1,42
08/05/16,2,20,8040,350,87,16,23,7,46
08/05/16,2,21,542,350,85,6,26,0,32
08/05/16,2,24,7675,360,106,20,6,3,29
08/05/16,2,25,542,375,69,10,13,0,23
08/05/16,2,26,641,360,136,3,7,1,11
08/05/16,2,28,7625,375,135,9,2,10,21
08/05/16,3,1,726,270,91,24,14,3,41
08/05/16,3,3,996,300,89,30,9,10,49
08/05/16,3,6,774,370,10,0,0,1,1
08/05/16,3,7,642,345,145,10,0,1,11
08/05/16,3,8,783,350,24,1,4,1,6
08/05/16,3,10,3062,380,145,13,8,7,28
08/05/16,3,11,7652,355,128,7,13,1,21
08/05/16,3,12,8032,350,108,29,14,5,48
08/05/16,3,14,747,360,151,6,1,5,12
08/05/16,3,16,294,350,62,45,15,7,67
08/05/16,3,17,513,370,89,32,4,2,38
08/05/16,3,18,542,350,13,9,4,10,23
08/05/16,3,20,8040,350,58,23,27,5,55
08/05/16,3,21,542,350,81,13,6,0,19
08/05/16,3,23,542,350,23,9,9,0,18
08/05/16,3,24,7675,360,71,24,2,0,26
08/05/16,3,26,641,360,144,1,4,0,5
08/05/16,3,28,7625,375,66,7,0,3,10
08/15/16,1,1,726,270,83,51,4,0,55
08/15/16,1,3,996,300,75,44,15,7,66
08/15/16,1,6,775,370,135,13,1,2,16
08/15/16,1,7,642,345,144,9,0,1,10
08/15/16,1,10,3062,380,146,16,9,4,29
08/15/16,1,11,7652,355,151,12,26,3,41
08/15/16,1,12,8032,350,117,30,19,3,52
08/15/16,1,14,747,360,154,1,0,1,2
08/15/16,1,16,294,350,34,19,23,6,48
08/15/16,1,17,513,370,112,39,5,1,45
08/15/16,1,18,542,350,108,32,11,2,45
08/15/16,1,20,8040,350,40,63,11,5,79
08/15/16,1,21,542,350,59,8,15,0,23
08/15/16,1,22,542,350,20,12,6,0,18
08/15/16,1,23,542,350,59,27,8,0,35
08/15/16,1,26,641,360,144,5,4,1,10
08/15/16,1,27,542,360,14,2,1,0,3
08/15/16,2,1,726,305,48,21,8,1,30
08/15/16,2,3,996,300,99,43,8,7,58
08/15/16,2,6,775,370,153,10,4,3,17
08/15/16,2,7,642,345,63,6,2,0,8
08/15/16,2,10,3062,380,143,12,15,3,30
08/15/16,2,11,7652,355,160,11,23,1,35
08/15/16,2,12,8032,350,135,17,17,2,36
08/15/16,2,14,747,360,157,5,0,3,8
08/15/16,2,16,294,350,5,5,0,3,8
08/15/16,3,13,775,400,97,5,4,1,10
08/15/16,3,14,747,360,159,1,1,1,3
08/15/16,3,15,775,350,125,1,6,0,7
08/15/16,3,17,513,370,19,8,1,1,10
08/15/16,3,18,542,350,55,33,4,0,37
08/15/16,3,19,542,360,23,27,0,0,27
08/15/16,3,20,8040,350,54,17,11,4,32
08/15/16,3,21,542,350,59,4,16,0,20
08/15/16,3,22,542,350,42,19,5,0,24
08/15/16,3,23,542,350,72,21,4,0,25
08/15/16,3,26,641,360,148,6,2,0,8
08/15/16,3,27,542,360,123,8,5,0,13
08/16/16,1,3,996,300,99,40,14,8,62
08/16/16,1,10,3062,380,158,11,8,2,21
08/16/16,1,11,7652,355,140,13,21,4,38
08/16/16,1,12,8032,350,127,18,23,5,46
08/16/16,1,13,775,400,83,5,22,4,31
08/16/16,1,14,747,360,141,5,2,7,14
08/16/16,1,15,775,350,146,3,6,1,10
08/16/16,1,16,294,350,10,6,1,1,8
08/16/16,1,17,513,370,99,46,2,1,49
08/16/16,1,18,542,350,83,42,9,3,54
08/16/16,1,19,542,360,26,50,0,0,50
08/16/16,1,20,8040,350,59,42,13,5,60
08/16/16,1,21,542,350,36,6,12,0,18
08/16/16,1,22,542,350,20,9,8,0,17
08/16/16,1,23,542,350,101,26,9,1,36
08/16/16,1,26,641,360,145,1,6,0,7
08/16/16,1,27,542,360,113,11,5,0,16
08/16/16,2,3,996,300,11,4,5,2,11
08/16/16,2,10,3062,380,162,14,10,3,27
08/16/16,2,11,7652,355,150,14,18,3,35
08/16/16,2,12,8032,350,151,11,11,2,24
08/16/16,2,13,775,400,150,9,10,2,21
08/16/16,2,14,747,360,109,7,1,3,11
08/16/16,2,15,775,350,85,10,5,0,15
08/16/16,2,17,513,370,97,40,2,1,43
08/16/16,2,18,542,350,80,45,6,1,52
08/16/16,2,20,8040,350,108,47,30,5,82
08/16/16,3,6,775,370,85,50,2,1,53
08/16/16,3,13,775,400,127,4,5,2,11
08/16/16,3,14,747,360,136,7,5,1,13
08/16/16,3,15,775,350,55,3,3,0,6
08/16/16,3,17,513,370,87,37,2,1,40
08/16/16,3,18,542,350,92,20,5,3,28
08/16/16,3,19,542,360,13,28,0,0,28
08/16/16,3,20,8040,350,61,17,15,7,39
08/16/16,3,21,542,350,90,4,19,0,23
08/16/16,3,23,542,350,59,31,0,0,31
08/16/16,3,25,542,375,12,15,3,0,18
08/16/16,3,26,641,360,155,1,0,0,1
08/16/16,3,27,542,360,47,3,7,0,10
08/16/16,3,28,7625,375,114,4,4,0,8
08/17/16,1,6,775,370,145,10,11,2,23
08/17/16,1,7,92,345,4,9,9,6,24
08/17/16,1,10,3062,380,156,14,13,3,30
08/17/16,1,11,7652,355,151,12,19,2,33
08/17/16,1,12,8032,350,144,12,15,6,33
08/17/16,1,13,775,400,127,3,11,2,16
08/17/16,1,14,747,360,60,3,1,1,5
08/17/16,1,15,775,350,141,2,6,2,10
08/17/16,1,16,294,350,104,27,9,7,43
08/17/16,1,17,513,370,111,50,3,1,54
08/17/16,1,18,542,350,127,25,9,1,35
08/17/16,1,19,542,360,14,36,1,0,37
08/17/16,1,20,8040,350,45,15,20,2,37
08/17/16,1,21,542,350,15,3,4,0,7
08/17/16,1,23,542,350,84,33,12,0,45
08/17/16,1,25,542,375,48,5,20,0,25
08/17/16,1,26,641,360,132,3,2,1,6
08/17/16,1,28,7625,375,130,12,2,3,17
08/17/16,2,3,996,300,11,4,5,2,11
08/17/16,2,6,775,370,153,10,4,2,16
08/17/16,2,7,92,345,95,72,1,1,74
08/17/16,2,10,3062,380,154,6,14,2,22
08/17/16,2,11,7652,355,151,11,22,1,34
08/17/16,2,12,8032,350,128,17,16,3,36
08/17/16,2,13,775,400,131,10,18,1,29
08/17/16,2,15,775,350,138,2,7,1,10
08/17/16,2,16,294,350,74,14,21,12,47
08/17/16,2,17,513,370,129,20,4,2,26
08/17/16,2,18,542,350,72,62,3,3,68
08/17/16,2,19,542,360,18,24,2,0,26
08/17/16,2,23,542,350,83,32,8,1,41
08/17/16,2,25,542,375,21,5,9,0,14
08/17/16,2,26,641,360,155,5,3,1,9
08/17/16,2,28,7625,375,118,6,0,4,10
08/17/16,3,3,996,300,97,23,9,10,42
08/17/16,3,5,8035,400,56,4,12,22,38
08/17/16,3,6,775,370,152,4,7,1,12
08/17/16,3,7,92,345,147,14,3,2,19
08/17/16,3,10,3062,380,155,10,11,2,23
08/17/16,3,11,7652,355,153,10,18,2,30
08/17/16,3,13,775,400,108,10,18,2,30
08/17/16,3,15,775,350,132,2,8,0,10
08/17/16,3,17,513,370,107,32,4,2,38
08/17/16,3,18,542,350,87,82,7,7,96
08/17/16,3,23,542,350,84,41,5,0,46
08/17/16,3,26,641,360,154,10,2,0,12
08/17/16,3,28,7625,375,117,13,5,4,22
08/18/16,1,3,996,300,121,23,8,4,35
08/18/16,1,5,8035,400,134,0,4,9,13
08/18/16,1,6,775,370,164,6,4,1,11
08/18/16,1,7,92,345,155,13,4,3,20
08/18/16,1,10,3062,380,162,14,10,5,29
08/18/16,1,11,7652,355,143,18,11,0,29
08/18/16,1,13,775,400,129,11,20,3,34
08/18/16,1,15,775,350,108,7,5,1,13
08/18/16,1,17,513,370,73,27,2,2,31
08/18/16,1,18,542,350,72,111,6,2,119
08/18/16,1,23,542,350,104,25,6,1,32
08/18/16,1,24,7675,360,68,25,2,2,29
08/18/16,1,26,641,360,162,3,0,1,4
08/18/16,1,28,7625,375,47,14,2,3,19
08/18/16,2,3,996,300,114,28,9,6,43
08/18/16,2,5,8035,400,102,1,10,7,18
08/18/16,2,6,775,370,160,13,0,1,14
08/18/16,2,7,92,345,156,5,4,2,11
08/18/16,2,10,3062,380,162,8,20,2,30
08/18/16,2,11,7652,355,132,19,17,2,38
08/18/16,2,13,775,400,19,0,4,0,4
08/18/16,2,15,775,350,136,3,7,1,11
08/18/16,2,18,542,350,36,111,6,2,119
08/18/16,2,19,542,360,26,31,4,0,35
08/18/16,2,20,7393,350,20,43,18,7,68
08/18/16,2,23,542,350,111,29,15,1,45
08/18/16,2,24,7675,360,120,20,5,0,25
08/18/16,2,26,641,360,158,3,3,1,7
08/18/16,3,3,996,300,87,47,7,14,68
08/18/16,3,5,8035,400,56,4,12,22,38
08/18/16,3,6,775,370,155,9,8,3,20
08/18/16,3,7,92,345,135,10,7,2,19
08/18/16,3,8,783,350,77,7,6,4,17
08/18/16,3,10,3062,380,160,12,12,2,26
08/18/16,3,11,7652,355,112,6,36,5,47
08/18/16,3,15,775,350,146,4,6,0,10
08/18/16,3,18,542,350,69,81,13,1,95
08/18/16,3,19,542,360,62,45,13,0,58
08/18/16,3,20,7393,350,30,92,14,2,108
08/18/16,3,23,542,350,102,27,9,0,36
08/18/16,3,24,7675,360,29,6,2,1,9
08/18/16,3,26,641,360,134,4,3,0,7
08/19/16,1,3,996,300,52,25,7,8,40
08/19/16,1,5,8035,400,141,9,6,3,18
08/19/16,1,6,775,370,163,4,2,1,7
08/19/16,1,7,92,345,160,2,1,2,5
08/19/16,1,8,783,350,96,9,12,5,26
08/19/16,1,10,3062,380,174,5,10,2,17
08/19/16,1,11,7652,355,127,18,9,0,27
08/19/16,1,14,747,360,17,16,11,31,58
08/19/16,1,15,775,350,131,14,5,1,20
08/19/16,1,18,542,350,105,66,17,1,84
08/19/16,1,19,542,360,62,41,7,1,49
08/19/16,1,20,7393,350,11,10,2,1,13
08/19/16,1,21,542,350,34,13,5,0,18
08/19/16,1,23,542,350,143,28,4,1,33
08/19/16,1,24,7675,360,137,9,4,2,15
08/19/16,1,26,641,360,182,1,0,1,2
08/19/16,1,28,7625,375,35,0,2,2,4
08/19/16,2,3,996,300,61,28,13,5,46
08/19/16,2,5,8035,400,156,2,4,2,8
08/19/16,2,6,775,370,156,11,6,1,18
08/19/16,2,7,92,345,157,7,2,4,13
08/19/16,2,8,783,350,118,15,23,3,41
08/19/16,2,10,3062,380,46,1,4,1,6
08/19/16,2,11,7652,355,147,22,9,0,31
08/19/16,2,14,747,360,74,5,17,7,29
08/19/16,2,15,775,350,145,6,2,1,9
08/19/16,2,18,542,350,61,52,11,1,64
08/19/16,2,19,542,360,58,52,7,0,59
08/19/16,2,20,7393,350,2,3,2,2,7
08/19/16,2,21,542,350,35,5,6,0,11
08/19/16,2,23,542,350,99,17,14,1,32
08/19/16,2,24,7675,360,117,19,6,2,27
08/19/16,2,26,641,360,162,6,1,1,8
08/19/16,2,28,7625,375,126,11,5,2,18
08/19/16,3,3,996,300,94,35,10,4,49
08/19/16,3,5,8035,400,145,2,5,7,14
08/19/16,3,6,775,370,143,17,6,3,26
08/19/16,3,7,92,345,144,7,6,3,16
08/19/16,3,8,783,350,106,8,19,2,29
08/19/16,3,11,7652,355,131,19,13,1,33
08/19/16,3,14,747,360,126,8,15,3,26
08/19/16,3,15,775,140,145,6,2,0,8
08/19/16,3,18,542,350,90,55,13,2,70
08/19/16,3,19,542,360,45,53,2,0,55
08/19/16,3,23,542,350,102,24,6,0,30
08/19/16,3,24,7675,360,94,13,5,2,20
08/19/16,3,25,542,375,67,6,5,0,11
08/19/16,3,26,641,360,151,5,6,0,11
08/19/16,3,28,7625,375,38,10,4,3,17
08/22/16,1,3,996,300,29,4,4,4,12
08/22/16,1,5,8035,400,125,5,5,9,19
08/22/16,1,6,775,370,154,8,4,3,15
08/22/16,1,8,783,350,118,19,12,1,32
08/22/16,1,11,7652,355,127,24,18,0,42
08/22/16,1,14,747,360,129,7,9,0,16
08/22/16,1,15,775,350,157,1,8,2,11
08/22/16,1,16,294,350,21,3,10,4,17
08/22/16,1,18,542,350,113,41,7,3,51
08/22/16,1,19,542,360,85,59,4,1,64
08/22/16,1,20,7393,350,57,104,13,4,121
08/22/16,1,23,542,350,98,29,7,1,37
08/22/16,1,24,7675,360,122,16,7,3,26
08/22/16,1,25,542,375,100,17,4,0,21
08/22/16,1,26,641,360,75,1,3,1,5
08/22/16,1,28,7625,375,103,17,6,2,25
08/22/16,2,5,8035,400,159,2,4,0,6
08/22/16,2,6,775,370,155,8,1,3,12
08/22/16,2,8,783,350,138,10,8,4,22
08/22/16,2,10,3062,380,48,4,4,2,10
08/22/16,2,11,7652,355,111,19,14,2,35
08/22/16,2,12,8032,350,72,10,21,13,44
08/22/16,2,14,747,360,140,7,12,1,20
08/22/16,2,15,775,350,125,7,4,1,12
08/22/16,2,16,294,350,120,47,19,5,71
08/22/16,2,18,542,350,73,34,11,0,45
08/22/16,2,19,542,360,62,45,6,0,51
08/22/16,2,20,7393,350,37,72,6,4,82
08/22/16,2,23,542,350,92,24,3,1,28
08/22/16,2,24,7675,360,5,0,3,2,5
08/22/16,2,25,542,375,119,11,3,1,15
08/22/16,2,28,7625,375,137,14,4,1,19
08/22/16,3,3,996,300,86,20,5,12,37
08/22/16,3,5,8035,400,151,2,5,1,8
08/22/16,3,6,775,370,151,25,4,2,31
08/22/16,3,10,3062,380,101,12,8,8,28
08/22/16,3,12,8032,350,109,24,29,3,56
08/22/16,3,14,747,360,151,2,11,0,13
08/22/16,3,15,775,350,33,2,2,0,4
08/22/16,3,16,294,350,24,23,33,8,64
08/22/16,3,18,542,350,81,62,12,1,75
08/22/16,3,19,542,360,94,47,6,0,53
08/22/16,3,20,7393,350,60,62,23,11,96
08/22/16,3,23,542,350,95,26,12,0,38
08/22/16,3,25,542,375,59,7,2,0,9
08/22/16,3,28,7625,375,63,9,1,1,11
08/23/16,1,3,996,300,115,15,9,23,47
08/23/16,1,5,8035,400,156,4,7,2,13
08/23/16,1,6,775,370,17,5,1,0,6
08/23/16,1,8,783,350,116,16,16,4,36
08/23/16,1,10,3062,380,140,11,11,2,24
08/23/16,1,12,8032,350,118,49,26,5,80
08/23/16,1,14,747,360,153,7,4,2,13
08/23/16,1,16,294,350,16,2,11,6,19
08/23/16,1,17,513,370,34,14,1,10,25
08/23/16,1,18,542,350,116,58,9,2,69
08/23/16,1,19,542,360,126,55,6,1,62
08/23/16,1,20,7393,350,69,120,9,3,132
08/23/16,1,23,542,350,106,30,14,1,45
08/23/16,1,25,542,375,75,12,2,1,15
08/23/16,2,3,996,300,89,46,6,6,58
08/23/16,2,5,8035,400,152,7,6,0,13
08/23/16,2,8,783,350,123,19,21,2,42
08/23/16,2,10,3062,380,166,11,8,2,21
08/23/16,2,12,8032,350,109,29,34,1,64
08/23/16,2,14,747,360,148,4,10,2,16
08/23/16,2,16,294,350,2,1,1,7,9
08/23/16,2,17,513,370,98,31,4,1,36
08/23/16,2,18,542,350,80,55,5,4,64
08/23/16,2,19,542,360,86,42,6,1,49
08/23/16,2,20,7393,350,104,74,2,6,82
08/23/16,2,23,542,350,34,17,3,0,20
08/23/16,2,24,7675,360,118,12,6,0,18
08/23/16,2,25,542,375,131,7,5,1,13
08/23/16,2,28,7625,375,10,4,0,2,6
08/23/16,3,3,996,300,74,27,6,9,42
08/23/16,3,5,8035,400,120,20,4,3,27
08/23/16,3,8,783,350,108,16,13,2,31
08/23/16,3,10,3062,380,157,13,9,3,25
08/23/16,3,12,8032,350,105,24,27,1,52
08/23/16,3,14,747,360,122,4,13,1,18
08/23/16,3,16,294,350,33,12,20,8,40
08/23/16,3,17,513,370,74,32,10,0,42
08/23/16,3,18,542,350,93,37,8,1,46
08/23/16,3,19,542,360,77,29,5,0,34
08/23/16,3,20,7393,350,75,28,10,4,42
08/23/16,3,21,542,350,45,8,7,0,15
08/23/16,3,24,7675,360,84,14,2,0,16
08/23/16,3,25,542,375,88,5,4,0,9
08/24/16,1,3,996,300,104,33,2,11,46
08/24/16,1,5,8035,400,115,5,4,1,10
08/24/16,1,7,7331,345,77,7,8,7,22
08/24/16,1,8,783,350,137,20,8,2,30
08/24/16,1,10,3062,380,160,17,11,3,31
08/24/16,1,12,8032,350,130,34,32,2,68
08/24/16,1,14,747,360,120,6,9,2,17
08/24/16,1,16,294,350,113,15,10,16,41
08/24/16,1,17,513,370,29,10,0,2,12
08/24/16,1,18,542,350,67,25,19,3,47
08/24/16,1,19,542,360,101,57,6,1,64
08/24/16,1,20,7393,350,102,18,6,17,41
08/24/16,1,21,542,350,89,11,27,0,38
08/24/16,1,23,542,350,15,2,4,0,6
08/24/16,1,24,7675,360,122,11,4,3,18
08/24/16,1,25,542,375,149,8,6,1,15
08/24/16,1,27,542,360,95,11,16,0,27
08/24/16,2,1,726,305,5,0,3,0,3
08/24/16,2,3,996,300,100,38,4,5,47
08/24/16,2,7,7331,345,137,30,0,3,33
08/24/16,2,8,783,350,128,22,9,3,34
08/24/16,2,10,3062,380,159,12,10,3,25
08/24/16,2,12,8032,350,124,24,24,2,50
08/24/16,2,14,747,360,112,1,24,4,29
08/24/16,2,16,294,350,27,7,2,0,9
08/24/16,2,19,542,360,67,52,2,0,54
08/24/16,2,20,7393,350,87,39,9,12,60
08/24/16,2,21,542,350,62,7,18,0,25
08/24/16,2,22,642,350,48,10,7,0,17
08/24/16,2,23,542,350,112,24,5,1,30
08/24/16,2,24,7675,360,109,16,7,5,28
08/24/16,2,25,542,375,108,4,2,1,7
08/24/16,2,27,542,360,86,13,19,1,33
08/24/16,2,28,7625,375,43,2,0,1,3
08/24/16,3,1,726,305,52,18,11,1,30
08/24/16,3,3,996,300,97,32,7,8,47
08/24/16,3,6,542,370,12,14,1,0,15
08/24/16,3,7,7331,345,145,18,4,2,24
08/24/16,3,8,783,350,113,15,17,2,34
08/24/16,3,10,3062,380,159,1,11,4,16
08/24/16,3,12,8032,350,101,20,28,2,50
08/24/16,3,14,747,360,142,2,13,1,16
08/24/16,3,19,542,360,65,28,7,0,35
08/24/16,3,20,7393,350,33,22,6,1,29
08/24/16,3,21,542,350,56,10,20,0,30
08/24/16,3,22,642,350,59,10,13,0,23
08/24/16,3,23,542,350,88,23,3,0,26
08/24/16,3,24,7675,360,104,16,3,0,19
08/24/16,3,25,542,375,103,8,7,0,15
08/24/16,3,27,542,360,58,7,16,0,23
08/24/16,3,28,7625,375,57,5,0,1,6
08/25/16,1,1,726,305,12,5,18,0,23
08/25/16,1,3,996,300,3,3,0,3,6
08/25/16,1,6,542,370,108,31,5,1,37
08/25/16,1,7,7331,345,151,22,1,1,24
08/25/16,1,8,783,350,58,13,6,1,20
08/25/16,1,10,3062,380,169,9,8,2,19
08/25/16,1,12,8032,350,132,44,28,3,75
08/25/16,1,14,747,360,148,2,5,2,9
08/25/16,1,19,542,360,120,28,10,0,38
08/25/16,1,21,542,350,99,6,24,0,30
08/25/16,1,22,642,350,66,2,9,0,11
08/25/16,1,23,542,350,113,33,6,0,39
08/25/16,1,24,7675,360,81,12,1,0,13
08/25/16,1,25,542,375,113,6,13,1,20
08/25/16,1,27,542,360,110,19,9,1,29
08/25/16,1,28,7625,375,107,26,0,4,30
08/25/16,2,1,726,305,59,3,29,2,34
08/25/16,2,3,996,300,76,42,9,5,56
08/25/16,2,6,542,370,129,35,5,1,41
08/25/16,2,7,7331,345,141,16,9,2,27
08/25/16,2,10,3062,380,160,8,15,2,25
08/25/16,2,11,7652,355,118,22,8,1,31
08/25/16,2,12,8032,350,118,17,30,2,49
08/25/16,2,13,8030,400,38,1,4,3,8
08/25/16,2,14,747,360,151,2,9,1,12
08/25/16,2,17,641,370,66,9,5,11,25
08/25/16,2,18,542,350,42,65,4,2,71
08/25/16,2,19,542,360,71,31,2,1,34
08/25/16,2,21,542,350,70,16,9,0,25
08/25/16,2,22,642,350,122,2,5,1,8
08/25/16,2,23,542,350,91,19,11,0,30
08/25/16,2,24,7675,360,76,6,7,5,18
08/25/16,2,25,542,375,100,17,2,1,20
08/25/16,2,27,542,360,82,13,10,1,24
08/25/16,2,28,7625,375,118,14,5,1,20
08/25/16,3,3,996,300,67,65,6,18,89
08/25/16,3,6,542,370,127,53,3,2,58
08/25/16,3,7,7331,345,37,3,9,1,13
08/25/16,3,10,3062,380,165,11,8,2,21
08/25/16,3,11,7652,355,131,19,3,2,24
08/25/16,3,12,8032,350,113,16,31,3,50
08/25/16,3,13,8030,400,47,19,4,21,44
08/25/16,3,14,747,360,152,5,11,0,16
08/25/16,3,16,7687,350,80,18,5,9,32
08/25/16,3,17,641,370,91,18,21,14,53
08/25/16,3,18,542,350,43,32,6,0,38
08/25/16,3,19,542,360,20,15,3,0,18
08/25/16,3,21,542,350,32,26,6,0,32
08/25/16,3,22,642,350,68,3,10,0,13
08/25/16,3,23,542,350,94,14,5,0,19
08/25/16,3,25,542,375,127,3,4,0,7
08/25/16,3,27,542,360,96,16,4,0,20
08/26/16,1,1,726,305,83,10,22,2,34
08/26/16,1,3,996,300,67,51,9,14,74
08/26/16,1,6,542,370,149,23,5,1,29
08/26/16,1,8,783,350,11,0,4,1,5
08/26/16,1,10,3062,380,163,17,10,2,29
08/26/16,1,11,7652,355,138,15,9,0,24
08/26/16,1,12,8032,350,123,30,28,1,59
08/26/16,1,13,8030,400,59,5,27,15,47
08/26/16,1,14,747,360,83,4,19,2,25
08/26/16,1,16,7687,350,118,62,7,3,72
08/26/16,1,17,641,370,18,7,0,0,7
08/26/16,1,19,542,360,95,18,10,1,29
08/26/16,1,21,542,350,58,46,7,0,53
08/26/16,1,22,642,350,124,2,8,1,11
08/26/16,1,23,542,350,109,31,8,0,39
08/26/16,1,25,542,375,125,9,2,1,12
08/26/16,1,27,542,360,127,17,7,2,26
08/26/16,2,1,726,305,88,13,12,0,25
08/26/16,2,3,996,300,88,31,6,6,43
08/26/16,2,6,542,370,127,29,6,2,37
08/26/16,2,8,783,350,130,12,9,2,23
08/26/16,2,10,3062,380,157,7,11,3,21
08/26/16,2,11,7652,355,121,25,20,2,47
08/26/16,2,12,8032,350,65,12,33,2,47
08/26/16,2,13,8030,400,104,3,20,0,23
08/26/16,2,14,747,360,127,4,4,0,8
08/26/16,2,16,7687,350,80,34,10,4,48
08/26/16,2,17,641,370,75,20,5,5,30
08/26/16,2,19,542,360,74,48,3,1,52
08/26/16,2,21,542,350,54,17,15,0,32
08/26/16,2,22,642,350,146,8,5,2,15
08/26/16,2,23,542,350,108,28,7,1,36
08/26/16,2,24,7675,360,67,10,3,6,19
08/26/16,2,25,542,375,135,14,3,1,18
08/26/16,2,27,542,360,127,14,5,1,20
08/26/16,3,1,726,305,84,7,14,0,21
08/26/16,3,3,996,300,104,22,10,17,49
08/26/16,3,6,542,370,121,45,5,1,51
08/26/16,3,8,783,350,145,6,6,2,14
08/26/16,3,10,3062,380,16,0,3,0,3
08/26/16,3,11,7652,355,75,14,19,2,35
08/26/16,3,14,747,360,143,6,9,4,19
08/26/16,3,16,7687,350,107,26,8,47,81
08/26/16,3,17,641,370,147,3,9,3,15
08/26/16,3,19,542,360,43,33,4,0,37
08/26/16,3,21,542,350,32,26,6,0,32
08/26/16,3,22,642,350,133,6,3,0,9
08/26/16,3,23,542,350,86,30,1,0,31
08/26/16,3,24,7675,360,102,16,2,0,18
08/26/16,3,25,542,375,67,3,7,0,10
08/26/16,3,27,542,360,112,13,7,0,20
08/29/16,1,1,726,305,30,6,7,1,14
08/29/16,1,2,738,315,16,2,6,2,10
08/29/16,1,3,996,300,93,30,7,13,50
08/29/16,1,4,999,300,64,16,11,8,35
08/29/16,1,6,542,370,128,58,9,1,68
08/29/16,1,8,783,350,141,15,12,2,29
08/29/16,1,14,747,360,117,1,11,1,13
08/29/16,1,16,7687,350,141,10,11,6,27
08/29/16,1,17,641,370,108,0,8,3,11
08/29/16,1,19,542,360,82,47,13,1,61
08/29/16,1,20,7393,350,59,25,4,11,40
08/29/16,1,21,542,350,38,30,6,0,36
08/29/16,1,22,642,350,124,4,15,0,19
08/29/16,1,23,542,350,101,28,7,1,36
08/29/16,1,24,7675,360,132,19,2,0,21
08/29/16,1,27,542,360,126,12,7,1,20
08/29/16,2,2,738,315,112,4,15,13,32
08/29/16,2,3,996,300,101,20,8,6,34
08/29/16,2,4,999,300,76,50,3,8,61
08/29/16,2,6,542,370,85,49,1,1,51
08/29/16,2,8,783,350,142,11,6,3,20
08/29/16,2,9,7740,350,18,25,17,8,50
08/29/16,2,10,3062,380,132,10,7,2,19
08/29/16,2,13,8030,400,56,1,9,7,17
08/29/16,2,14,747,360,117,15,10,2,27
08/29/16,2,16,7687,350,99,16,5,3,24
08/29/16,2,17,641,370,118,9,6,4,19
08/29/16,2,19,542,360,74,49,8,0,57
08/29/16,2,20,7393,350,104,48,4,2,54
08/29/16,2,21,542,350,44,46,7,0,53
08/29/16,2,22,642,350,146,7,1,1,9
08/29/16,2,23,542,350,119,18,4,1,23
08/29/16,2,24,7675,360,127,14,4,4,22
08/29/16,2,26,7748,360,22,17,0,0,17
08/29/16,2,27,542,360,131,10,6,1,17
08/29/16,3,2,738,315,110,20,5,13,38
08/29/16,3,3,996,300,117,22,8,10,40
08/29/16,3,4,999,300,51,36,4,13,53
08/29/16,3,6,542,370,121,47,4,2,53
08/29/16,3,8,783,350,124,21,4,1,26
08/29/16,3,10,3062,380,155,25,5,4,34
08/29/16,3,14,747,360,98,12,11,2,25
08/29/16,3,16,7687,350,86,18,6,5,29
08/29/16,3,17,641,370,119,6,8,7,21
08/29/16,3,19,542,360,21,16,1,6,23
08/29/16,3,20,7393,350,34,17,0,1,18
08/29/16,3,21,542,350,30,22,10,0,32
08/29/16,3,22,642,350,121,6,1,0,7
08/29/16,3,23,542,350,91,17,8,0,25
08/29/16,3,24,7675,360,59,3,1,0,4
08/29/16,3,26,7748,360,42,33,0,0,33
08/29/16,3,27,542,360,91,6,13,0,19
08/30/16,1,2,738,315,113,14,6,6,26
08/30/16,1,3,996,300,119,14,7,15,36
08/30/16,1,4,999,300,75,97,9,10,116
08/30/16,1,6,542,370,43,18,14,31,63
08/30/16,1,7,7331,345,33,17,6,8,31
08/30/16,1,8,783,350,139,10,15,1,26
08/30/16,1,9,7740,350,11,31,4,2,37
08/30/16,1,10,3062,380,156,17,8,2,27
08/30/16,1,11,7652,355,17,5,1,2,8
08/30/16,1,13,8030,400,45,2,16,8,26
08/30/16,1,16,7687,350,70,24,8,14,46
08/30/16,1,17,641,370,121,4,13,2,19
08/30/16,1,20,7393,350,57,99,1,2,102
08/30/16,1,21,542,350,56,22,18,0,40
08/30/16,1,22,642,350,122,6,7,2,15
08/30/16,1,23,542,350,82,19,4,1,24
08/30/16,1,26,7748,360,65,38,4,0,42
08/30/16,1,27,542,360,131,8,8,2,18
08/30/16,2,2,738,315,99,13,10,7,30
08/30/16,2,3,996,300,112,10,7,12,29
08/30/16,2,4,999,300,71,34,8,6,48
08/30/16,2,5,8035,400,16,3,3,11,17
08/30/16,2,7,7331,345,117,34,6,3,43
08/30/16,2,8,783,350,148,9,5,2,16
08/30/16,2,9,7740,350,3,1,0,2,3
08/30/16,2,10,3062,380,161,13,6,2,21
08/30/16,2,11,7652,355,118,21,24,0,45
08/30/16,2,16,7687,350,53,2,9,4,15
08/30/16,2,17,641,370,143,10,6,1,17
08/30/16,2,18,542,350,8,15,7,4,26
08/30/16,2,20,7393,350,57,13,4,2,19
08/30/16,2,21,542,350,68,33,21,0,54
08/30/16,2,22,642,350,161,1,1,1,3
08/30/16,2,23,542,350,124,12,5,1,18
08/30/16,2,26,7748,360,42,17,2,0,19
08/30/16,2,27,542,360,115,10,10,1,21
08/30/16,3,1,726,305,76,8,22,5,35
08/30/16,3,2,738,315,112,13,10,7,30
08/30/16,3,3,996,300,20,4,2,1,7
08/30/16,3,4,999,300,11,4,4,1,9
08/30/16,3,5,8035,400,130,20,9,4,33
08/30/16,3,6,542,370,7,4,1,2,7
08/30/16,3,7,7331,345,133,26,9,3,38
08/30/16,3,8,783,350,129,18,9,3,30
08/30/16,3,10,3062,380,160,12,6,3,21
08/30/16,3,11,7652,355,124,22,15,1,38
08/30/16,3,17,641,370,117,14,8,8,30
08/30/16,3,18,542,350,19,60,12,21,93
08/30/16,3,20,7393,350,104,17,6,2,25
08/30/16,3,21,542,350,33,26,5,0,31
08/30/16,3,22,642,350,141,2,4,0,6
08/30/16,3,23,542,350,92,21,0,0,21
08/30/16,3,27,542,360,89,12,4,0,16
08/31/16,1,1,726,305,100,15,19,2,36
08/31/16,1,2,738,315,108,8,18,9,35
08/31/16,1,5,8035,400,135,12,4,6,22
08/31/16,1,6,542,370,146,21,8,5,34
08/31/16,1,7,7331,345,141,37,10,1,48
08/31/16,1,9,7740,350,28,10,5,0,15
08/31/16,1,10,3062,380,146,5,8,4,17
08/31/16,1,11,7652,355,114,24,16,0,40
08/31/16,1,14,8030,360,17,26,9,24,59
08/31/16,1,15,542,350,50,6,10,0,16
08/31/16,1,17,641,370,53,4,25,5,34
08/31/16,1,18,542,350,41,41,19,1,61
08/31/16,1,20,7393,350,118,20,2,3,25
08/31/16,1,21,542,350,36,39,3,0,42
08/31/16,1,22,642,350,135,15,9,0,24
08/31/16,1,23,542,350,75,19,3,3,25
08/31/16,1,24,7675,360,101,12,4,2,18
08/31/16,1,25,542,375,53,12,16,1,29
08/31/16,1,27,542,360,53,4,9,0,13
08/31/16,2,1,726,305,106,14,13,2,29
08/31/16,2,2,738,315,96,12,15,6,33
08/31/16,2,4,999,300,32,11,1,8,20
08/31/16,2,5,8035,400,132,21,12,0,33
08/31/16,2,6,542,370,139,36,3,1,40
08/31/16,2,7,7331,345,130,27,5,2,34
08/31/16,2,9,7740,350,25,12,0,0,12
08/31/16,2,10,3062,380,163,12,10,2,24
08/31/16,2,11,7652,355,110,19,22,0,41
08/31/16,2,15,542,350,34,13,14,0,27
08/31/16,2,17,641,370,102,5,17,2,24
08/31/16,2,18,542,350,51,46,11,1,58
08/31/16,2,19,542,360,20,11,1,0,12
08/31/16,2,20,7393,350,120,24,4,5,33
08/31/16,2,21,542,350,41,38,8,0,46
08/31/16,2,22,642,350,136,7,3,1,11
08/31/16,2,23,542,350,77,18,6,1,25
08/31/16,2,24,7675,360,11,1,3,0,4
08/31/16,2,25,542,375,56,8,23,0,31
08/31/16,2,27,542,360,7,0,2,0,2
08/31/16,3,1,726,305,87,8,20,4,32
08/31/16,3,2,738,315,105,12,11,0,23
08/31/16,3,4,999,300,70,40,9,16,65
08/31/16,3,5,8035,400,134,15,5,3,23
08/31/16,3,6,542,370,131,23,4,6,33
08/31/16,3,7,7331,345,132,27,7,2,36
08/31/16,3,10,3062,380,142,22,4,2,28
08/31/16,3,11,7652,355,107,20,16,4,40
08/31/16,3,15,542,350,22,13,8,0,21
08/31/16,3,17,641,370,138,20,2,0,22
08/31/16,3,18,542,350,67,58,19,0,77
08/31/16,3,19,542,360,90,29,5,0,34
08/31/16,3,20,7393,350,12,9,1,1,11
08/31/16,3,21,542,350,44,46,5,0,51
08/31/16,3,22,642,350,138,13,2,0,15
08/31/16,3,23,542,350,68,23,7,0,30
08/31/16,3,25,542,375,69,9,30,0,39
09/01/16,1,1,726,305,104,22,16,1,39
09/01/16,1,2,738,315,9,0,2,1,3
09/01/16,1,3,996,300,6,1,0,4,5
09/01/16,1,4,999,300,72,42,9,4,55
09/01/16,1,5,8035,400,142,9,4,0,13
09/01/16,1,6,542,370,104,16,5,7,28
09/01/16,1,7,7331,345,143,41,2,3,46
09/01/16,1,9,7740,350,32,30,12,0,42
09/01/16,1,10,3062,380,144,15,7,4,26
09/01/16,1,11,7652,355,103,49,13,1,63
09/01/16,1,14,8030,360,19,1,4,5,10
09/01/16,1,15,542,350,26,13,7,0,20
09/01/16,1,17,641,370,93,8,20,9,37
09/01/16,1,18,542,350,101,61,16,1,78
09/01/16,1,19,542,360,117,24,9,1,34
09/01/16,1,20,7393,350,21,10,7,8,25
09/01/16,1,21,542,350,62,57,11,0,68
09/01/16,1,22,642,350,145,6,4,2,12
09/01/16,1,25,542,375,94,3,43,1,47
09/01/16,1,26,747,360,8,13,10,0,23
09/01/16,1,28,1001,375,15,0,0,3,3
09/01/16,2,1,726,305,89,29,12,4,45
09/01/16,2,3,996,300,57,5,3,4,12
09/01/16,2,4,999,300,54,29,8,4,41
09/01/16,2,5,8035,400,139,15,4,2,21
09/01/16,2,7,7331,345,141,25,8,3,36
09/01/16,2,10,3062,380,150,17,14,2,33
09/01/16,2,11,7652,355,138,16,20,1,37
09/01/16,2,17,641,370,145,6,4,1,11
09/01/16,2,18,542,350,91,40,14,1,55
09/01/16,2,19,542,360,124,20,5,1,26
09/01/16,2,20,7393,350,50,9,4,5,18
09/01/16,2,21,542,350,45,36,12,0,48
09/01/16,2,22,642,350,145,7,2,1,10
09/01/16,2,24,7675,360,121,8,5,4,17
09/01/16,2,25,542,375,75,2,28,0,30
09/01/16,2,26,747,360,13,10,5,0,15
09/01/16,2,28,1001,375,110,21,1,5,27
09/01/16,3,1,726,305,101,16,20,2,38
09/01/16,3,3,996,300,107,25,4,0,29
09/01/16,3,5,8035,400,152,16,0,3,19
09/01/16,3,7,7331,345,121,18,7,3,28
09/01/16,3,10,3062,380,154,24,11,2,37
09/01/16,3,11,7652,355,105,33,23,3,59
09/01/16,3,17,641,370,111,9,2,1,12
09/01/16,3,18,542,350,56,15,14,2,31
09/01/16,3,19,542,360,48,3,23,0,26
09/01/16,3,20,7393,350,80,23,2,3,28
09/01/16,3,21,542,350,52,45,3,0,48
09/01/16,3,22,642,350,122,7,2,1,10
09/01/16,3,24,7675,360,75,11,4,0,15
09/01/16,3,25,542,375,69,6,17,1,24
09/01/16,3,26,747,360,17,13,5,0,18
09/01/16,3,28,1001,375,106,17,0,0,17
09/02/16,1,1,726,305,107,14,11,0,25
09/02/16,1,2,738,315,16,2,0,3,5
09/02/16,1,3,996,300,97,22,5,41,68
09/02/16,1,5,8035,400,156,11,6,0,17
09/02/16,1,7,7331,345,135,24,6,3,33
09/02/16,1,10,3062,380,155,25,11,3,39
09/02/16,1,11,7652,355,119,25,18,5,48
09/02/16,1,14,8030,360,64,3,8,7,18
09/02/16,1,16,8040,350,20,6,7,9,22
09/02/16,1,17,641,370,127,9,10,1,20
09/02/16,1,18,542,350,62,34,19,1,54
09/02/16,1,19,542,360,67,6,37,1,44
09/02/16,1,20,7747,350,97,32,5,15,52
09/02/16,1,21,542,350,39,42,10,0,52
09/02/16,1,22,642,350,68,3,10,1,14
09/02/16,1,24,7675,360,106,10,3,1,14
09/02/16,1,25,542,375,38,5,22,0,27
09/02/16,1,26,747,360,16,19,3,0,22
09/02/16,1,27,542,360,75,11,8,0,19
09/02/16,1,28,1001,375,120,23,7,2,32
09/02/16,2,1,726,305,109,10,16,3,29
09/02/16,2,2,738,315,110,18,14,15,47
09/02/16,2,5,8035,400,144,9,4,1,14
09/02/16,2,7,7331,345,135,17,9,1,27
09/02/16,2,10,3062,380,162,12,10,2,24
09/02/16,2,11,7652,355,111,33,20,0,53
09/02/16,2,16,8040,350,105,12,9,4,25
09/02/16,2,17,641,370,131,7,4,2,13
09/02/16,2,18,542,350,61,19,17,1,37
09/02/16,2,19,542,360,56,7,25,0,32
09/02/16,2,20,7747,350,126,24,2,4,30
09/02/16,2,21,542,350,22,26,3,0,29
09/02/16,2,24,7675,360,133,11,2,2,15
09/02/16,2,25,542,375,50,2,17,1,20
09/02/16,2,26,747,360,62,12,5,10,27
09/02/16,2,27,542,360,101,8,5,0,13
09/02/16,2,28,1001,375,124,28,1,2,31
09/02/16,3,1,726,305,111,11,14,1,26
09/02/16,3,2,738,315,32,5,2,0,7
09/02/16,3,5,8035,400,154,3,6,1,10
09/02/16,3,7,7331,345,33,4,4,2,10
09/02/16,3,11,7652,355,125,26,14,1,41
09/02/16,3,16,8040,350,107,17,17,4,38
09/02/16,3,17,641,370,83,4,16,1,21
09/02/16,3,18,542,350,40,79,19,5,103
09/02/16,3,19,542,360,22,1,11,0,12
09/02/16,3,20,7747,350,86,20,1,4,25
09/02/16,3,21,542,350,15,10,2,1,13
09/02/16,3,24,7675,360,91,8,0,1,9
09/02/16,3,25,542,375,64,10,18,0,28
09/02/16,3,26,747,360,66,24,2,1,27
09/02/16,3,27,542,360,42,0,4,0,4
09/02/16,3,28,1001,375,104,18,3,1,22
09/06/16,1,1,726,305,107,15,23,1,39
09/06/16,1,3,996,300,100,8,8,21,37
09/06/16,1,5,8035,400,151,6,4,0,10
09/06/16,1,11,7652,355,128,16,12,2,30
09/06/16,1,14,8030,360,118,0,1,0,1
09/06/16,1,16,8040,350,130,20,22,8,50
09/06/16,1,18,542,350,34,24,17,1,42
09/06/16,1,19,542,360,66,6,42,1,49
09/06/16,1,20,7747,350,80,17,3,5,25
09/06/16,1,21,542,350,24,21,6,0,27
09/06/16,1,23,542,350,9,3,2,2,7
09/06/16,1,24,7675,360,115,18,6,1,25
09/06/16,1,25,542,375,39,12,14,1,27
09/06/16,1,26,747,360,75,26,5,0,31
09/06/16,1,27,542,360,143,11,7,0,18
09/06/16,1,28,1001,375,134,22,2,0,24
09/06/16,2,1,726,305,117,5,14,1,20
09/06/16,2,3,996,300,111,31,5,12,48
09/06/16,2,5,8035,400,122,24,2,1,27
09/06/16,2,9,7740,350,2,10,1,10,21
09/06/16,2,11,7652,355,140,23,16,0,39
09/06/16,2,12,8040,350,22,10,5,7,22
09/06/16,2,14,8030,360,168,3,0,1,4
09/06/16,2,16,8040,350,142,12,22,3,37
09/06/16,2,18,542,350,55,5,36,1,42
09/06/16,2,19,542,360,60,5,36,1,42
09/06/16,2,21,542,350,38,25,9,0,34
09/06/16,2,23,542,350,82,16,4,10,30
09/06/16,2,24,7675,360,47,3,5,3,11
09/06/16,2,25,542,375,44,20,10,0,30
09/06/16,2,26,747,360,64,30,3,0,33
09/06/16,2,27,542,360,140,15,8,1,24
09/06/16,2,28,1001,375,67,16,0,3,19
09/06/16,3,1,726,305,92,8,21,2,31
09/06/16,3,3,996,300,38,87,3,22,112
09/06/16,3,5,8035,400,132,32,3,2,37
09/06/16,3,11,7652,355,103,18,9,0,27
09/06/16,3,12,8040,350,79,16,10,6,32
09/06/16,3,14,8030,360,170,0,0,1,1
09/06/16,3,16,8040,350,82,9,15,3,27
09/06/16,3,17,641,370,23,49,7,3,59
09/06/16,3,18,542,350,54,34,11,1,46
09/06/16,3,19,542,360,63,3,32,0,35
09/06/16,3,21,542,350,20,24,4,0,28
09/06/16,3,23,542,350,26,26,1,0,27
09/06/16,3,25,542,375,88,9,21,0,30
09/06/16,3,26,747,360,50,36,0,0,36
09/06/16,3,27,542,360,147,10,0,0,10
09/07/16,1,1,726,305,116,7,18,2,27
09/07/16,1,5,8035,400,18,2,2,4,8
09/07/16,1,11,7652,355,120,33,23,1,57
09/07/16,1,12,8040,350,142,35,11,3,49
09/07/16,1,13,8038,400,16,0,2,10,12
09/07/16,1,14,8030,360,126,2,7,4,13
09/07/16,1,16,8040,350,148,15,19,6,40
09/07/16,1,17,641,370,98,29,6,2,37
09/07/16,1,18,542,350,34,57,13,1,71
09/07/16,1,19,542,360,68,10,32,0,42
09/07/16,1,20,7747,350,28,8,3,1,12
09/07/16,1,21,542,350,37,39,2,0,41
09/07/16,1,23,542,350,93,36,9,0,45
09/07/16,1,24,7675,360,35,4,4,2,10
09/07/16,1,25,542,375,87,6,19,1,26
09/07/16,1,26,747,360,135,18,6,0,24
09/07/16,1,27,542,360,155,9,6,0,15
09/07/16,2,1,726,305,94,9,20,9,38
09/07/16,2,3,996,300,10,12,2,0,14
09/07/16,2,11,7652,355,15,0,7,1,8
09/07/16,2,12,8040,350,130,28,5,2,35
09/07/16,2,13,8038,400,153,5,0,1,6
09/07/16,2,14,8030,360,160,0,3,1,4
09/07/16,2,16,8040,350,106,28,9,3,40
09/07/16,2,17,641,370,96,13,9,4,26
09/07/16,2,18,542,350,48,15,20,1,36
09/07/16,2,19,542,360,73,8,25,0,33
09/07/16,2,20,7747,350,100,13,6,5,24
09/07/16,2,21,542,350,35,35,6,0,41
09/07/16,2,23,542,350,89,28,9,1,38
09/07/16,2,24,7675,360,88,19,3,3,25
09/07/16,2,25,542,375,75,6,31,2,39
09/07/16,2,26,747,360,134,8,5,1,14
09/07/16,2,27,542,360,148,7,4,0,11
09/07/16,3,1,726,305,102,15,18,0,33
09/07/16,3,3,996,300,59,87,8,0,95
09/07/16,3,12,8040,350,125,22,6,7,35
09/07/16,3,13,8038,400,143,6,1,6,13
09/07/16,3,14,8030,360,168,0,3,1,4
09/07/16,3,16,8040,350,95,39,20,3,62
09/07/16,3,17,641,370,61,39,0,0,39
09/07/16,3,18,542,350,39,20,15,1,36
09/07/16,3,19,542,360,41,5,16,0,21
09/07/16,3,20,7747,350,106,25,7,2,34
09/07/16,3,21,542,350,24,20,4,0,24
09/07/16,3,23,542,350,78,21,6,0,27
09/07/16,3,24,7675,360,76,16,1,0,17
09/07/16,3,25,542,375,48,4,22,0,26
09/07/16,3,26,747,360,11,2,8,0,10
09/07/16,3,27,542,360,150,4,4,0,8
09/07/16,3,28,1001,375,5,2,8,13,23
09/08/16,1,1,726,305,105,15,25,4,44
09/08/16,1,3,996,300,95,19,14,9,42
09/08/16,1,6,542,370,25,8,11,3,22
09/08/16,1,9,7740,350,33,28,10,4,42
09/08/16,1,12,8040,350,115,33,14,3,50
09/08/16,1,13,8038,400,137,5,10,1,16
09/08/16,1,14,8030,360,164,0,1,1,2
09/08/16,1,16,8040,350,125,33,14,2,49
09/08/16,1,17,641,370,152,11,2,2,15
09/08/16,1,18,542,350,74,27,32,0,59
09/08/16,1,19,542,360,98,14,15,1,30
09/08/16,1,20,7747,350,122,26,4,5,35
09/08/16,1,21,542,350,42,39,12,0,51
09/08/16,1,23,542,350,109,24,12,0,36
09/08/16,1,24,7675,360,129,22,5,1,28
09/08/16,1,25,542,375,50,9,30,0,39
09/08/16,1,26,747,360,154,4,3,0,7
09/08/16,1,27,542,360,149,10,7,0,17
09/08/16,1,28,1001,375,102,21,5,3,29
09/08/16,2,1,726,305,114,2,16,3,21
09/08/16,2,3,996,300,75,6,4,4,14
09/08/16,2,6,542,370,93,18,43,1,62
09/08/16,2,11,7652,355,46,20,10,7,37
09/08/16,2,12,8040,350,144,24,5,2,31
09/08/16,2,13,8038,400,122,6,28,0,34
09/08/16,2,14,8030,360,163,3,2,1,6
09/08/16,2,16,8040,350,130,36,14,4,54
09/08/16,2,17,641,370,119,11,9,3,23
09/08/16,2,18,542,350,69,43,10,1,54
09/08/16,2,19,542,360,96,6,15,1,22
09/08/16,2,20,7747,350,111,26,9,6,41
09/08/16,2,23,542,350,82,19,10,0,29
09/08/16,2,24,7675,360,119,17,5,5,27
09/08/16,2,25,542,375,43,17,5,5,27
09/08/16,2,26,747,360,120,7,20,1,28
09/08/16,2,27,542,360,132,15,2,0,17
09/08/16,2,28,1001,375,118,29,2,1,32
09/08/16,3,1,726,305,94,12,14,1,27
09/08/16,3,2,738,315,21,1,2,3,6
09/08/16,3,3,996,300,53,3,4,3,10
09/08/16,3,6,542,370,115,18,56,3,77
09/08/16,3,11,7652,355,109,50,19,0,69
09/08/16,3,12,8040,350,142,12,9,2,23
09/08/16,3,13,8038,400,156,2,7,1,10
09/08/16,3,14,8030,360,170,2,0,0,2
09/08/16,3,15,495,350,14,1,7,0,8
09/08/16,3,16,8040,350,79,18,9,1,28
09/08/16,3,17,641,370,92,14,8,1,23
09/08/16,3,18,542,350,57,22,9,1,32
09/08/16,3,19,542,360,86,12,8,0,20
09/08/16,3,20,7747,350,52,10,2,5,17
09/08/16,3,22,642,350,34,3,2,0,5
09/08/16,3,23,542,350,50,17,5,0,22
09/08/16,3,24,7675,360,93,19,4,0,23
09/08/16,3,25,542,375,46,7,18,0,25
09/08/16,3,26,747,360,99,4,6,0,10
09/08/16,3,27,542,360,143,12,2,0,14
09/08/16,3,28,1001,375,96,6,4,2,12
09/09/16,1,1,726,305,113,6,15,1,22
09/09/16,1,2,738,315,108,7,12,4,23
09/09/16,1,3,996,300,112,1,8,9,18
09/09/16,1,6,542,370,113,7,29,5,41
09/09/16,1,9,7740,350,18,11,0,0,11
09/09/16,1,10,774,380,90,22,14,9,45
09/09/16,1,11,7652,355,127,17,23,5,45
09/09/16,1,12,8040,350,134,20,16,3,39
09/09/16,1,13,8038,400,162,2,0,2,4
09/09/16,1,14,8030,360,159,12,2,2,16
09/09/16,1,15,495,350,74,9,20,2,31
09/09/16,1,16,8040,350,116,45,15,2,62
09/09/16,1,17,641,370,129,11,6,2,19
09/09/16,1,18,542,350,71,34,18,3,55
09/09/16,1,19,542,360,122,13,7,1,21
09/09/16,1,21,542,350,52,12,7,0,19
09/09/16,1,22,642,350,80,8,15,1,24
09/09/16,1,23,542,350,95,25,14,0,39
09/09/16,1,24,7675,360,126,17,3,1,21
09/09/16,1,25,542,375,66,8,20,1,29
09/09/16,1,26,747,360,167,8,2,0,10
09/09/16,1,27,542,360,149,15,11,0,26
09/09/16,1,28,1001,375,109,25,15,2,42
09/09/16,2,1,726,305,92,8,13,2,23
09/09/16,2,2,738,315,96,9,13,3,25
09/09/16,2,3,996,300,116,6,4,10,20
09/09/16,2,6,542,370,90,14,40,2,56
09/09/16,2,7,7724,345,32,1,2,5,8
09/09/16,2,9,7740,350,34,13,5,5,23
09/09/16,2,10,774,380,127,13,19,4,36
09/09/16,2,11,7652,355,80,30,16,2,48
09/09/16,2,12,8040,350,80,39,9,1,49
09/09/16,2,13,8038,400,148,4,2,0,6
09/09/16,2,14,8030,360,148,5,4,1,10
09/09/16,2,15,495,350,71,2,12,0,14
09/09/16,2,16,8040,350,85,28,14,2,44
09/09/16,2,17,641,370,138,17,3,1,21
09/09/16,2,18,542,350,43,31,13,1,45
09/09/16,2,19,542,360,128,12,6,0,18
09/09/16,2,21,542,350,54,14,8,0,22
09/09/16,2,22,642,350,78,7,16,0,23
09/09/16,2,23,542,350,88,20,7,0,27
09/09/16,2,24,7675,360,136,16,2,2,20
09/09/16,2,25,542,375,42,3,18,0,21
09/09/16,2,26,747,360,149,4,3,1,8
09/09/16,2,27,542,360,134,8,2,0,10
09/09/16,2,28,1001,375,96,14,6,5,25
09/09/16,3,1,726,305,105,3,17,1,21
09/09/16,3,5,8035,400,67,20,6,10,36
09/09/16,3,6,542,370,116,25,41,1,67
09/09/16,3,7,7724,345,137,2,11,8,21
09/09/16,3,10,774,380,144,28,18,6,52
09/09/16,3,11,7652,355,113,42,18,3,63
09/09/16,3,12,8040,350,100,64,6,5,75
09/09/16,3,13,8038,400,157,1,2,0,3
09/09/16,3,14,8030,360,161,4,4,2,10
09/09/16,3,15,495,140,80,8,5,0,13
09/09/16,3,16,8040,350,68,16,10,1,27
09/09/16,3,17,641,370,87,16,3,0,19
09/09/16,3,18,542,350,41,20,13,2,35
09/09/16,3,19,542,360,52,1,5,0,6
09/09/16,3,21,542,350,47,15,9,0,24
09/09/16,3,22,642,350,62,7,20,0,27
09/09/16,3,23,542,350,77,21,6,0,27
09/09/16,3,24,7675,360,83,21,0,0,21
09/09/16,3,25,542,375,50,0,17,0,17
09/09/16,3,26,747,17,132,4,17,0,21
09/09/16,3,27,542,360,113,6,7,0,13
09/12/16,1,1,726,305,102,19,16,1,36
09/12/16,1,3,996,300,25,1,1,5,7
09/12/16,1,5,8035,400,128,4,5,5,14
09/12/16,1,6,542,370,104,17,48,2,67
09/12/16,1,7,7724,345,145,6,8,2,16
09/12/16,1,10,774,380,125,34,22,4,60
09/12/16,1,11,7652,355,125,16,19,1,36
09/12/16,1,12,8040,350,88,65,7,1,73
09/12/16,1,13,8038,400,134,5,3,15,23
09/12/16,1,14,8030,360,164,0,1,1,2
09/12/16,1,15,495,350,107,7,10,1,18
09/12/16,1,16,8040,350,104,37,8,3,48
09/12/16,1,17,641,370,126,14,2,4,20
09/12/16,1,18,542,350,89,44,24,2,70
09/12/16,1,19,542,360,115,45,4,1,50
09/12/16,1,21,542,350,75,7,22,0,29
09/12/16,1,22,642,350,116,11,0,1,12
09/12/16,1,23,542,350,110,37,10,0,47
09/12/16,1,24,7675,360,101,19,4,2,25
09/12/16,1,25,542,375,83,3,22,0,25
09/12/16,1,26,747,360,140,5,6,0,11
09/12/16,1,27,542,360,148,11,4,0,15
09/12/16,2,1,726,305,87,14,16,3,33
09/12/16,2,3,996,300,102,8,7,8,23
09/12/16,2,5,8035,400,113,21,6,1,28
09/12/16,2,6,542,370,98,20,27,1,48
09/12/16,2,7,7724,345,147,1,2,1,4
09/12/16,2,10,774,380,135,19,10,2,31
09/12/16,2,11,7652,355,89,35,11,2,48
09/12/16,2,12,8040,350,81,51,5,2,58
09/12/16,2,13,8038,400,161,3,0,1,4
09/12/16,2,14,8030,360,166,0,3,1,4
09/12/16,2,15,495,350,107,5,12,0,17
09/12/16,2,16,8040,350,104,15,16,2,33
09/12/16,2,17,641,370,135,9,6,3,18
09/12/16,2,18,542,350,70,33,13,1,47
09/12/16,2,19,542,360,45,6,5,0,11
09/12/16,2,21,542,350,66,9,18,0,27
09/12/16,2,22,642,350,135,7,5,0,12
09/12/16,2,23,542,350,98,28,5,1,34
09/12/16,2,24,7675,360,54,3,5,3,11
09/12/16,2,25,542,375,51,8,16,1,25
09/12/16,2,26,747,360,145,4,2,1,7
09/12/16,2,27,542,360,108,10,6,0,16
09/12/16,2,28,1001,375,48,16,3,12,31
09/12/16,3,1,726,305,61,6,15,0,21
09/12/16,3,5,8035,400,154,7,5,0,12
09/12/16,3,6,542,370,113,32,42,1,75
09/12/16,3,7,7724,345,157,4,1,2,7
09/12/16,3,10,774,380,148,42,6,3,51
09/12/16,3,11,7652,355,99,83,4,1,88
09/12/16,3,12,8040,350,52,8,7,1,16
09/12/16,3,13,8038,400,157,3,0,2,5
09/12/16,3,14,8030,360,167,0,4,0,4
09/12/16,3,15,495,350,70,4,16,0,20
09/12/16,3,16,8040,350,85,16,8,3,27
09/12/16,3,17,641,370,124,6,3,0,9
09/12/16,3,18,542,350,60,30,8,0,38
09/12/16,3,21,542,350,59,7,17,0,24
09/12/16,3,22,642,350,85,13,4,0,17
09/12/16,3,23,542,350,71,25,4,0,29
09/12/16,3,25,542,375,49,4,19,0,23
09/12/16,3,26,747,360,106,2,8,0,10
09/12/16,3,27,542,360,144,2,5,0,7
09/12/16,3,28,1001,375,81,24,3,0,27
09/13/16,1,3,996,300,107,6,8,17,31
09/13/16,1,5,8035,400,151,2,4,2,8
09/13/16,1,6,542,370,105,38,6,3,47
09/13/16,1,7,7724,345,150,2,6,3,11
09/13/16,1,10,774,380,137,40,12,2,54
09/13/16,1,11,7652,355,124,40,13,1,54
09/13/16,1,14,8030,360,136,2,11,3,16
09/13/16,1,15,495,350,115,7,16,0,23
09/13/16,1,16,8040,350,117,32,10,2,44
09/13/16,1,17,641,370,125,12,10,5,27
09/13/16,1,18,542,350,115,50,17,1,68
09/13/16,1,19,542,360,6,3,3,0,6
09/13/16,1,22,642,350,130,12,9,0,21
09/13/16,1,23,542,350,126,24,11,0,35
09/13/16,1,24,7675,360,48,9,4,5,18
09/13/16,1,25,542,375,73,10,27,1,38
09/13/16,1,26,747,360,135,2,10,1,13
09/13/16,1,27,542,360,141,7,3,0,10
09/13/16,1,28,1001,375,122,29,9,4,42
09/13/16,2,3,996,300,69,5,4,20,29
09/13/16,2,5,8035,400,164,1,3,1,5
09/13/16,2,6,542,370,119,16,38,1,55
09/13/16,2,7,7724,345,162,1,1,1,3
09/13/16,2,9,485,350,4,0,18,8,26
09/13/16,2,10,774,380,144,18,12,2,32
09/13/16,2,11,7652,355,103,30,14,0,44
09/13/16,2,12,8040,350,89,21,2,6,29
09/13/16,2,14,8030,360,167,3,2,0,5
09/13/16,2,15,495,350,94,4,17,1,22
09/13/16,2,16,8040,350,42,9,5,2,16
09/13/16,2,17,641,370,146,6,2,3,11
09/13/16,2,18,542,350,73,36,12,1,49
09/13/16,2,19,542,360,116,27,8,1,36
09/13/16,2,22,642,350,118,6,8,1,15
09/13/16,2,23,542,350,122,15,11,0,26
09/13/16,2,24,7675,360,110,15,14,1,30
09/13/16,2,25,542,375,50,4,16,0,20
09/13/16,2,26,747,360,123,3,3,1,7
09/13/16,2,27,542,360,126,16,6,0,22
09/13/16,2,28,1001,375,102,33,11,3,47
09/13/16,3,5,8035,400,142,3,4,0,7
09/13/16,3,6,542,370,93,29,29,4,62
09/13/16,3,7,7724,345,149,1,1,1,3
09/13/16,3,9,485,350,93,27,13,7,47
09/13/16,3,10,774,380,147,17,14,2,33
09/13/16,3,11,7652,355,99,18,42,2,62
09/13/16,3,12,8040,350,115,34,7,1,42
09/13/16,3,14,8030,360,64,2,2,2,6
09/13/16,3,15,495,350,127,4,15,0,19
09/13/16,3,17,641,370,107,8,6,3,17
09/13/16,3,18,542,350,44,10,12,0,22
09/13/16,3,19,542,360,76,20,4,0,24
09/13/16,3,22,642,350,129,11,3,0,14
09/13/16,3,23,542,350,75,23,3,0,26
09/13/16,3,24,7675,360,74,17,3,0,20
09/13/16,3,26,747,360,139,6,3,0,9
09/13/16,3,27,542,360,137,7,2,0,9
09/13/16,3,28,1001,375,60,20,5,2,27
09/14/16,1,3,996,300,60,2,7,8,17
09/14/16,1,5,8035,400,148,4,5,8,17
09/14/16,1,6,542,370,105,32,36,1,69
09/14/16,1,7,7724,345,148,9,3,1,13
09/14/16,1,9,7740,350,135,16,4,11,31
09/14/16,1,10,774,380,146,35,11,2,48
09/14/16,1,11,7652,355,99,37,19,3,59
09/14/16,1,12,8040,350,137,34,3,3,40
09/14/16,1,13,7601,400,18,5,6,8,19
09/14/16,1,14,8030,360,65,0,3,6,9
09/14/16,1,15,495,350,130,5,18,1,24
09/14/16,1,16,8040,350,60,12,6,2,20
09/14/16,1,17,641,370,151,8,6,4,18
09/14/16,1,19,542,360,99,76,2,0,78
09/14/16,1,21,542,350,140,18,4,1,23
09/14/16,1,22,642,350,145,10,1,0,11
09/14/16,1,23,542,350,117,26,7,0,33
09/14/16,1,24,7675,360,129,29,6,1,36
09/14/16,1,26,747,360,162,9,5,1,15
09/14/16,1,27,542,360,145,9,5,0,14
09/14/16,1,28,1001,375,105,33,8,4,45
09/14/16,2,3,996,300,110,7,5,12,24
09/14/16,2,5,8035,400,164,0,2,1,3
09/14/16,2,6,542,370,104,9,39,1,49
09/14/16,2,7,7724,345,160,4,3,2,9
09/14/16,2,9,7740,350,159,10,1,4,15
09/14/16,2,10,774,380,135,16,16,3,35
09/14/16,2,11,7652,355,112,25,16,1,42
09/14/16,2,12,8040,350,125,33,6,1,40
09/14/16,2,13,7601,400,128,9,5,1,15
09/14/16,2,14,8030,360,159,0,4,0,4
09/14/16,2,15,495,350,102,5,14,0,19
09/14/16,2,16,8040,350,134,17,10,3,30
09/14/16,2,17,641,370,111,4,11,1,16
09/14/16,2,18,542,350,80,6,9,5,20
09/14/16,2,19,542,360,74,75,0,0,75
09/14/16,2,21,542,350,121,20,7,0,27
09/14/16,2,22,642,350,145,8,0,1,9
09/14/16,2,23,542,350,87,12,6,0,18
09/14/16,2,24,7675,360,121,32,5,3,40
09/14/16,2,25,542,375,15,7,5,0,12
09/14/16,2,26,747,360,75,8,1,0,9
09/14/16,2,27,542,360,145,9,3,0,12
09/14/16,2,28,1001,375,11,0,1,1,2
09/14/16,3,5,8035,400,155,1,5,2,8
09/14/16,3,6,542,370,123,23,34,1,58
09/14/16,3,7,7724,345,159,2,1,1,4
09/14/16,3,9,7740,350,151,12,6,4,22
09/14/16,3,10,774,380,16,5,12,0,17
09/14/16,3,11,7652,355,123,25,20,2,47
09/14/16,3,12,8040,350,119,28,9,1,38
09/14/16,3,13,7601,400,145,8,4,3,15
09/14/16,3,14,8030,360,168,1,2,2,5
09/14/16,3,15,495,350,88,4,16,0,20
09/14/16,3,16,8040,350,91,25,6,1,32
09/14/16,3,17,641,370,119,10,13,2,25
09/14/16,3,18,542,350,130,12,0,4,16
09/14/16,3,19,542,360,49,51,1,0,52
09/14/16,3,21,542,350,111,15,7,0,22
09/14/16,3,22,642,350,130,7,5,0,12
09/14/16,3,24,7675,360,79,30,4,1,35
09/14/16,3,25,542,375,69,19,11,0,30
09/14/16,3,27,542,360,128,13,3,0,16
09/15/16,1,3,996,300,49,1,7,12,20
09/15/16,1,5,8035,400,153,4,4,1,9
09/15/16,1,6,542,370,78,6,34,5,45
09/15/16,1,7,7724,345,161,2,2,0,4
09/15/16,1,9,7740,350,155,5,11,3,19
09/15/16,1,11,7652,355,126,22,24,0,46
09/15/16,1,12,8040,350,146,31,6,3,40
09/15/16,1,13,7601,400,154,4,6,2,12
09/15/16,1,14,8030,360,153,2,4,6,12
09/15/16,1,15,495,350,149,4,12,0,16
09/15/16,1,16,8040,350,149,21,7,4,32
09/15/16,1,17,641,370,155,8,4,2,14
09/15/16,1,18,542,350,120,28,11,3,42
09/15/16,1,19,542,360,96,53,3,0,56
09/15/16,1,21,542,350,141,21,7,0,28
09/15/16,1,22,642,350,156,8,2,0,10
09/15/16,1,24,7675,360,96,21,7,4,32
09/15/16,1,25,542,375,126,19,4,1,24
09/15/16,1,27,542,360,162,8,1,0,9
09/15/16,1,28,1001,375,26,2,5,7,14
09/15/16,2,3,996,300,117,13,4,0,17
09/15/16,2,5,8035,400,155,3,3,2,8
09/15/16,2,7,7724,345,156,7,1,1,9
09/15/16,2,9,7740,350,148,7,4,1,12
09/15/16,2,11,7652,355,139,14,22,0,36
09/15/16,2,12,8040,350,148,17,5,2,24
09/15/16,2,13,7601,400,138,5,3,1,9
09/15/16,2,14,8030,360,166,2,1,2,5
09/15/16,2,15,495,350,138,6,12,1,19
09/15/16,2,16,8040,350,139,6,19,1,26
09/15/16,2,17,641,370,120,7,10,2,19
09/15/16,2,18,542,350,118,17,10,2,29
09/15/16,2,19,542,360,94,51,2,1,54
09/15/16,2,20,8032,350,3,3,4,3,10
09/15/16,2,21,542,350,122,15,9,0,24
09/15/16,2,22,642,350,119,2,4,1,7
09/15/16,2,24,7675,360,30,3,6,2,11
09/15/16,2,25,542,375,96,14,12,1,27
09/15/16,2,27,542,360,94,7,6,0,13
09/15/16,2,28,1001,375,100,32,12,5,49
09/15/16,3,3,996,300,128,11,4,9,24
09/15/16,3,5,8035,400,163,3,3,0,6
09/15/16,3,7,7724,345,156,1,2,2,5
09/15/16,3,9,7740,350,159,2,2,7,11
09/15/16,3,11,7652,355,133,20,21,0,41
09/15/16,3,12,8040,350,140,17,7,2,26
09/15/16,3,13,7601,400,141,8,8,2,18
09/15/16,3,14,8030,360,169,0,1,0,1
09/15/16,3,15,495,350,100,2,17,0,19
09/15/16,3,16,8040,350,86,20,8,1,29
09/15/16,3,17,641,370,85,10,10,3,23
09/15/16,3,18,542,350,117,12,4,3,19
09/15/16,3,19,542,360,32,42,1,0,43
09/15/16,3,20,8032,350,63,6,29,4,39
09/15/16,3,21,542,350,85,19,9,0,28
09/15/16,3,24,7675,360,12,2,8,2,12
09/15/16,3,25,542,375,108,12,5,0,17
09/15/16,3,28,1001,375,65,16,8,3,27
09/16/16,1,2,972,315,65,6,15,10,31
09/16/16,1,3,996,300,124,4,7,25,36
09/16/16,1,6,542,370,78,6,34,5,45
09/16/16,1,7,7724,345,153,2,3,1,6
09/16/16,1,9,7740,350,167,4,2,4,10
09/16/16,1,10,774,380,38,5,13,7,25
09/16/16,1,11,7652,355,113,41,17,3,61
09/16/16,1,12,8040,350,145,28,5,1,34
09/16/16,1,13,7601,400,131,12,6,1,19
09/16/16,1,14,8030,360,165,0,3,4,7
09/16/16,1,15,495,350,141,5,15,1,21
09/16/16,1,16,8040,350,153,22,6,5,33
09/16/16,1,17,641,370,105,13,14,1,28
09/16/16,1,18,542,350,146,25,3,3,31
09/16/16,1,19,542,360,120,36,4,1,41
09/16/16,1,20,8032,350,72,6,64,3,73
09/16/16,1,21,542,350,65,10,4,1,15
09/16/16,1,24,7675,360,114,24,5,6,35
09/16/16,1,25,542,375,118,13,11,1,25
09/16/16,1,26,747,360,33,24,4,0,28
09/16/16,1,28,1001,375,104,22,12,5,39
09/16/16,2,2,972,315,96,10,5,2,17
09/16/16,2,3,996,300,29,7,5,3,15
09/16/16,2,6,542,370,68,22,23,0,45
09/16/16,2,7,7724,345,143,4,3,2,9
09/16/16,2,9,7740,350,142,1,15,2,18
09/16/16,2,10,774,380,126,18,8,1,27
09/16/16,2,11,7652,355,112,21,15,1,37
09/16/16,2,12,8040,350,111,39,5,2,46
09/16/16,2,13,7601,400,147,5,2,1,8
09/16/16,2,14,8030,360,161,3,2,0,5
09/16/16,2,15,495,350,115,4,8,1,13
09/16/16,2,16,8040,350,113,19,9,5,33
09/16/16,2,17,641,370,114,16,5,1,22
09/16/16,2,18,542,350,97,26,6,1,33
09/16/16,2,19,542,360,82,14,2,1,17
09/16/16,2,20,8032,350,63,20,31,1,52
09/16/16,2,21,542,350,100,11,7,0,18
09/16/16,2,24,7675,360,111,21,5,9,35
09/16/16,2,25,542,375,119,13,3,1,17
09/16/16,2,26,747,360,94,12,5,0,17
09/16/16,2,28,1001,375,96,28,2,5,35
09/16/16,3,2,972,315,111,17,6,2,25
09/16/16,3,7,7724,345,157,3,0,4,7
09/16/16,3,9,7740,350,158,11,3,4,18
09/16/16,3,10,774,380,150,33,11,4,48
09/16/16,3,11,7652,355,105,29,25,2,56
09/16/16,3,12,8040,350,48,17,3,0,20
09/16/16,3,13,7601,400,148,8,3,2,13
09/16/16,3,14,8030,360,168,0,1,3,4
09/16/16,3,15,495,140,67,1,21,0,22
09/16/16,3,16,8040,350,113,11,8,3,22
09/16/16,3,17,641,370,85,11,7,1,19
09/16/16,3,18,542,350,86,21,3,1,25
09/16/16,3,19,542,360,45,17,3,0,20
09/16/16,3,20,8032,350,40,4,4,2,10
09/16/16,3,21,542,350,88,11,6,0,17
09/16/16,3,24,7675,360,82,14,1,2,17
09/16/16,3,25,542,375,77,14,5,0,19
09/16/16,3,26,747,17,46,26,1,0,27
09/16/16,3,28,1001,375,55,19,5,3,27
09/19/16,1,2,972,315,117,13,3,5,21
09/19/16,1,3,996,300,21,5,2,7,14
09/19/16,1,7,7724,345,153,1,4,2,7
09/19/16,1,8,785,350,44,0,8,0,8
09/19/16,1,9,485,350,138,3,12,2,17
09/19/16,1,10,774,380,144,30,8,2,40
09/19/16,1,11,7652,355,92,66,12,2,80
09/19/16,1,13,7601,400,136,15,6,1,22
09/19/16,1,14,8030,360,162,1,3,0,4
09/19/16,1,15,495,350,90,4,17,0,21
09/19/16,1,16,8040,350,134,31,8,3,42
09/19/16,1,18,542,350,50,13,2,2,17
09/19/16,1,19,542,360,68,50,13,1,64
09/19/16,1,20,8032,350,73,9,57,3,69
09/19/16,1,21,542,350,101,5,9,0,14
09/19/16,1,24,7675,360,94,23,3,4,30
09/19/16,1,25,542,375,141,9,4,2,15
09/19/16,1,26,775,360,88,34,4,1,39
09/19/16,1,28,1001,375,66,30,11,4,45
09/19/16,2,1,726,305,26,1,8,1,10
09/19/16,2,2,972,315,121,6,3,2,11
09/19/16,2,3,996,300,96,20,10,6,36
09/19/16,2,7,7724,345,154,0,2,1,3
09/19/16,2,8,785,350,138,7,5,3,15
09/19/16,2,9,485,350,163,3,4,2,9
09/19/16,2,10,774,380,149,28,11,3,42
09/19/16,2,11,7652,355,100,31,21,1,53
09/19/16,2,13,7601,400,148,5,1,2,8
09/19/16,2,14,8030,360,166,1,3,1,5
09/19/16,2,15,495,350,91,1,24,1,26
09/19/16,2,16,8040,350,142,11,8,5,24
09/19/16,2,19,542,360,110,26,10,0,36
09/19/16,2,20,8032,350,76,15,42,2,59
09/19/16,2,21,542,350,119,19,8,0,27
09/19/16,2,24,7675,360,125,24,3,3,30
09/19/16,2,25,542,375,131,18,2,1,21
09/19/16,2,26,775,360,96,33,4,0,37
09/19/16,2,28,1001,375,10,6,7,2,15
09/19/16,3,1,726,305,104,19,18,2,39
09/19/16,3,2,972,315,116,12,5,2,19
09/19/16,3,3,996,300,101,14,14,10,38
09/19/16,3,7,7724,345,156,2,3,2,7
09/19/16,3,8,785,350,151,1,7,2,10
09/19/16,3,9,485,350,50,1,3,1,5
09/19/16,3,10,774,380,142,30,9,1,40
09/19/16,3,11,7652,355,57,18,7,3,28
09/19/16,3,13,7601,400,143,11,1,2,14
09/19/16,3,14,8030,360,168,1,3,0,4
09/19/16,3,15,495,350,112,2,15,0,17
09/19/16,3,16,8040,350,132,8,10,1,19
09/19/16,3,19,542,360,89,12,12,1,25
09/19/16,3,20,8032,350,66,6,38,2,46
09/19/16,3,21,542,350,107,15,3,0,18
09/19/16,3,24,7675,360,107,19,1,5,25
09/19/16,3,25,542,375,115,16,4,1,21
09/19/16,3,26,775,360,64,23,2,1,26
09/20/16,1,1,726,305,104,12,19,2,33
09/20/16,1,2,972,315,111,10,9,2,21
09/20/16,1,3,996,300,107,16,9,9,34
09/20/16,1,7,7724,345,162,0,3,1,4
09/20/16,1,8,785,350,138,4,1,7,12
09/20/16,1,10,774,380,126,8,13,8,29
09/20/16,1,11,7652,355,83,13,16,1,30
09/20/16,1,13,7601,400,142,14,2,2,18
09/20/16,1,14,8030,360,169,1,1,1,3
09/20/16,1,15,495,350,110,2,21,1,24
09/20/16,1,16,8040,350,137,15,16,2,33
09/20/16,1,18,542,350,64,8,6,2,16
09/20/16,1,19,542,360,110,21,6,1,28
09/20/16,1,20,8032,350,85,31,38,3,72
09/20/16,1,21,542,350,127,18,4,0,22
09/20/16,1,22,785,350,44,1,17,0,18
09/20/16,1,24,7751,360,83,20,5,3,28
09/20/16,1,25,542,375,111,9,5,1,15
09/20/16,1,26,775,360,96,46,2,1,49
09/20/16,1,28,1001,375,87,39,5,5,49
09/20/16,2,1,726,305,113,8,7,2,17
09/20/16,2,2,972,315,109,11,4,1,16
09/20/16,2,3,996,300,102,26,4,5,35
09/20/16,2,7,7724,345,160,0,4,1,5
09/20/16,2,8,785,350,151,2,3,0,5
09/20/16,2,10,774,380,110,21,18,4,43
09/20/16,2,11,7652,355,102,35,13,0,48
09/20/16,2,13,7601,400,134,13,5,2,20
09/20/16,2,14,8030,360,168,3,3,0,6
09/20/16,2,15,495,350,103,0,21,0,21
09/20/16,2,16,8040,350,121,22,17,2,41
09/20/16,2,18,542,350,94,28,5,2,35
09/20/16,2,19,542,360,118,15,5,1,21
09/20/16,2,20,8032,350,66,26,34,3,63
09/20/16,2,21,542,350,115,18,4,0,22
09/20/16,2,22,785,350,102,2,12,1,15
09/20/16,2,24,7751,360,111,21,4,6,31
09/20/16,2,25,542,375,121,15,4,1,20
09/20/16,2,26,775,360,75,15,10,0,25
09/20/16,2,27,542,360,70,19,8,0,27
09/20/16,2,28,1001,375,73,43,3,8,54
09/20/16,3,1,726,305,102,12,10,1,23
09/20/16,3,2,972,315,110,10,6,2,18
09/20/16,3,3,996,300,12,3,1,4,8
09/20/16,3,7,7724,345,22,0,13,3,16
09/20/16,3,8,785,350,145,0,2,2,4
09/20/16,3,10,774,380,133,27,16,1,44
09/20/16,3,11,7652,355,103,23,29,3,55
09/20/16,3,13,7601,400,143,11,2,2,15
09/20/16,3,14,8030,360,160,0,3,2,5
09/20/16,3,15,495,350,57,2,21,0,23
09/20/16,3,16,8040,350,109,13,9,2,24
09/20/16,3,18,542,350,108,25,3,1,29
09/20/16,3,19,542,360,100,16,5,0,21
09/20/16,3,20,8032,350,46,15,32,4,51
09/20/16,3,21,542,350,80,14,0,0,14
09/20/16,3,22,785,350,21,22,5,0,27
09/20/16,3,24,7751,360,76,18,3,2,23
09/20/16,3,25,542,375,101,8,5,0,13
09/20/16,3,26,775,360,92,18,4,0,22
09/20/16,3,27,542,360,49,13,11,0,24
09/20/16,3,28,1001,375,48,24,3,5,32
09/21/16,1,1,726,305,102,27,12,3,42
09/21/16,1,2,972,315,118,14,6,1,21
09/21/16,1,3,996,300,83,27,11,6,44
09/21/16,1,5,8035,400,59,1,5,4,10
09/21/16,1,6,513,370,5,0,1,0,1
09/21/16,1,8,785,350,115,4,5,3,12
09/21/16,1,10,774,380,136,37,12,2,51
09/21/16,1,12,285,350,20,8,3,0,11
09/21/16,1,13,7601,400,97,10,5,3,18
09/21/16,1,14,8030,360,165,1,4,0,5
09/21/16,1,15,495,350,123,5,23,1,29
09/21/16,1,16,8040,350,147,9,11,3,23
09/21/16,1,18,542,350,125,26,5,1,32
09/21/16,1,19,542,360,140,19,6,1,26
09/21/16,1,20,8032,350,84,20,42,2,64
09/21/16,1,22,785,350,96,5,9,0,14
09/21/16,1,24,7675,360,110,21,3,4,28
09/21/16,1,25,542,375,126,15,2,1,18
09/21/16,1,26,775,360,141,15,8,1,24
09/21/16,1,27,542,360,92,22,20,0,42
09/21/16,1,28,1001,375,100,40,9,4,53
09/21/16,2,1,726,305,109,11,12,2,25
09/21/16,2,2,972,315,103,11,9,2,22
09/21/16,2,3,996,300,9,0,3,0,3
09/21/16,2,5,8035,400,152,4,12,1,17
09/21/16,2,6,513,370,126,14,7,4,25
09/21/16,2,7,7724,345,5,0,1,4,5
09/21/16,2,8,785,350,151,0,7,2,9
09/21/16,2,10,774,380,131,28,12,1,41
09/21/16,2,12,285,350,119,17,12,3,32
09/21/16,2,14,8030,360,165,1,4,1,6
09/21/16,2,15,495,350,68,1,17,0,18
09/21/16,2,16,8040,350,9,1,2,2,5
09/21/16,2,18,542,350,100,33,3,1,37
09/21/16,2,20,8032,350,89,8,29,1,38
09/21/16,2,22,785,350,94,4,4,0,8
09/21/16,2,24,7675,360,110,13,6,4,23
09/21/16,2,25,542,375,94,11,4,1,16
09/21/16,2,26,775,360,88,18,4,1,23
09/21/16,2,27,542,360,63,11,16,0,27
09/21/16,2,28,1001,375,58,28,9,5,42
09/21/16,3,1,726,305,36,5,6,0,11
09/21/16,3,2,972,315,109,9,15,1,25
09/21/16,3,5,8035,400,154,2,8,2,12
09/21/16,3,6,513,370,146,10,3,4,17
09/21/16,3,7,7724,345,109,1,29,2,32
09/21/16,3,8,785,350,154,2,4,1,7
09/21/16,3,10,774,380,126,20,15,4,39
09/21/16,3,12,285,350,115,8,7,5,20
09/21/16,3,14,8030,360,152,0,13,0,13
09/21/16,3,15,495,350,85,0,14,0,14
09/21/16,3,18,542,350,104,30,1,1,32
09/21/16,3,20,8032,350,80,7,29,1,37
09/21/16,3,22,785,350,104,2,10,0,12
09/21/16,3,24,7675,360,97,16,3,3,22
09/21/16,3,26,775,360,98,26,8,0,34
09/21/16,3,27,542,360,77,21,13,0,34
09/21/16,3,28,1001,375,62,32,0,3,35
09/22/16,1,1,726,305,71,14,4,0,18
09/22/16,1,2,972,315,62,14,21,1,36
09/22/16,1,4,5302,300,90,21,6,7,34
09/22/16,1,5,8035,400,131,3,11,5,19
09/22/16,1,6,513,370,151,16,2,2,20
09/22/16,1,7,7724,345,140,0,13,1,14
09/22/16,1,8,785,350,148,1,6,1,8
09/22/16,1,11,7652,355,42,3,6,6,15
09/22/16,1,12,285,350,114,38,7,7,52
09/22/16,1,14,8030,360,160,1,4,1,6
09/22/16,1,15,495,350,124,2,15,0,17
09/22/16,1,17,775,370,81,14,5,5,24
09/22/16,1,18,542,350,94,29,5,1,35
09/22/16,1,20,8032,350,59,17,36,2,55
09/22/16,1,22,785,350,126,0,4,1,5
09/22/16,1,23,542,350,101,29,5,0,34
09/22/16,1,24,7751,360,124,18,5,3,26
09/22/16,1,26,775,360,121,23,5,1,29
09/22/16,1,27,542,360,111,17,19,0,36
09/22/16,1,28,1001,375,41,37,4,10,51
09/22/16,2,1,726,305,111,8,9,2,19
09/22/16,2,3,996,300,57,7,12,6,25
09/22/16,2,4,5302,300,79,29,0,3,32
09/22/16,2,5,8035,400,150,0,13,0,13
09/22/16,2,6,542,370,140,9,7,1,17
09/22/16,2,7,7724,345,107,0,18,4,22
09/22/16,2,8,785,350,138,1,8,8,17
09/22/16,2,10,774,380,12,0,8,2,10
09/22/16,2,11,7652,355,137,6,17,0,23
09/22/16,2,12,285,350,103,39,9,2,50
09/22/16,2,14,8030,360,162,0,2,1,3
09/22/16,2,15,495,350,90,1,19,1,21
09/22/16,2,17,775,370,133,18,9,2,29
09/22/16,2,18,542,350,53,9,4,3,16
09/22/16,2,20,8032,350,60,15,39,2,56
09/22/16,2,22,785,350,110,3,9,0,12
09/22/16,2,23,542,350,101,17,8,0,25
09/22/16,2,24,7751,360,42,10,2,3,15
09/22/16,2,26,775,360,102,24,7,1,32
09/22/16,2,27,542,360,91,17,15,0,32
09/22/16,2,28,1001,375,57,29,3,2,34
09/22/16,3,1,726,305,91,9,9,0,18
09/22/16,3,3,996,300,77,14,27,8,49
09/22/16,3,4,5302,300,93,35,0,3,38
09/22/16,3,5,8035,400,128,6,6,2,14
09/22/16,3,6,542,370,160,5,2,1,8
09/22/16,3,7,7724,345,148,0,5,3,8
09/22/16,3,8,785,350,155,2,2,1,5
09/22/16,3,10,774,380,126,18,27,7,52
09/22/16,3,11,7652,355,142,9,9,0,18
09/22/16,3,12,285,350,90,48,8,4,60
09/22/16,3,14,8030,360,74,1,9,0,10
09/22/16,3,15,495,350,85,0,14,0,14
09/22/16,3,17,775,370,111,19,5,4,28
09/22/16,3,20,8032,350,71,10,49,5,64
09/22/16,3,22,785,350,101,1,1,0,2
09/22/16,3,23,542,350,98,25,4,0,29
09/22/16,3,26,775,360,135,18,3,0,21
09/22/16,3,27,542,360,101,17,16,0,33
09/22/16,3,28,1001,375,3,1,2,1,4
09/23/16,1,3,996,300,109,18,9,9,36
09/23/16,1,4,5302,300,52,1,17,6,24
09/23/16,1,5,8035,400,143,7,5,3,15
09/23/16,1,6,513,370,149,20,4,2,26
09/23/16,1,7,7724,345,157,0,8,1,9
09/23/16,1,8,785,350,122,2,8,9,19
09/23/16,1,10,774,380,114,36,20,6,62
09/23/16,1,11,7652,355,145,11,10,3,24
09/23/16,1,12,285,350,54,57,2,1,60
09/23/16,1,14,8030,360,18,0,5,2,7
09/23/16,1,15,495,350,119,0,19,1,20
09/23/16,1,17,775,370,121,24,11,3,38
09/23/16,1,20,8032,350,76,12,40,3,55
09/23/16,1,21,542,350,69,17,15,0,32
09/23/16,1,22,785,350,169,2,2,0,4
09/23/16,1,23,542,350,109,41,3,0,44
09/23/16,1,24,7751,360,94,14,7,0,21
09/23/16,1,26,775,360,147,25,6,1,32
09/23/16,1,27,542,360,105,22,17,0,39
09/23/16,1,28,7751,375,39,5,0,8,13
09/23/16,2,3,996,300,121,12,10,5,27
09/23/16,2,4,5302,300,60,1,27,2,30
09/23/16,2,5,8035,400,114,0,14,1,15
09/23/16,2,6,542,370,139,25,6,1,32
09/23/16,2,7,7724,345,148,0,7,4,11
09/23/16,2,8,785,350,150,4,7,1,12
09/23/16,2,10,774,380,123,33,27,1,61
09/23/16,2,11,7652,355,149,10,6,0,16
09/23/16,2,12,285,350,102,37,12,4,53
09/23/16,2,14,8030,360,132,0,17,3,20
09/23/16,2,15,495,350,45,1,16,0,17
09/23/16,2,17,775,370,120,20,6,1,27
09/23/16,2,18,542,350,20,17,3,3,23
09/23/16,2,19,715,360,60,1,6,0,7
09/23/16,2,20,8032,350,64,17,39,1,57
09/23/16,2,21,542,350,85,13,13,0,26
09/23/16,2,22,785,350,134,0,3,1,4
09/23/16,2,23,542,350,90,49,2,0,51
09/23/16,2,24,7751,360,110,20,12,2,34
09/23/16,2,26,775,360,93,19,5,1,25
09/23/16,2,27,542,360,91,17,10,0,27
09/23/16,2,28,1001,375,118,25,7,5,37
09/23/16,3,3,996,300,99,13,11,9,33
09/23/16,3,4,5302,300,83,33,0,6,39
09/23/16,3,5,8035,400,145,0,8,3,11
09/23/16,3,6,542,370,76,20,3,1,24
09/23/16,3,7,7724,345,155,0,2,1,3
09/23/16,3,8,785,350,149,4,4,2,10
09/23/16,3,9,775,350,15,40,10,22,72
09/23/16,3,10,774,380,112,34,20,6,60
09/23/16,3,11,7652,355,118,13,14,3,30
09/23/16,3,12,285,350,109,23,6,3,32
09/23/16,3,14,8030,360,160,1,5,0,6
09/23/16,3,15,495,140,87,2,13,0,15
09/23/16,3,17,775,370,104,14,10,4,28
09/23/16,3,18,542,350,57,43,4,0,47
09/23/16,3,19,715,360,40,2,2,0,4
09/23/16,3,20,8032,350,54,8,29,1,38
09/23/16,3,21,542,350,44,22,9,0,31
09/23/16,3,22,785,350,125,2,6,0,8
09/23/16,3,23,542,350,40,28,2,0,30
09/23/16,3,24,7751,360,54,7,0,3,10
09/23/16,3,26,775,17,70,20,5,6,31
09/23/16,3,27,542,360,81,12,11,0,23
09/23/16,3,28,1001,375,42,12,12,5,29
09/26/16,1,1,726,305,58,5,11,2,18
09/26/16,1,3,996,300,76,14,14,6,34
09/26/16,1,4,5302,300,82,30,0,5,35
09/26/16,1,5,8035,400,148,2,6,1,9
09/26/16,1,6,542,370,135,13,1,1,15
09/26/16,1,7,7724,345,149,0,10,2,12
09/26/16,1,8,785,350,144,1,4,1,6
09/26/16,1,9,775,350,95,22,11,3,36
09/26/16,1,10,774,380,96,15,13,8,36
09/26/16,1,11,7652,355,129,13,10,4,27
09/26/16,1,12,285,350,134,8,17,7,32
09/26/16,1,14,8030,360,143,1,0,4,5
09/26/16,1,15,495,350,104,0,21,1,22
09/26/16,1,17,775,370,90,44,5,2,51
09/26/16,1,18,542,350,71,109,1,1,111
09/26/16,1,19,715,360,53,2,4,0,6
09/26/16,1,20,8032,350,42,11,35,1,47
09/26/16,1,21,542,350,74,19,12,0,31
09/26/16,1,22,785,350,154,4,3,0,7
09/26/16,1,23,542,350,64,25,5,0,30
09/26/16,1,24,7751,360,117,20,4,2,26
09/26/16,1,26,775,360,87,19,5,0,24
09/26/16,1,27,542,360,74,11,18,0,29
09/26/16,1,28,7751,375,97,19,12,3,34
09/26/16,2,1,726,305,107,7,13,1,21
09/26/16,2,4,5302,300,73,44,0,0,44
09/26/16,2,5,8035,400,163,2,3,1,6
09/26/16,2,6,542,370,155,19,2,2,23
09/26/16,2,7,7724,345,162,2,1,0,3
09/26/16,2,8,785,350,157,2,1,2,5
09/26/16,2,9,775,350,119,28,13,12,53
09/26/16,2,10,774,380,123,21,20,2,43
09/26/16,2,11,7652,355,141,30,15,2,47
09/26/16,2,12,285,350,17,26,7,2,35
09/26/16,2,14,8030,360,165,1,1,1,3
09/26/16,2,15,495,350,48,2,14,0,16
09/26/16,2,17,775,370,92,47,7,8,62
09/26/16,2,18,542,350,75,68,4,0,72
09/26/16,2,19,715,360,145,1,8,0,9
09/26/16,2,20,8032,350,66,21,35,0,56
09/26/16,2,21,542,350,71,28,10,0,38
09/26/16,2,22,785,350,150,7,1,0,8
09/26/16,2,23,542,350,103,39,1,0,40
09/26/16,2,24,7751,360,137,15,2,5,22
09/26/16,2,26,775,360,115,22,9,2,33
09/26/16,2,27,542,360,82,18,12,0,30
09/26/16,2,28,7751,375,115,32,4,4,40
09/26/16,3,1,726,305,116,8,16,0,24
09/26/16,3,3,996,300,106,5,14,28,47
09/26/16,3,4,5302,300,81,23,0,11,34
09/26/16,3,5,8035,400,151,1,7,0,8
09/26/16,3,6,542,370,112,20,5,6,31
09/26/16,3,7,7724,345,154,4,5,1,10
09/26/16,3,8,785,350,158,2,3,1,6
09/26/16,3,9,775,350,116,28,25,2,55
09/26/16,3,10,774,380,134,19,24,1,44
09/26/16,3,11,7652,355,149,8,12,0,20
09/26/16,3,14,8030,360,164,0,4,2,6
09/26/16,3,17,775,370,62,24,9,1,34
09/26/16,3,18,542,350,35,52,1,0,53
09/26/16,3,19,715,360,54,8,2,0,10
09/26/16,3,20,8032,350,29,14,23,2,39
09/26/16,3,21,542,350,65,19,5,0,24
09/26/16,3,22,785,350,130,10,0,0,10
09/26/16,3,23,542,350,61,30,1,0,31
09/26/16,3,24,7751,360,85,13,3,2,18
09/26/16,3,26,775,360,69,19,7,0,26
09/26/16,3,27,542,360,92,13,13,0,26
09/26/16,3,28,7751,375,111,20,3,3,26
09/27/16,1,1,726,305,84,11,5,6,22
09/27/16,1,2,996,315,51,6,22,8,36
09/27/16,1,3,996,300,112,17,14,7,38
09/27/16,1,4,5302,300,89,2,41,5,48
09/27/16,1,5,8035,400,160,2,3,3,8
09/27/16,1,6,542,370,56,6,1,1,8
09/27/16,1,7,7724,345,162,3,0,3,6
09/27/16,1,8,785,350,158,2,2,0,4
09/27/16,1,9,775,350,121,23,25,1,49
09/27/16,1,10,774,380,140,22,22,2,46
09/27/16,1,11,7652,355,154,3,9,0,12
09/27/16,1,14,8030,360,151,1,11,1,13
09/27/16,1,17,775,370,87,39,13,1,53
09/27/16,1,18,542,350,80,91,2,5,98
09/27/16,1,19,715,360,141,10,6,1,17
09/27/16,1,20,8032,350,59,37,27,1,65
09/27/16,1,21,542,350,82,28,12,0,40
09/27/16,1,22,785,350,160,3,1,0,4
09/27/16,1,23,542,350,89,32,8,0,40
09/27/16,1,27,542,360,52,12,8,0,20
09/27/16,1,28,7751,375,94,20,6,4,30
09/27/16,2,1,726,305,99,10,17,0,27
09/27/16,2,2,996,315,77,7,28,6,41
09/27/16,2,3,996,300,92,14,11,5,30
09/27/16,2,4,5302,300,83,39,0,3,42
09/27/16,2,5,8035,400,55,1,7,1,9
09/27/16,2,7,7724,345,158,2,4,1,7
09/27/16,2,8,785,350,152,5,1,1,7
09/27/16,2,9,775,350,87,22,18,4,44
09/27/16,2,10,774,380,106,27,16,6,49
09/27/16,2,11,7652,355,137,4,10,1,15
09/27/16,2,14,8030,360,121,1,16,3,20
09/27/16,2,17,775,370,137,25,6,1,32
09/27/16,2,18,542,350,87,86,1,5,92
09/27/16,2,19,715,360,150,2,11,1,14
09/27/16,2,20,8032,350,78,19,45,3,67
09/27/16,2,21,542,350,100,15,13,0,28
09/27/16,2,22,785,350,163,2,0,1,3
09/27/16,2,23,542,350,110,37,3,0,40
09/27/16,2,24,7675,360,78,5,5,7,17
09/27/16,2,27,542,360,79,21,14,0,35
09/27/16,3,1,726,305,103,16,15,0,31
09/27/16,3,2,996,315,75,16,14,4,34
09/27/16,3,3,996,300,129,6,6,6,18
09/27/16,3,4,5302,300,96,27,4,5,36
09/27/16,3,7,7724,345,159,1,2,2,5
09/27/16,3,8,785,350,145,2,6,1,9
09/27/16,3,9,775,350,104,38,19,1,58
09/27/16,3,10,774,380,122,28,26,1,55
09/27/16,3,11,7652,355,135,7,14,0,21
09/27/16,3,14,8030,360,160,1,2,1,4
09/27/16,3,17,775,370,118,34,7,3,44
09/27/16,3,18,542,350,47,107,1,4,112
09/27/16,3,19,715,360,132,0,8,0,8
09/27/16,3,20,8032,350,68,24,32,2,58
09/27/16,3,21,542,350,100,17,14,0,31
09/27/16,3,22,785,350,135,6,1,0,7
09/27/16,3,23,542,350,94,29,2,0,31
09/27/16,3,24,7675,360,134,11,3,4,18
09/27/16,3,25,542,375,71,12,7,0,19
09/27/16,3,27,542,360,98,12,12,0,24
09/28/16,1,1,726,305,110,21,6,2,29
09/28/16,1,2,996,315,78,48,23,4,75
09/28/16,1,3,996,300,111,15,12,9,36
09/28/16,1,4,5302,300,69,60,2,7,69
09/28/16,1,7,7724,345,156,0,5,1,6
09/28/16,1,8,785,350,126,3,3,5,11
09/28/16,1,9,775,350,114,36,22,2,60
09/28/16,1,10,774,380,138,27,16,3,46
09/28/16,1,11,7652,355,141,11,6,1,18
09/28/16,1,14,8030,360,163,2,4,0,6
09/28/16,1,17,775,370,117,24,9,5,38
09/28/16,1,18,542,350,133,32,3,1,36
09/28/16,1,19,715,360,150,0,7,0,7
09/28/16,1,20,8032,350,62,16,38,1,55
09/28/16,1,21,542,350,102,22,20,0,42
09/28/16,1,22,785,350,131,7,6,0,13
09/28/16,1,23,542,350,106,39,3,0,42
09/28/16,1,24,7675,360,140,15,1,7,23
09/28/16,1,25,542,375,121,20,11,1,32
09/28/16,1,27,542,360,98,6,22,0,28
09/28/16,1,28,7751,375,21,4,0,3,7
09/28/16,2,1,726,305,95,6,15,0,21
09/28/16,2,2,996,315,77,32,20,2,54
09/28/16,2,3,996,300,99,14,12,6,32
09/28/16,2,4,5302,300,32,57,2,4,63
09/28/16,2,7,7724,345,153,1,4,1,6
09/28/16,2,8,785,350,114,8,8,3,19
09/28/16,2,9,775,350,89,26,7,1,34
09/28/16,2,10,774,380,96,19,15,2,36
09/28/16,2,11,7652,355,74,6,9,0,15
09/28/16,2,12,285,350,76,8,8,5,21
09/28/16,2,14,8030,360,144,2,6,1,9
09/28/16,2,17,775,370,111,26,4,0,30
09/28/16,2,18,542,350,105,28,9,1,38
09/28/16,2,19,715,360,149,0,7,1,8
09/28/16,2,20,8032,350,77,15,38,1,54
09/28/16,2,21,542,350,83,20,13,0,33
09/28/16,2,22,785,350,131,7,4,1,12
09/28/16,2,23,542,350,95,44,0,0,44
09/28/16,2,24,7675,360,130,11,5,6,22
09/28/16,2,25,542,375,86,18,5,1,24
09/28/16,2,27,542,360,103,20,13,0,33
09/28/16,3,2,996,315,91,51,21,7,79
09/28/16,3,3,996,300,116,9,14,15,38
09/28/16,3,4,5302,300,66,81,0,6,87
09/28/16,3,7,7724,345,159,0,4,0,4
09/28/16,3,8,785,350,150,4,7,0,11
09/28/16,3,9,775,350,127,21,18,3,42
09/28/16,3,10,774,380,64,9,18,0,27
09/28/16,3,12,285,350,131,19,7,3,29
09/28/16,3,17,775,370,125,14,6,1,21
09/28/16,3,18,542,350,79,40,6,2,48
09/28/16,3,19,715,360,144,3,9,0,12
09/28/16,3,20,8032,350,70,9,25,1,35
09/28/16,3,21,542,350,103,16,10,0,26
09/28/16,3,22,785,350,49,35,0,0,35
09/28/16,3,23,542,350,28,9,4,0,13
09/28/16,3,24,7675,360,109,15,2,2,19
09/28/16,3,25,542,375,69,17,13,0,30
09/28/16,3,27,542,360,65,3,12,0,15
09/29/16,1,2,996,315,99,34,41,7,82
09/29/16,1,3,996,300,119,13,12,25,50
09/29/16,1,4,5302,300,80,83,0,5,88
09/29/16,1,7,7724,345,160,2,1,1,4
09/29/16,1,8,785,350,158,2,3,1,6
09/29/16,1,9,775,350,101,33,20,4,57
09/29/16,1,10,774,380,20,1,0,4,5
09/29/16,1,12,285,350,141,15,8,5,28
09/29/16,1,17,775,370,132,15,14,3,32
09/29/16,1,18,542,350,118,55,3,1,59
09/29/16,1,19,715,360,155,0,10,1,11
09/29/16,1,20,8032,350,77,15,37,1,53
09/29/16,1,21,542,350,101,17,15,0,32
09/29/16,1,22,785,350,142,16,1,1,18
09/29/16,1,23,542,350,85,25,10,0,35
09/29/16,1,24,7675,360,99,4,4,3,11
09/29/16,1,25,542,375,93,33,9,1,43
09/29/16,1,26,542,360,55,26,10,0,36
09/29/16,1,28,7751,375,43,12,4,2,18
09/29/16,2,1,726,305,78,5,12,1,18
09/29/16,2,2,996,315,65,19,32,4,55
09/29/16,2,3,996,300,90,3,14,12,29
09/29/16,2,4,5302,300,56,53,0,3,56
09/29/16,2,7,7724,345,154,0,1,1,2
09/29/16,2,8,785,350,99,4,8,0,12
09/29/16,2,9,775,350,101,22,11,3,36
09/29/16,2,10,774,380,99,8,15,1,24
09/29/16,2,11,7652,355,63,8,16,3,27
09/29/16,2,12,285,350,149,10,9,6,25
09/29/16,2,14,8030,360,2,1,2,1,4
09/29/16,2,17,775,370,116,33,5,0,38
09/29/16,2,18,542,350,122,18,9,0,27
09/29/16,2,19,715,360,158,5,4,1,10
09/29/16,2,20,8032,350,71,22,34,3,59
09/29/16,2,21,542,350,103,11,14,0,25
09/29/16,2,22,785,350,149,7,2,0,9
09/29/16,2,23,542,350,86,39,3,0,42
09/29/16,2,24,7675,360,31,3,7,7,17
09/29/16,2,25,542,375,81,13,7,0,20
09/29/16,2,26,542,360,69,27,3,1,31
09/29/16,3,1,726,305,110,11,15,0,26
09/29/16,3,3,996,300,30,2,3,2,7
09/29/16,3,4,5302,300,47,115,0,10,125
09/29/16,3,7,7724,345,155,2,2,1,5
09/29/16,3,9,775,350,120,28,11,6,45
09/29/16,3,10,774,380,147,13,26,2,41
09/29/16,3,11,7652,355,122,9,24,2,35
09/29/16,3,12,285,350,141,14,6,8,28
09/29/16,3,14,8030,360,156,1,3,1,5
09/29/16,3,17,775,370,48,25,3,2,30
09/29/16,3,18,542,350,100,37,1,0,38
09/29/16,3,19,715,360,135,17,5,0,22
09/29/16,3,20,8032,350,63,15,30,1,46
09/29/16,3,21,542,350,118,13,8,0,21
09/29/16,3,22,785,350,129,8,7,0,15
09/29/16,3,23,542,350,80,23,5,0,28
09/29/16,3,24,7675,360,97,12,11,4,27
09/29/16,3,25,542,375,93,23,6,0,29
09/29/16,3,26,542,360,71,29,8,0,37
09/30/16,1,1,726,305,91,11,23,4,38
09/30/16,1,2,996,315,72,29,31,4,64
09/30/16,1,3,996,300,117,11,12,12,35
09/30/16,1,4,5302,300,60,59,1,8,68
09/30/16,1,7,7724,345,151,1,10,1,12
09/30/16,1,9,775,350,129,21,14,6,41
09/30/16,1,10,774,380,112,12,21,2,35
09/30/16,1,11,7652,355,128,21,15,0,36
09/30/16,1,12,285,350,142,14,9,3,26
09/30/16,1,14,8030,360,165,0,1,2,3
09/30/16,1,15,785,350,6,3,1,0,4
09/30/16,1,18,542,350,119,45,2,1,48
09/30/16,1,19,715,360,171,2,7,1,10
09/30/16,1,20,8032,350,50,9,25,1,35
09/30/16,1,21,542,350,125,18,14,0,32
09/30/16,1,22,785,350,146,9,4,0,13
09/30/16,1,23,542,350,91,43,3,0,46
09/30/16,1,24,7675,360,115,10,14,3,27
09/30/16,1,25,542,375,89,21,8,1,30
09/30/16,1,26,542,360,67,41,1,1,43
09/30/16,1,27,542,360,51,13,0,1,14
09/30/16,2,1,726,305,94,6,19,2,27
09/30/16,2,2,996,315,82,33,19,8,60
09/30/16,2,3,996,300,100,9,11,8,28
09/30/16,2,4,5302,300,42,25,0,4,29
09/30/16,2,7,7724,345,159,1,2,1,4
09/30/16,2,8,785,350,51,2,1,12,15
09/30/16,2,9,775,350,110,19,7,2,28
09/30/16,2,10,774,380,125,14,9,3,26
09/30/16,2,11,7652,355,101,11,24,1,36
09/30/16,2,12,285,350,140,10,5,4,19
09/30/16,2,14,8030,360,137,3,4,1,8
09/30/16,2,15,785,350,78,10,2,0,12
09/30/16,2,18,542,350,77,43,3,0,46
09/30/16,2,19,715,360,152,1,6,1,8
09/30/16,2,20,8032,350,16,5,9,2,16
09/30/16,2,21,542,350,69,20,10,1,31
09/30/16,2,22,785,350,110,2,8,1,11
09/30/16,2,23,542,350,84,33,4,1,38
09/30/16,2,24,7675,360,95,7,13,2,22
09/30/16,2,25,542,375,100,5,12,1,18
09/30/16,2,26,542,360,40,32,2,0,34
09/30/16,2,27,542,360,105,29,0,1,30
09/30/16,3,1,726,305,102,15,17,1,33
09/30/16,3,2,996,315,80,32,26,6,64
09/30/16,3,3,996,300,101,4,14,11,29
09/30/16,3,4,5302,300,96,27,0,7,34
09/30/16,3,7,7724,345,105,0,10,1,11
09/30/16,3,8,785,350,162,3,0,0,3
09/30/16,3,9,775,350,121,30,12,3,45
09/30/16,3,10,774,380,129,22,20,1,43
09/30/16,3,11,7652,355,110,12,15,1,28
09/30/16,3,12,285,350,115,15,6,7,28
09/30/16,3,14,8030,360,150,1,2,1,4
09/30/16,3,15,785,140,158,1,0,0,1
09/30/16,3,18,542,350,89,64,3,7,74
09/30/16,3,19,715,360,148,4,5,0,9
09/30/16,3,21,542,350,93,27,7,0,34
09/30/16,3,22,785,350,151,2,3,0,5
09/30/16,3,23,542,350,77,45,4,0,49
09/30/16,3,24,7675,360,74,6,6,2,14
09/30/16,3,25,542,375,23,3,8,0,11
09/30/16,3,26,542,17,33,35,3,0,38
09/30/16,3,27,542,360,114,22,2,0,24
10/03/16,1,1,726,305,73,19,13,60,92
10/03/16,1,2,996,315,80,44,29,14,87
10/03/16,1,3,996,300,106,8,9,9,26
10/03/16,1,4,5302,300,91,39,0,3,42
10/03/16,1,8,785,350,131,0,3,6,9
10/03/16,1,9,775,350,124,32,3,1,36
10/03/16,1,10,774,380,127,23,15,3,41
10/03/16,1,11,7652,355,129,18,19,0,37
10/03/16,1,14,8030,360,159,2,5,0,7
10/03/16,1,15,785,350,156,0,3,0,3
10/03/16,1,17,542,370,2,3,1,0,4
10/03/16,1,18,542,350,94,61,2,0,63
10/03/16,1,19,715,360,172,0,2,0,2
10/03/16,1,21,542,350,93,15,21,1,37
10/03/16,1,22,785,350,155,6,2,0,8
10/03/16,1,23,542,350,95,39,6,1,46
10/03/16,1,24,7675,360,80,6,21,4,31
10/03/16,1,26,542,360,52,45,5,0,50
10/03/16,1,27,542,360,133,15,2,1,18
10/03/16,2,1,726,305,87,9,27,14,50
10/03/16,2,2,996,315,48,28,11,2,41
10/03/16,2,3,996,300,116,7,15,9,31
10/03/16,2,4,5302,300,60,28,0,7,35
10/03/16,2,8,785,350,154,1,1,2,4
10/03/16,2,9,775,350,127,19,11,2,32
10/03/16,2,10,774,380,116,23,21,1,45
10/03/16,2,11,7652,355,86,11,16,4,31
10/03/16,2,14,8030,360,168,1,1,2,4
10/03/16,2,15,785,350,159,2,1,1,4
10/03/16,2,17,542,370,40,49,19,3,71
10/03/16,2,18,542,350,95,38,7,0,45
10/03/16,2,19,715,360,152,1,3,1,5
10/03/16,2,20,8032,350,51,25,48,3,76
10/03/16,2,21,542,350,92,18,9,0,27
10/03/16,2,22,785,350,131,6,3,1,10
10/03/16,2,23,542,350,111,28,4,0,32
10/03/16,2,24,7675,360,106,4,13,2,19
10/03/16,2,25,542,375,51,7,7,0,14
10/03/16,2,26,542,360,34,39,2,0,41
10/03/16,2,27,542,360,127,21,2,2,25
10/03/16,3,1,726,305,100,15,23,3,41
10/03/16,3,3,996,300,99,14,11,10,35
10/03/16,3,4,5302,300,71,40,4,13,57
10/03/16,3,6,542,370,24,83,0,12,95
10/03/16,3,8,785,350,163,0,1,0,1
10/03/16,3,9,775,350,47,8,7,1,16
10/03/16,3,10,774,380,131,30,18,3,51
10/03/16,3,11,7652,355,122,18,19,0,37
10/03/16,3,14,8030,360,170,1,0,0,1
10/03/16,3,15,785,350,143,1,4,1,6
10/03/16,3,16,8040,350,54,44,3,2,49
10/03/16,3,17,775,370,34,39,5,0,44
10/03/16,3,18,542,350,74,33,1,0,34
10/03/16,3,19,715,360,143,1,5,1,7
10/03/16,3,20,8032,350,38,9,33,2,44
10/03/16,3,21,542,350,67,21,6,1,28
10/03/16,3,22,785,350,36,2,12,0,14
10/03/16,3,23,542,350,64,24,3,1,28
10/03/16,3,24,7675,360,82,8,10,4,22
10/03/16,3,25,542,375,61,14,8,1,23
10/03/16,3,26,542,360,17,15,1,1,17
10/03/16,3,27,542,360,94,21,0,0,21
10/04/16,1,1,726,305,111,15,13,3,31
10/04/16,1,2,996,315,75,34,22,12,68
10/04/16,1,3,996,300,80,23,12,11,46
10/04/16,1,4,5302,300,70,70,3,7,80
10/04/16,1,6,542,370,125,50,8,5,63
10/04/16,1,8,785,350,157,0,2,1,3
10/04/16,1,10,774,380,124,34,12,1,47
10/04/16,1,11,7652,355,129,12,20,1,33
10/04/16,1,14,8030,360,158,2,5,1,8
10/04/16,1,15,785,350,152,0,4,0,4
10/04/16,1,16,8040,350,30,9,0,7,16
10/04/16,1,17,542,370,76,46,19,1,66
10/04/16,1,18,542,350,16,8,3,1,12
10/04/16,1,19,715,360,162,1,5,1,7
10/04/16,1,20,8032,350,51,22,39,1,62
10/04/16,1,21,542,350,114,16,15,1,32
10/04/16,1,23,542,350,72,33,8,0,41
10/04/16,1,24,7675,360,6,1,3,3,7
10/04/16,1,25,542,375,114,17,12,1,30
10/04/16,1,26,542,360,46,36,4,0,40
10/04/16,1,27,542,360,87,32,0,1,33
10/04/16,2,1,726,305,89,10,16,1,27
10/04/16,2,2,996,315,71,21,20,3,44
10/04/16,2,3,996,300,65,16,15,9,40
10/04/16,2,4,5302,300,62,40,1,1,42
10/04/16,2,6,542,370,89,46,4,1,51
10/04/16,2,8,785,350,157,3,1,1,5
10/04/16,2,10,774,380,114,34,12,2,48
10/04/16,2,11,7652,355,123,24,11,2,37
10/04/16,2,14,8030,360,156,0,2,1,3
10/04/16,2,15,785,350,171,0,0,1,1
10/04/16,2,16,8040,350,85,24,12,2,38
10/04/16,2,17,542,370,78,34,11,2,47
10/04/16,2,19,715,360,157,2,6,1,9
10/04/16,2,20,8032,350,104,32,20,1,53
10/04/16,2,21,542,350,123,17,10,1,28
10/04/16,2,22,774,350,60,8,11,0,19
10/04/16,2,23,542,350,105,37,4,1,42
10/04/16,2,25,542,375,123,17,8,1,26
10/04/16,2,26,542,360,57,39,0,1,40
10/04/16,2,27,542,360,138,16,2,2,20
10/04/16,3,1,726,305,106,13,16,2,31
10/04/16,3,2,996,315,72,19,29,5,53
10/04/16,3,3,996,300,78,22,17,9,48
10/04/16,3,4,5302,300,95,33,0,5,38
10/04/16,3,6,542,370,114,29,8,6,43
10/04/16,3,8,785,350,156,3,1,0,4
10/04/16,3,10,774,380,114,59,13,2,74
10/04/16,3,11,7652,355,101,41,22,2,65
10/04/16,3,14,8030,360,123,1,31,2,34
10/04/16,3,15,785,350,144,3,1,0,4
10/04/16,3,16,8040,350,69,17,12,0,29
10/04/16,3,17,775,370,66,35,16,2,53
10/04/16,3,19,715,360,154,3,6,0,9
10/04/16,3,20,8032,350,62,20,12,1,33
10/04/16,3,21,542,350,93,18,13,0,31
10/04/16,3,22,774,350,115,12,10,0,22
10/04/16,3,23,542,350,49,25,0,0,25
10/04/16,3,25,542,375,92,11,5,0,16
10/04/16,3,26,542,360,56,38,4,0,42
10/04/16,3,27,542,360,118,18,2,0,20
10/05/16,1,1,726,305,84,13,19,5,37
10/05/16,1,2,996,315,35,18,19,3,40
10/05/16,1,3,996,300,78,25,9,7,41
10/05/16,1,4,5302,300,49,21,0,9,30
10/05/16,1,6,542,370,124,36,6,7,49
10/05/16,1,8,785,350,162,0,1,1,2
10/05/16,1,10,774,380,110,37,14,5,56
10/05/16,1,11,7652,355,122,12,19,3,34
10/05/16,1,12,7493,350,82,21,8,9,38
10/05/16,1,14,8030,360,162,0,3,1,4
10/05/16,1,15,785,350,162,1,6,0,7
10/05/16,1,16,8040,350,105,28,11,3,42
10/05/16,1,17,775,370,77,28,22,2,52
10/05/16,1,19,715,360,158,1,12,1,14
10/05/16,1,20,8032,350,100,51,18,2,71
10/05/16,1,21,542,350,122,13,14,1,28
10/05/16,1,22,774,350,123,11,18,2,31
10/05/16,1,23,542,350,13,4,1,0,5
10/05/16,1,25,542,375,124,14,17,1,32
10/05/16,1,26,542,360,75,55,3,0,58
10/05/16,1,27,542,360,32,6,0,0,6
10/05/16,2,1,726,305,62,5,20,8,33
10/05/16,2,2,996,315,9,12,1,5,18
10/05/16,2,4,5302,300,76,23,3,2,28
10/05/16,2,6,542,370,105,26,4,5,35
10/05/16,2,7,7724,345,82,14,3,9,26
10/05/16,2,8,785,350,164,0,2,1,3
10/05/16,2,10,774,380,11,0,3,0,3
10/05/16,2,11,7652,355,148,7,12,0,19
10/05/16,2,12,7493,350,124,20,13,4,37
10/05/16,2,14,8030,360,120,1,2,1,4
10/05/16,2,15,785,350,153,1,1,1,3
10/05/16,2,16,8040,350,123,31,14,1,46
10/05/16,2,17,775,370,56,32,15,1,48
10/05/16,2,19,715,360,154,1,10,1,12
10/05/16,2,20,8032,350,92,30,20,1,51
10/05/16,2,21,542,350,100,14,12,1,27
10/05/16,2,22,774,350,89,10,19,1,30
10/05/16,2,23,542,350,28,19,1,0,20
10/05/16,2,25,542,375,120,12,15,1,28
10/05/16,2,26,542,360,70,45,3,0,48
10/05/16,2,27,542,360,150,12,2,1,15
10/05/16,3,1,726,305,92,14,20,6,40
10/05/16,3,2,996,315,21,4,9,1,14
10/05/16,3,4,5302,300,79,31,2,8,41
10/05/16,3,6,542,370,81,17,2,2,21
10/05/16,3,7,7724,345,117,28,21,4,53
10/05/16,3,8,785,350,151,1,1,1,3
10/05/16,3,11,7652,355,128,5,8,0,13
10/05/16,3,12,7493,350,114,22,9,6,37
10/05/16,3,15,785,350,153,1,2,0,3
10/05/16,3,16,8040,350,84,25,10,1,36
10/05/16,3,17,775,370,62,33,8,1,42
10/05/16,3,18,542,350,9,28,14,9,51
10/05/16,3,19,715,360,156,3,1,1,5
10/05/16,3,20,8032,350,67,26,17,1,44
10/05/16,3,21,542,350,85,18,10,1,29
10/05/16,3,22,774,350,81,18,7,0,25
10/05/16,3,23,542,350,70,36,4,0,40
10/05/16,3,25,542,375,93,11,4,0,15
10/05/16,3,26,542,360,34,37,0,1,38
10/05/16,3,27,542,360,96,20,0,1,21
10/05/16,3,28,7675,375,8,3,0,8,11
10/06/16,1,1,726,305,84,9,14,10,33
10/06/16,1,2,996,315,104,9,23,4,36
10/06/16,1,3,996,300,47,12,20,4,36
10/06/16,1,4,5302,300,80,31,1,2,34
10/06/16,1,6,542,370,107,33,7,1,41
10/06/16,1,7,7724,345,101,25,15,8,48
10/06/16,1,8,785,350,165,0,0,0,0
10/06/16,1,10,774,380,49,19,25,4,48
10/06/16,1,11,7652,355,106,18,11,2,31
10/06/16,1,12,7493,350,67,17,9,3,29
10/06/16,1,15,785,350,162,0,5,0,5
10/06/16,1,16,8040,350,111,18,8,3,29
10/06/16,1,17,775,370,56,42,19,4,65
10/06/16,1,18,542,350,73,41,17,2,60
10/06/16,1,19,715,360,159,0,10,1,11
10/06/16,1,20,8032,350,69,34,12,4,50
10/06/16,1,21,542,350,68,10,12,1,23
10/06/16,1,22,774,350,90,13,9,1,23
10/06/16,1,23,542,350,76,24,8,1,33
10/06/16,1,25,542,375,110,14,14,1,29
10/06/16,1,26,542,360,84,52,1,1,54
10/06/16,1,27,542,360,147,15,5,2,22
10/06/16,1,28,7675,375,67,58,5,3,66
10/06/16,2,1,726,305,111,6,6,0,12
10/06/16,2,2,996,315,80,21,13,5,39
10/06/16,2,3,996,300,35,4,20,3,27
10/06/16,2,4,5302,300,59,19,2,1,22
10/06/16,2,6,542,370,114,29,1,2,32
10/06/16,2,7,7724,345,111,20,12,3,35
10/06/16,2,8,785,350,160,1,2,2,5
10/06/16,2,9,542,350,38,35,16,1,52
10/06/16,2,10,774,380,102,19,18,4,41
10/06/16,2,11,7652,355,42,8,6,0,14
10/06/16,2,12,7493,350,84,19,8,2,29
10/06/16,2,14,8030,360,66,0,14,5,19
10/06/16,2,15,785,350,168,0,1,1,2
10/06/16,2,16,8040,350,79,15,9,2,26
10/06/16,2,17,775,370,72,36,13,1,50
10/06/16,2,18,542,350,67,42,1,0,43
10/06/16,2,19,715,360,136,1,15,0,16
10/06/16,2,20,8032,350,72,42,21,3,66
10/06/16,2,22,774,350,102,9,10,1,20
10/06/16,2,23,542,350,24,4,2,0,6
10/06/16,2,25,542,375,112,12,13,1,26
10/06/16,2,26,542,360,100,24,5,1,30
10/06/16,2,27,542,360,135,5,6,1,12
10/06/16,2,28,7675,375,100,37,4,4,45
10/06/16,3,1,726,305,110,11,8,0,19
10/06/16,3,2,996,315,76,18,14,6,38
10/06/16,3,3,996,300,56,24,23,13,60
10/06/16,3,4,5302,300,66,30,1,8,39
10/06/16,3,6,542,370,123,48,5,8,61
10/06/16,3,7,7724,345,122,22,11,1,34
10/06/16,3,8,785,350,160,1,1,2,4
10/06/16,3,9,542,350,102,38,12,1,51
10/06/16,3,10,774,380,120,34,20,1,55
10/06/16,3,12,7493,350,103,24,19,5,48
10/06/16,3,14,8030,360,145,0,17,0,17
10/06/16,3,15,785,350,135,5,3,0,8
10/06/16,3,16,8040,350,93,25,12,1,38
10/06/16,3,17,775,370,50,24,22,2,48
10/06/16,3,18,542,350,76,48,5,0,53
10/06/16,3,19,715,360,155,3,5,0,8
10/06/16,3,20,8032,350,77,36,19,1,56
10/06/16,3,21,542,350,55,17,15,0,32
10/06/16,3,22,774,350,99,11,16,0,27
10/06/16,3,25,542,375,61,14,6,0,20
10/06/16,3,26,542,360,61,21,1,0,22
10/06/16,3,28,7675,375,110,24,2,5,31
10/07/16,1,1,726,305,98,7,10,2,19
10/07/16,1,2,996,315,76,19,19,5,43
10/07/16,1,3,996,300,58,21,27,3,51
10/07/16,1,4,5302,300,80,35,3,2,40
10/07/16,1,6,542,370,108,3,4,0,7
10/07/16,1,7,7724,345,97,4,3,0,7
10/07/16,1,8,785,350,162,0,2,0,2
10/07/16,1,9,542,350,91,29,14,2,45
10/07/16,1,10,774,380,120,23,18,7,48
10/07/16,1,11,7652,355,85,5,12,5,22
10/07/16,1,12,7493,350,116,19,11,9,39
10/07/16,1,14,8030,360,164,1,5,1,7
10/07/16,1,15,785,350,163,0,1,0,1
10/07/16,1,16,8040,350,93,31,15,5,51
10/07/16,1,17,775,370,86,21,25,9,55
10/07/16,1,18,542,350,73,92,11,1,104
10/07/16,1,19,715,360,167,2,8,1,11
10/07/16,1,20,8032,350,77,19,23,1,43
10/07/16,1,21,542,350,109,19,18,1,38
10/07/16,1,22,774,350,105,17,14,1,32
10/07/16,1,23,542,350,71,34,6,0,40
10/07/16,1,25,542,375,120,17,13,0,30
10/07/16,1,26,542,360,90,56,2,1,59
10/07/16,1,27,542,360,72,7,0,0,7
10/07/16,1,28,7675,375,97,44,2,3,49
10/07/16,2,1,726,305,102,9,13,0,22
10/07/16,2,2,996,315,93,7,17,4,28
10/07/16,2,3,996,300,53,16,25,6,47
10/07/16,2,4,5302,300,72,25,5,4,34
10/07/16,2,6,542,370,89,26,13,3,42
10/07/16,2,7,7724,345,91,22,13,1,36
10/07/16,2,8,785,350,129,4,2,3,9
10/07/16,2,9,542,350,88,14,14,2,30
10/07/16,2,10,774,380,100,16,11,1,28
10/07/16,2,11,7652,355,115,24,12,1,37
10/07/16,2,14,8030,360,136,5,7,0,12
10/07/16,2,15,785,350,156,1,1,1,3
10/07/16,2,16,8040,350,117,17,7,3,27
10/07/16,2,17,775,370,105,25,12,2,39
10/07/16,2,18,542,350,84,50,11,0,61
10/07/16,2,19,715,360,156,1,4,1,6
10/07/16,2,20,8032,350,71,46,25,2,73
10/07/16,2,21,542,350,82,16,13,1,30
10/07/16,2,22,774,350,99,25,13,1,39
10/07/16,2,23,542,350,106,19,7,1,27
10/07/16,2,25,542,375,120,16,14,0,30
10/07/16,2,26,542,360,71,32,9,0,41
10/07/16,2,28, ,375,91,27,2,3,32
10/07/16,3,1,726,305,113,10,12,2,24
10/07/16,3,2,996,315,19,6,3,1,10
10/07/16,3,3,996,300,69,39,33,5,77
10/07/16,3,4,5302,300,96,32,3,12,47
10/07/16,3,6,542,370,115,46,8,11,65
10/07/16,3,7,7724,345,128,34,12,4,50
10/07/16,3,8,785,350,164,1,0,1,2
10/07/16,3,9,542,350,127,23,14,1,38
10/07/16,3,10,774,380,18,2,33,2,37
10/07/16,3,11,7652,355,112,34,16,0,50
10/07/16,3,14,8030,360,161,4,2,2,8
10/07/16,3,15,785,140,129,1,6,3,10
10/07/16,3,16,8040,350,71,18,9,3,30
10/07/16,3,17,775,370,93,27,7,1,35
10/07/16,3,18,542,350,50,53,11,0,64
10/07/16,3,19,715,360,141,0,8,0,8
10/07/16,3,20,8032,350,70,27,13,2,42
10/07/16,3,21,542,350,53,7,14,0,21
10/07/16,3,22,774,350,89,17,10,0,27
10/07/16,3,23,542,350,76,23,4,0,27
10/07/16,3,25,542,375,62,15,6,0,21
10/07/16,3,26,542,17,72,35,1,0,36
10/07/16,3,28,7675,375,102,15,2,3,20
10/10/16,1,1,726,305,103,14,9,0,23
10/10/16,1,2,996,315,10,6,3,6,15
10/10/16,1,3,996,300,49,26,27,3,56
10/10/16,1,4,5302,300,71,33,4,4,41
10/10/16,1,6,542,370,110,29,9,7,45
10/10/16,1,7,783,345,112,33,7,2,42
10/10/16,1,8,785,350,150,0,4,2,6
10/10/16,1,9,542,350,100,35,6,1,42
10/10/16,1,10,774,380,64,4,19,8,31
10/10/16,1,11,7652,355,91,36,10,0,46
10/10/16,1,14,8030,360,116,1,12,0,13
10/10/16,1,15,785,350,142,0,4,0,4
10/10/16,1,16,8040,350,100,20,7,2,29
10/10/16,1,17,542,370,65,17,17,3,37
10/10/16,1,18,542,350,38,102,8,0,110
10/10/16,1,19,715,360,161,3,3,1,7
10/10/16,1,20,8032,350,57,58,8,2,68
10/10/16,1,21,542,350,24,12,3,1,16
10/10/16,1,22,774,350,101,8,18,0,26
10/10/16,1,23,542,350,129,16,6,1,23
10/10/16,1,25,542,375,90,20,15,1,36
10/10/16,1,26,542,360,76,29,4,1,34
10/10/16,1,28,7675,375,65,13,1,2,16
10/10/16,2,1,726,305,90,16,13,2,31
10/10/16,2,2,996,315,81,15,12,6,33
10/10/16,2,3,996,300,47,24,22,3,49
10/10/16,2,4,5302,300,35,12,1,5,18
10/10/16,2,5,3062,400,76,12,4,16,32
10/10/16,2,6,542,370,99,24,4,4,32
10/10/16,2,7,783,345,87,28,9,2,39
10/10/16,2,8,785,350,145,0,0,2,2
10/10/16,2,9,542,350,89,32,6,2,40
10/10/16,2,10,774,380,101,17,22,2,41
10/10/16,2,11,7652,355,94,35,13,2,50
10/10/16,2,14,8030,360,42,3,27,1,31
10/10/16,2,15,785,350,163,1,1,1,3
10/10/16,2,16,8040,350,53,25,9,2,36
10/10/16,2,17,542,370,117,20,12,1,33
10/10/16,2,18,542,350,54,73,6,4,83
10/10/16,2,19,715,360,153,2,3,1,6
10/10/16,2,20,8032,350,91,31,15,4,50
10/10/16,2,21,542,350,78,16,21,0,37
10/10/16,2,22,774,350,108,8,16,1,25
10/10/16,2,23,542,350,119,21,6,1,28
10/10/16,2,25,542,375,91,20,14,1,35
10/10/16,2,26,542,360,116,28,3,0,31
10/10/16,2,28,7675,375,54,13,4,5,22
10/10/16,3,1,726,305,94,5,20,1,26
10/10/16,3,2,996,315,93,19,23,5,47
10/10/16,3,3,996,300,48,28,30,8,66
10/10/16,3,4,5302,300,88,33,3,9,45
10/10/16,3,5,8035,400,132,21,2,3,26
10/10/16,3,6,542,370,126,29,5,2,36
10/10/16,3,7,7724,345,124,32,9,5,46
10/10/16,3,8,785,350,165,0,0,1,1
10/10/16,3,9,542,350,67,25,0,2,27
10/10/16,3,10,774,380,113,21,18,2,41
10/10/16,3,11,7652,355,111,36,13,2,51
10/10/16,3,14,8030,360,11,0,23,6,29
10/10/16,3,15,785,350,146,2,6,0,8
10/10/16,3,16,8040,350,76,22,6,1,29
10/10/16,3,17,775,370,90,22,12,1,35
10/10/16,3,18,542,350,39,64,4,0,68
10/10/16,3,19,715,360,144,0,10,0,10
10/10/16,3,20,8032,350,57,31,18,1,50
10/10/16,3,21,542,350,76,13,13,0,26
10/10/16,3,22,774,350,103,12,13,0,25
10/10/16,3,23,542,350,50,39,1,0,40
10/10/16,3,25,542,375,104,18,8,0,26
10/10/16,3,26,542,360,78,22,4,0,26
10/10/16,3,27,542,360,68,21,2,0,23
10/11/16,1,1,726,305,94,6,14,3,23
10/11/16,1,2,996,315,95,8,16,4,28
10/11/16,1,3,996,300,53,25,22,3,50
10/11/16,1,4,5302,300,76,27,2,7,36
10/11/16,1,5,3062,400,120,21,4,2,27
10/11/16,1,6,542,370,107,21,10,4,35
10/11/16,1,7,783,345,110,31,6,1,38
10/11/16,1,8,785,350,158,1,0,2,3
10/11/16,1,9,542,350,63,20,7,2,29
10/11/16,1,10,774,380,102,16,13,4,33
10/11/16,1,11,7652,355,83,30,15,4,49
10/11/16,1,12,7652,350,13,5,9,13,27
10/11/16,1,14,8030,360,68,1,7,3,11
10/11/16,1,15,785,350,154,2,2,0,4
10/11/16,1,16,8040,350,92,32,13,2,47
10/11/16,1,17,775,370,90,15,19,2,36
10/11/16,1,18,542,350,64,73,9,0,82
10/11/16,1,19,715,360,142,2,12,0,14
10/11/16,1,20,8032,350,72,22,19,2,43
10/11/16,1,21,542,350,79,16,17,1,34
10/11/16,1,22,774,350,122,10,16,1,27
10/11/16,1,23,542,350,113,29,10,1,40
10/11/16,1,25,542,375,80,22,15,1,38
10/11/16,1,26,542,360,73,25,3,1,29
10/11/16,1,27,542,360,105,26,4,1,31
10/11/16,2,1,726,305,80,16,4,0,20
10/11/16,2,2,996,315,68,5,18,5,28
10/11/16,2,3,996,300,47,23,21,6,50
10/11/16,2,4,5302,300,82,19,2,4,25
10/11/16,2,5,3062,400,134,5,7,1,13
10/11/16,2,6,542,370,103,19,6,1,26
10/11/16,2,7,783,345,110,17,13,1,31
10/11/16,2,8,785,350,165,0,0,1,1
10/11/16,2,9,542,350,108,15,8,1,24
10/11/16,2,10,774,380,72,15,26,2,43
10/11/16,2,11,7652,355,94,19,13,0,32
10/11/16,2,12,7652,350,72,24,19,8,51
10/11/16,2,13,7601,400,19,1,5,1,7
10/11/16,2,14,8030,360,163,1,2,1,4
10/11/16,2,15,785,350,165,1,0,1,2
10/11/16,2,16,8040,350,103,18,10,1,29
10/11/16,2,17,775,370,104,27,7,4,38
10/11/16,2,18,542,350,54,59,8,0,67
10/11/16,2,19,715,360,152,3,4,1,8
10/11/16,2,20,8032,350,81,28,17,2,47
10/11/16,2,21,542,350,86,20,9,1,30
10/11/16,2,22,774,350,58,7,7,1,15
10/11/16,2,23,542,350,89,30,7,1,38
10/11/16,2,25,542,375,81,21,14,1,36
10/11/16,2,26,542,360,70,25,6,0,31
10/11/16,2,27,542,360,114,24,5,1,30
10/11/16,3,1,726,305,67,20,10,1,31
10/11/16,3,2,996,315,40,5,10,2,17
10/11/16,3,3,996,300,63,20,19,7,46
10/11/16,3,4,5302,300,77,25,3,10,38
10/11/16,3,5,8035,400,139,13,6,2,21
10/11/16,3,6,542,370,122,30,5,1,36
10/11/16,3,7,7724,345,110,25,19,2,46
10/11/16,3,8,785,350,162,2,0,1,3
10/11/16,3,9,542,350,91,26,21,3,50
10/11/16,3,10,774,380,117,21,23,2,46
10/11/16,3,11,7652,355,94,25,20,1,46
10/11/16,3,12,7652,350,62,12,27,11,50
10/11/16,3,13,7601,400,113,8,12,1,21
10/11/16,3,14,8030,360,144,0,8,1,9
10/11/16,3,15,785,350,163,0,1,0,1
10/11/16,3,16,8040,350,72,15,7,6,28
10/11/16,3,17,775,370,81,32,4,3,39
10/11/16,3,18,542,350,50,38,2,0,40
10/11/16,3,19,715,360,129,1,13,0,14
10/11/16,3,20,8032,350,37,14,6,1,21
10/11/16,3,21,542,350,93,13,14,0,27
10/11/16,3,22,774,350,103,12,13,0,25
10/11/16,3,23,542,350,73,35,6,0,41
10/11/16,3,25,542,375,40,10,7,0,17
10/11/16,3,26,542,360,11,4,5,0,9
10/11/16,3,27,542,360,87,19,4,0,23
10/10/16,1,1,726,305,103,14,9,0,23
10/10/16,1,2,996,315,10,6,3,6,15
10/10/16,1,3,996,300,49,26,27,3,56
10/10/16,1,4,5302,300,71,33,4,4,41
10/10/16,1,6,542,370,110,29,9,7,45
10/10/16,1,7,783,345,112,33,7,2,42
10/10/16,1,8,785,350,150,0,4,2,6
10/10/16,1,9,542,350,100,35,6,1,42
10/10/16,1,10,774,380,64,4,19,8,31
10/10/16,1,11,7652,355,91,36,10,0,46
10/10/16,1,14,8030,360,116,1,12,0,13
10/10/16,1,15,785,350,142,0,4,0,4
10/10/16,1,16,8040,350,100,20,7,2,29
10/10/16,1,17,542,370,65,17,17,3,37
10/10/16,1,18,542,350,38,102,8,0,110
10/10/16,1,19,715,360,161,3,3,1,7
10/10/16,1,20,8032,350,57,58,8,2,68
10/10/16,1,21,542,350,24,12,3,1,16
10/10/16,1,22,774,350,101,8,18,0,26
10/10/16,1,23,542,350,129,16,6,1,23
10/10/16,1,25,542,375,90,20,15,1,36
10/10/16,1,26,542,360,76,29,4,1,34
10/10/16,1,28,7675,375,65,13,1,2,16
10/10/16,2,1,726,305,90,16,13,2,31
10/10/16,2,2,996,315,81,15,12,6,33
10/10/16,2,3,996,300,47,24,22,3,49
10/10/16,2,4,5302,300,35,12,1,5,18
10/10/16,2,5,3062,400,76,12,4,16,32
10/10/16,2,6,542,370,99,24,4,4,32
10/10/16,2,7,783,345,87,28,9,2,39
10/10/16,2,8,785,350,145,0,0,2,2
10/10/16,2,9,542,350,89,32,6,2,40
10/10/16,2,10,774,380,101,17,22,2,41
10/10/16,2,11,7652,355,94,35,13,2,50
10/10/16,2,14,8030,360,42,3,27,1,31
10/10/16,2,15,785,350,163,1,1,1,3
10/10/16,2,16,8040,350,53,25,9,2,36
10/10/16,2,17,542,370,117,20,12,1,33
10/10/16,2,18,542,350,54,73,6,4,83
10/10/16,2,19,715,360,153,2,3,1,6
10/10/16,2,20,8032,350,91,31,15,4,50
10/10/16,2,21,542,350,78,16,21,0,37
10/10/16,2,22,774,350,108,8,16,1,25
10/10/16,2,23,542,350,119,21,6,1,28
10/10/16,2,25,542,375,91,20,14,1,35
10/10/16,2,26,542,360,116,28,3,0,31
10/10/16,2,28,7675,375,54,13,4,5,22
10/10/16,3,1,726,305,94,5,20,1,26
10/10/16,3,2,996,315,93,19,23,5,47
10/10/16,3,3,996,300,48,28,30,8,66
10/10/16,3,4,5302,300,88,33,3,9,45
10/10/16,3,5,8035,400,132,21,2,3,26
10/10/16,3,6,542,370,126,29,5,2,36
10/10/16,3,7,7724,345,124,32,9,5,46
10/10/16,3,8,785,350,165,0,0,1,1
10/10/16,3,9,542,350,67,25,0,2,27
10/10/16,3,10,774,380,113,21,18,2,41
10/10/16,3,11,7652,355,111,36,13,2,51
10/10/16,3,14,8030,360,11,0,23,6,29
10/10/16,3,15,785,350,146,2,6,0,8
10/10/16,3,16,8040,350,76,22,6,1,29
10/10/16,3,17,775,370,90,22,12,1,35
10/10/16,3,18,542,350,39,64,4,0,68
10/10/16,3,19,715,360,144,0,10,0,10
10/10/16,3,20,8032,350,57,31,18,1,50
10/10/16,3,21,542,350,76,13,13,0,26
10/10/16,3,22,774,350,103,12,13,0,25
10/10/16,3,23,542,350,50,39,1,0,40
10/10/16,3,25,542,375,104,18,8,0,26
10/10/16,3,26,542,360,78,22,4,0,26
10/10/16,3,27,542,360,68,21,2,0,23
10/11/16,1,1,726,305,94,6,14,3,23
10/11/16,1,2,996,315,95,8,16,4,28
10/11/16,1,3,996,300,53,25,22,3,50
10/11/16,1,4,5302,300,76,27,2,7,36
10/11/16,1,5,3062,400,120,21,4,2,27
10/11/16,1,6,542,370,107,21,10,4,35
10/11/16,1,7,783,345,110,31,6,1,38
10/11/16,1,8,785,350,158,1,0,2,3
10/11/16,1,9,542,350,63,20,7,2,29
10/11/16,1,10,774,380,102,16,13,4,33
10/11/16,1,11,7652,355,83,30,15,4,49
10/11/16,1,12,7652,350,13,5,9,13,27
10/11/16,1,14,8030,360,68,1,7,3,11
10/11/16,1,15,785,350,154,2,2,0,4
10/11/16,1,16,8040,350,92,32,13,2,47
10/11/16,1,17,775,370,90,15,19,2,36
10/11/16,1,18,542,350,64,73,9,0,82
10/11/16,1,19,715,360,142,2,12,0,14
10/11/16,1,20,8032,350,72,22,19,2,43
10/11/16,1,21,542,350,79,16,17,1,34
10/11/16,1,22,774,350,122,10,16,1,27
10/11/16,1,23,542,350,113,29,10,1,40
10/11/16,1,25,542,375,80,22,15,1,38
10/11/16,1,26,542,360,73,25,3,1,29
10/11/16,1,27,542,360,105,26,4,1,31
10/11/16,2,1,726,305,80,16,4,0,20
10/11/16,2,2,996,315,68,5,18,5,28
10/11/16,2,3,996,300,47,23,21,6,50
10/11/16,2,4,5302,300,82,19,2,4,25
10/11/16,2,5,3062,400,134,5,7,1,13
10/11/16,2,6,542,370,103,19,6,1,26
10/11/16,2,7,783,345,110,17,13,1,31
10/11/16,2,8,785,350,165,0,0,1,1
10/11/16,2,9,542,350,108,15,8,1,24
10/11/16,2,10,774,380,72,15,26,2,43
10/11/16,2,11,7652,355,94,19,13,0,32
10/11/16,2,12,7652,350,72,24,19,8,51
10/11/16,2,13,7601,400,19,1,5,1,7
10/11/16,2,14,8030,360,163,1,2,1,4
10/11/16,2,15,785,350,165,1,0,1,2
10/11/16,2,16,8040,350,103,18,10,1,29
10/11/16,2,17,775,370,104,27,7,4,38
10/11/16,2,18,542,350,54,59,8,0,67
10/11/16,2,19,715,360,152,3,4,1,8
10/11/16,2,20,8032,350,81,28,17,2,47
10/11/16,2,21,542,350,86,20,9,1,30
10/11/16,2,22,774,350,58,7,7,1,15
10/11/16,2,23,542,350,89,30,7,1,38
10/11/16,2,25,542,375,81,21,14,1,36
10/11/16,2,26,542,360,70,25,6,0,31
10/11/16,2,27,542,360,114,24,5,1,30
10/11/16,3,1,726,305,67,20,10,1,31
10/11/16,3,2,996,315,40,5,10,2,17
10/11/16,3,3,996,300,63,20,19,7,46
10/11/16,3,4,5302,300,77,25,3,10,38
10/11/16,3,5,8035,400,139,13,6,2,21
10/11/16,3,6,542,370,122,30,5,1,36
10/11/16,3,7,7724,345,110,25,19,2,46
10/11/16,3,8,785,350,162,2,0,1,3
10/11/16,3,9,542,350,91,26,21,3,50
10/11/16,3,10,774,380,117,21,23,2,46
10/11/16,3,11,7652,355,94,25,20,1,46
10/11/16,3,12,7652,350,62,12,27,11,50
10/11/16,3,13,7601,400,113,8,12,1,21
10/11/16,3,14,8030,360,144,0,8,1,9
10/11/16,3,15,785,350,163,0,1,0,1
10/11/16,3,16,8040,350,72,15,7,6,28
10/11/16,3,17,775,370,81,32,4,3,39
10/11/16,3,18,542,350,50,38,2,0,40
10/11/16,3,19,715,360,129,1,13,0,14
10/11/16,3,20,8032,350,37,14,6,1,21
10/11/16,3,21,542,350,93,13,14,0,27
10/11/16,3,22,774,350,103,12,13,0,25
10/11/16,3,23,542,350,73,35,6,0,41
10/11/16,3,25,542,375,40,10,7,0,17
10/11/16,3,26,542,360,11,4,5,0,9
10/11/16,3,27,542,360,87,19,4,0,23
10/12/16,1,1,726,305,70,42,12,6,60
10/12/16,1,3,996,300,63,24,16,5,45
10/12/16,1,4,5302,300,79,27,3,10,40
10/12/16,1,5,3062,400,138,14,5,3,22
10/12/16,1,6,542,370,118,28,2,1,31
10/12/16,1,8,785,350,152,1,4,1,6
10/12/16,1,9,542,350,110,40,9,1,50
10/12/16,1,10,774,380,121,23,15,1,39
10/12/16,1,11,7652,355,93,28,18,1,47
10/12/16,1,12,7652,350,93,31,15,0,46
10/12/16,1,13,7601,400,141,16,10,2,28
10/12/16,1,14,8030,360,159,0,1,2,3
10/12/16,1,15,785,350,150,2,3,0,5
10/12/16,1,16,8040,350,101,24,9,4,37
10/12/16,1,17,775,370,114,33,17,3,53
10/12/16,1,18,542,350,97,76,13,0,89
10/12/16,1,19,715,360,151,4,7,1,12
10/12/16,1,21,542,350,78,20,17,1,38
10/12/16,1,23,542,350,134,22,4,2,28
10/12/16,1,27,542,360,113,14,6,1,21
10/12/16,2,1,726,305,91,10,19,1,30
10/12/16,2,3,996,300,41,21,21,3,45
10/12/16,2,4,5302,300,46,18,1,7,26
10/12/16,2,5,3062,400,127,7,5,2,14
10/12/16,2,6,542,370,93,38,5,2,45
10/12/16,2,9,542,350,98,29,6,1,36
10/12/16,2,10,774,380,119,28,5,2,35
10/12/16,2,11,7652,355,99,39,11,0,50
10/12/16,2,12,7652,350,114,12,24,0,36
10/12/16,2,13,7601,400,129,6,6,1,13
10/12/16,2,14,8030,360,157,1,3,1,5
10/12/16,2,15,785,350,41,3,1,0,4
10/12/16,2,16,8040,350,79,17,18,3,38
10/12/16,2,17,775,370,126,24,10,2,36
10/12/16,2,18,542,350,89,70,13,0,83
10/12/16,2,19,715,360,154,4,11,0,15
10/12/16,2,21,542,350,102,22,7,1,30
10/12/16,2,23,542,350,103,29,6,1,36
10/12/16,2,26,542,360,35,28,1,0,29
10/12/16,2,27,542,360,127,16,5,1,22
10/12/16,3,1,726,305,97,12,13,2,27
10/12/16,3,3,996,300,58,28,25,5,58
10/12/16,3,4,5302,300,97,24,0,7,31
10/12/16,3,5,8035,400,136,20,3,2,25
10/12/16,3,6,542,370,123,32,3,6,41
10/12/16,3,9,542,350,87,40,12,0,52
10/12/16,3,10,774,380,107,47,18,1,66
10/12/16,3,11,7652,355,86,39,13,4,56
10/12/16,3,12,7652,350,95,17,30,0,47
10/12/16,3,13,7601,400,131,9,9,2,20
10/12/16,3,14,8030,360,161,1,5,2,8
10/12/16,3,16,8040,350,82,21,16,7,44
10/12/16,3,17,775,370,86,43,8,1,52
10/12/16,3,18,542,350,58,37,8,0,45
10/12/16,3,19,715,360,149,2,4,0,6
10/12/16,3,21,542,350,83,14,7,0,21
10/12/16,3,23,542,350,92,19,5,0,24
10/12/16,3,25,542,375,23,14,2,0,16
10/12/16,3,26,542,360,35,28,1,0,29
10/12/16,3,27,542,360,103,19,4,0,23
10/13/16,1,3,996,300,73,17,26,5,48
10/13/16,1,4,5302,300,77,45,1,2,48
10/13/16,1,5,3062,400,143,12,7,2,21
10/13/16,1,6,542,370,130,24,9,1,34
10/13/16,1,9,542,350,104,46,5,3,54
10/13/16,1,11,7652,355,88,32,22,2,56
10/13/16,1,12,7652,350,119,18,12,0,30
10/13/16,1,13,7601,400,144,10,7,2,19
10/13/16,1,14,8030,360,146,1,6,0,7
10/13/16,1,17,542,370,76,25,20,3,48
10/13/16,1,18,542,350,91,50,9,2,61
10/13/16,1,19,715,360,167,1,6,1,8
10/13/16,1,20,8032,350,32,14,8,2,24
10/13/16,1,21,542,350,86,25,12,1,38
10/13/16,1,23,542,350,117,39,6,2,47
10/13/16,1,25,542,375,90,22,11,1,34
10/13/16,1,26,542,360,55,41,6,1,48
10/13/16,1,27,542,360,124,24,2,2,28
10/13/16,2,3,996,300,61,15,26,4,45
10/13/16,2,4,5302,300,57,30,0,5,35
10/13/16,2,5,3062,400,125,11,3,7,21
10/13/16,2,6,542,370,68,22,15,1,38
10/13/16,2,9,542,350,103,23,10,2,35
10/13/16,2,11,7652,355,116,15,21,0,36
10/13/16,2,12,7652,350,118,17,17,1,35
10/13/16,2,13,7601,400,137,7,12,2,21
10/13/16,2,14,8030,360,128,1,23,1,25
10/13/16,2,17,542,370,92,30,13,1,44
10/13/16,2,18,542,350,98,37,16,0,53
10/13/16,2,19,715,360,165,2,2,0,4
10/13/16,2,20,8032,350,108,27,9,2,38
10/13/16,2,21,542,350,96,16,11,1,28
10/13/16,2,23,542,350,64,41,7,0,48
10/13/16,2,25,542,375,90,23,10,1,34
10/13/16,2,26,542,360,54,48,4,0,52
10/13/16,2,27,542,360,140,16,0,1,17
10/13/16,3,3,996,300,49,13,38,14,65
10/13/16,3,4,5302,300,92,33,2,10,45
10/13/16,3,5,3062,400,145,4,6,2,12
10/13/16,3,9,542,350,111,32,11,3,46
10/13/16,3,11,7652,355,122,19,22,1,42
10/13/16,3,12,7652,350,110,30,22,3,55
10/13/16,3,13,7601,400,105,12,20,7,39
10/13/16,3,14,8030,360,125,0,4,7,11
10/13/16,3,15,309,350,12,5,9,0,14
10/13/16,3,17,542,370,89,20,6,1,27
10/13/16,3,18,542,350,63,39,8,1,48
10/13/16,3,19,715,360,125,4,8,0,12
10/13/16,3,20,8032,350,103,11,10,1,22
10/13/16,3,21,542,350,82,14,14,0,28
10/13/16,3,23,542,350,103,16,6,0,22
10/13/16,3,25,542,375,56,27,5,0,32
10/13/16,3,26,542,360,67,27,6,0,33
10/13/16,3,27,542,360,93,20,2,0,22
10/14/16,1,2,738,315,47,7,8,21,36
10/14/16,1,4,5302,300,82,44,0,1,45
10/14/16,1,5,3062,400,145,5,9,3,17
10/14/16,1,6,542,370,121,20,10,5,35
10/14/16,1,9,542,350,113,33,15,3,51
10/14/16,1,11,7652,355,131,22,13,2,37
10/14/16,1,12,7652,350,115,44,21,2,67
10/14/16,1,13,7601,400,101,16,14,6,36
10/14/16,1,14,8030,360,162,2,4,1,7
10/14/16,1,15,309,350,71,25,8,0,33
10/14/16,1,17,542,370,111,44,7,3,54
10/14/16,1,18,542,350,104,45,16,0,61
10/14/16,1,20,8032,350,94,14,10,3,27
10/14/16,1,21,542,350,89,19,11,1,31
10/14/16,1,23,542,350,136,22,6,1,29
10/14/16,1,25,542,375,88,25,9,1,35
10/14/16,1,26,542,360,74,42,3,1,46
10/14/16,1,27,542,360,132,23,2,1,26
10/14/16,2,2,738,315,111,8,10,3,21
10/14/16,2,4,5302,300,73,46,0,4,50
10/14/16,2,5,3062,400,155,5,5,2,12
10/14/16,2,6,542,370,136,22,11,2,35
10/14/16,2,9,542,350,124,24,16,2,42
10/14/16,2,11,7652,355,117,26,21,0,47
10/14/16,2,12,7652,350,116,26,10,4,40
10/14/16,2,13,7601,400,131,9,7,2,18
10/14/16,2,14,8030,360,158,3,1,0,4
10/14/16,2,15,309,350,62,23,7,1,31
10/14/16,2,17,542,370,107,41,6,1,48
10/14/16,2,18,542,350,82,50,8,0,58
10/14/16,2,20,8032,350,111,29,14,4,47
10/14/16,2,21,542,350,99,14,8,1,23
10/14/16,2,23,542,350,110,23,4,0,27
10/14/16,2,25,542,375,87,26,9,1,36
10/14/16,2,26,542,360,63,35,10,0,45
10/14/16,2,27,542,360,99,31,3,1,35
10/14/16,3,2,738,315,89,11,16,3,30
10/14/16,3,4,5302,300,63,48,3,4,55
10/14/16,3,5,3062,400,99,20,9,5,34
10/14/16,3,6,542,370,123,7,11,2,20
10/14/16,3,9,542,350,74,42,4,1,47
10/14/16,3,11,7652,355,66,43,13,0,56
10/14/16,3,12,7652,350,88,16,14,1,31
10/14/16,3,13,7601,400,100,10,2,0,12
10/14/16,3,14,8030,360,52,1,1,0,2
10/14/16,3,15,309,140,20,10,3,1,14
10/14/16,3,17,542,370,45,14,2,0,16
10/14/16,3,18,542,350,32,27,4,0,31
10/14/16,3,20,8032,350,48,15,8,0,23
10/14/16,3,21,542,350,35,7,4,1,12
10/14/16,3,23,542,350,52,10,2,0,12
10/14/16,3,25,542,375,23,18,4,0,22
10/14/16,3,26,542,17,12,15,5,0,20
10/14/16,3,27,542,360,47,15,0,1,16
10/17/16,1,2,738,315,87,8,17,5,30
10/17/16,1,3,996,300,71,13,6,11,30
10/17/16,1,4,5302,300,75,31,0,4,35
10/17/16,1,5,3062,400,138,14,5,2,21
10/17/16,1,6,542,370,132,17,10,3,30
10/17/16,1,7,8040,345,59,13,13,7,33
10/17/16,1,9,542,350,26,6,1,1,8
10/17/16,1,12,7652,350,123,20,17,2,39
10/17/16,1,13,7601,400,140,4,7,1,12
10/17/16,1,14,8030,360,142,5,2,3,10
10/17/16,1,15,309,350,73,12,19,0,31
10/17/16,1,16,8040,350,89,12,19,3,34
10/17/16,1,17,542,370,65,27,16,2,45
10/17/16,1,18,542,350,84,46,16,0,62
10/17/16,1,19,715,360,131,1,8,0,9
10/17/16,1,20,8032,350,118,16,9,2,27
10/17/16,1,21,542,350,73,18,9,1,28
10/17/16,1,23,542,350,133,20,4,1,25
10/17/16,1,25,542,375,70,19,10,1,30
10/17/16,1,26,542,360,82,33,6,1,40
10/17/16,1,27,542,360,129,19,6,0,25
10/17/16,2,2,738,315,102,10,16,3,29
10/17/16,2,3,996,300,85,9,11,20,40
10/17/16,2,4,5302,300,100,31,0,4,35
10/17/16,2,5,3062,400,42,3,6,6,15
10/17/16,2,6,542,370,109,28,11,3,42
10/17/16,2,7,8040,345,108,16,28,2,46
10/17/16,2,12,7652,350,111,25,19,0,44
10/17/16,2,13,7601,400,130,9,9,2,20
10/17/16,2,14,8030,360,153,1,2,2,5
10/17/16,2,15,309,350,105,10,13,1,24
10/17/16,2,16,8040,350,103,19,17,1,37
10/17/16,2,17,542,370,89,33,8,3,44
10/17/16,2,18,542,350,80,44,4,1,49
10/17/16,2,19,715,360,160,1,5,1,7
10/17/16,2,20,8032,350,98,18,18,5,41
10/17/16,2,21,542,350,97,11,9,1,21
10/17/16,2,23,542,350,98,22,3,1,26
10/17/16,2,24,1001,360,86,6,0,11,17
10/17/16,2,25,542,375,71,20,9,1,30
10/17/16,2,26,542,360,63,30,4,1,35
10/17/16,2,27,542,360,126,14,2,1,17
10/17/16,3,2,738,315,92,14,18,1,33
10/17/16,3,3,996,300,48,7,20,14,41
10/17/16,3,4,5302,300,86,30,1,4,35
10/17/16,3,5,3062,400,116,16,3,1,20
10/17/16,3,6,542,370,94,36,13,1,50
10/17/16,3,7,7724,345,98,16,15,2,33
10/17/16,3,12,7652,350,98,8,10,1,19
10/17/16,3,13,7601,400,81,10,6,2,18
10/17/16,3,14,8030,360,152,2,4,1,7
10/17/16,3,15,309,350,45,1,10,1,12
10/17/16,3,16,8040,350,41,5,5,1,11
10/17/16,3,17,542,370,16,1,4,2,7
10/17/16,3,18,542,350,29,17,2,2,21
10/17/16,3,19,715,360,58,0,4,0,4
10/17/16,3,20,8032,350,40,5,10,1,16
10/17/16,3,21,542,350,41,5,5,0,10
10/17/16,3,23,542,350,50,6,0,0,6
10/17/16,3,24,1001,360,62,5,0,4,9
10/17/16,3,25,542,375,13,5,1,0,6
10/17/16,3,26,542,360,25,7,1,0,8
10/17/16,3,27,542,360,38,8,0,0,8
10/18/16,1,1,726,305,15,4,0,10,14
10/18/16,1,2,738,315,117,12,3,2,17
10/18/16,1,3,996,300,101,21,3,16,40
10/18/16,1,4,5302,300,102,28,2,6,36
10/18/16,1,5,3062,400,127,22,8,2,32
10/18/16,1,6,542,370,130,34,9,2,45
10/18/16,1,7,8040,345,127,21,18,2,41
10/18/16,1,9,542,350,10,7,0,0,7
10/18/16,1,11,7652,355,39,8,6,2,16
10/18/16,1,12,7652,350,106,28,18,0,46
10/18/16,1,13,7601,400,63,7,3,2,12
10/18/16,1,14,8030,360,162,0,4,2,6
10/18/16,1,15,309,350,114,9,16,1,26
10/18/16,1,16,8040,350,130,11,15,7,33
10/18/16,1,18,542,350,105,42,13,3,58
10/18/16,1,19,715,360,160,1,7,1,9
10/18/16,1,20,8032,350,102,22,18,6,46
10/18/16,1,22,715,350,59,1,12,0,13
10/18/16,1,23,542,350,123,35,9,2,46
10/18/16,1,24,1001,360,138,9,5,4,18
10/18/16,1,25,542,375,71,15,9,1,25
10/18/16,1,26,542,360,89,40,7,1,48
10/18/16,2,1,726,305,7,1,2,0,3
10/18/16,2,2,738,315,96,5,16,0,21
10/18/16,2,3,996,300,85,7,14,13,34
10/18/16,2,4,5302,300,76,22,2,3,27
10/18/16,2,5,3062,400,150,1,5,2,8
10/18/16,2,6,542,370,120,25,132,4,161
10/18/16,2,7,8040,345,88,23,19,1,43
10/18/16,2,9,542,350,91,26,9,2,37
10/18/16,2,11,7652,355,130,9,10,1,20
10/18/16,2,12,7652,350,114,9,17,0,26
10/18/16,2,13,7601,400,110,9,3,5,17
10/18/16,2,14,8030,360,34,0,12,1,13
10/18/16,2,15,309,350,99,6,22,0,28
10/18/16,2,16,8040,350,113,8,13,2,23
10/18/16,2,18,542,350,65,27,11,1,39
10/18/16,2,19,715,360,166,3,5,1,9
10/18/16,2,20,8032,350,85,29,17,3,49
10/18/16,2,21,542,350,6,3,0,0,3
10/18/16,2,22,715,350,89,1,18,0,19
10/18/16,2,23,542,350,110,14,4,1,19
10/18/16,2,24,1001,360,128,13,3,8,24
10/18/16,2,25,542,375,72,16,8,1,25
10/18/16,2,26,542,360,74,35,3,0,38
10/18/16,3,2,738,315,80,11,13,0,24
10/18/16,3,3,996,300,54,3,5,5,13
10/18/16,3,4,5302,300,30,1,0,0,1
10/18/16,3,5,3062,400,141,6,10,1,17
10/18/16,3,6,542,370,132,15,5,1,21
10/18/16,3,7,7724,345,83,20,11,3,34
10/18/16,3,9,542,350,89,20,19,0,39
10/18/16,3,10,8030,380,32,9,21,13,43
10/18/16,3,11,7652,355,106,13,15,0,28
10/18/16,3,12,7652,350,13,3,1,0,4
10/18/16,3,13,7601,400,93,18,9,2,29
10/18/16,3,15,309,350,74,7,11,0,18
10/18/16,3,16,8040,350,76,5,12,2,19
10/18/16,3,18,542,350,52,12,6,2,20
10/18/16,3,19,715,360,130,1,7,0,8
10/18/16,3,20,8032,350,51,11,11,3,25
10/18/16,3,21,542,350,20,18,2,0,20
10/18/16,3,22,715,350,67,0,9,0,9
10/18/16,3,23,542,350,51,15,2,0,17
10/18/16,3,24,1001,360,50,3,4,3,10
10/18/16,3,25,542,375,54,16,2,0,18
10/18/16,3,26,542,360,49,21,2,0,23
10/19/16,1,1,726,305,34,3,5,8,16
10/19/16,1,2,738,315,108,3,14,0,17
10/19/16,1,3,996,300,41,3,6,9,18
10/19/16,1,4,5302,300,91,23,1,3,27
10/19/16,1,5,3062,400,138,9,7,2,18
10/19/16,1,6,542,370,126,4,5,0,9
10/19/16,1,7,8040,345,109,26,18,2,46
10/19/16,1,9,542,350,103,31,19,2,52
10/19/16,1,10,8030,380,113,2,13,0,15
10/19/16,1,11,7652,355,137,19,11,0,30
10/19/16,1,13,7601,400,166,15,6,2,23
10/19/16,1,14,8030,360,95,1,3,7,11
10/19/16,1,15,309,350,106,14,18,1,33
10/19/16,1,16,8040,350,114,16,22,3,41
10/19/16,1,18,542,350,101,47,20,1,68
10/19/16,1,19,715,360,162,1,5,0,6
10/19/16,1,20,8032,350,106,30,15,6,51
10/19/16,1,21,542,350,87,31,6,1,38
10/19/16,1,22,715,350,111,0,24,0,24
10/19/16,1,23,542,350,138,19,7,1,27
10/19/16,1,25,542,375,65,20,8,1,29
10/19/16,1,26,542,360,110,46,1,1,48
10/19/16,2,3,996,300,22,9,3,3,15
10/19/16,2,4,5302,300,59,15,1,8,24
10/19/16,2,5,3062,400,126,5,9,2,16
10/19/16,2,6,542,370,134,14,8,2,24
10/19/16,2,7,8040,345,105,18,14,3,35
10/19/16,2,9,542,350,77,36,5,2,43
10/19/16,2,10,8030,380,163,5,9,1,15
10/19/16,2,11,7652,355,145,11,11,1,23
10/19/16,2,12,7652,350,126,14,18,1,33
10/19/16,2,13,7601,400,52,4,5,0,9
10/19/16,2,14,8030,360,130,1,5,1,7
10/19/16,2,15,309,350,94,8,20,0,28
10/19/16,2,16,8040,350,118,15,23,3,41
10/19/16,2,17,542,370,69,21,13,3,37
10/19/16,2,18,542,350,59,28,12,1,41
10/19/16,2,19,715,360,158,2,6,1,9
10/19/16,2,20,8032,350,109,25,14,4,43
10/19/16,2,21,542,350,88,16,9,0,25
10/19/16,2,22,715,350,80,0,17,1,18
10/19/16,2,23,542,350,85,22,7,1,30
10/19/16,2,25,542,375,81,15,5,1,21
10/19/16,2,26,542,360,73,33,1,1,35
10/19/16,3,2,738,315,13,3,9,3,15
10/19/16,3,3,996,300,95,20,11,13,44
10/19/16,3,4,5302,300,93,38,0,7,45
10/19/16,3,5,3062,400,137,13,7,2,22
10/19/16,3,6,542,370,134,23,14,2,39
10/19/16,3,7,7724,345,130,21,14,5,40
10/19/16,3,9,542,350,89,76,5,2,83
10/19/16,3,11,7652,355,126,20,16,0,36
10/19/16,3,12,7652,350,2,1,8,0,9
10/19/16,3,14,8030,360,160,2,8,1,11
10/19/16,3,15,309,350,75,9,21,0,30
10/19/16,3,16,8040,350,97,18,9,3,30
10/19/16,3,17,542,370,56,35,5,1,41
10/19/16,3,18,542,350,73,38,9,0,47
10/19/16,3,19,715,360,155,1,5,0,6
10/19/16,3,20,8032,350,80,22,11,2,35
10/19/16,3,21,542,350,93,20,5,0,25
10/19/16,3,22,715,350,97,1,22,0,23
10/19/16,3,25,542,375,81,24,2,0,26
10/19/16,3,26,542,360,68,27,2,0,29
10/19/16,3,27,542,360,42,11,2,0,13
10/20/16,1,2,738,315,102,11,15,0,26
10/20/16,1,3,996,300,62,10,14,15,39
10/20/16,1,4,5302,300,68,44,0,3,47
10/20/16,1,5,3062,400,147,11,7,2,20
10/20/16,1,6,542,370,113,13,13,1,27
10/20/16,1,7,8040,345,122,16,16,2,34
10/20/16,1,8,785,350,81,11,8,1,20
10/20/16,1,9,542,350,97,60,10,5,75
10/20/16,1,11,7652,355,112,20,14,1,35
10/20/16,1,14,8030,360,162,2,3,1,6
10/20/16,1,15,309,350,71,20,13,0,33
10/20/16,1,16,8040,350,101,24,13,2,39
10/20/16,1,17,542,370,110,49,7,1,57
10/20/16,1,18,542,350,88,46,17,1,64
10/20/16,1,19,715,360,169,0,2,1,3
10/20/16,1,20,8032,350,110,22,9,2,33
10/20/16,1,21,542,350,117,20,4,1,25
10/20/16,1,22,715,350,105,0,23,1,24
10/20/16,1,25,542,375,108,14,7,0,21
10/20/16,1,26,542,360,87,37,11,0,48
10/20/16,1,27,542,360,74,28,5,0,33
10/20/16,2,2,738,315,102,8,14,1,23
10/20/16,2,3,996,300,91,23,7,6,36
10/20/16,2,4,5302,300,72,51,0,0,51
10/20/16,2,5,3062,400,131,12,4,4,20
10/20/16,2,6,542,370,75,5,12,0,17
10/20/16,2,7,8040,345,117,20,24,2,46
10/20/16,2,8,785,350,130,5,4,1,10
10/20/16,2,9,542,350,55,40,11,1,52
10/20/16,2,11,7652,355,135,18,8,3,29
10/20/16,2,14,8030,360,161,3,1,2,6
10/20/16,2,15,309,350,72,6,20,1,27
10/20/16,2,16,8040,350,106,22,16,2,40
10/20/16,2,17,542,370,92,40,3,1,44
10/20/16,2,18,542,350,60,47,8,0,55
10/20/16,2,19,715,360,162,3,4,1,8
10/20/16,2,20,8032,350,103,24,11,1,36
10/20/16,2,21,542,350,135,11,4,2,17
10/20/16,2,22,715,350,69,0,16,0,16
10/20/16,2,23,542,350,80,8,14,0,22
10/20/16,2,25,542,375,90,24,3,0,27
10/20/16,2,26,542,360,60,35,3,1,39
10/20/16,2,27,542,360,55,19,1,0,20
10/20/16,3,2,738,315,103,15,19,0,34
10/20/16,3,3,996,300,85,15,21,15,51
10/20/16,3,4,5302,300,82,41,1,12,54
10/20/16,3,5,3062,400,134,19,15,1,35
10/20/16,3,7,8040,345,129,10,27,2,39
10/20/16,3,8,785,350,150,1,6,1,8
10/20/16,3,10,8030,380,142,5,22,3,30
10/20/16,3,11,7652,355,135,17,15,0,32
10/20/16,3,12,7652,350,55,22,12,7,41
10/20/16,3,14,8030,360,169,1,0,0,1
10/20/16,3,15,309,350,87,11,12,0,23
10/20/16,3,16,8040,350,108,18,18,2,38
10/20/16,3,17,542,370,105,25,7,2,34
10/20/16,3,18,542,350,87,38,8,0,46
10/20/16,3,19,715,360,170,1,2,0,3
10/20/16,3,20,8032,350,89,27,6,3,36
10/20/16,3,21,542,350,92,19,2,0,21
10/20/16,3,22,715,350,83,0,19,0,19
10/20/16,3,23,542,350,48,17,2,0,19
10/20/16,3,25,542,375,88,22,2,0,24
10/20/16,3,26,542,360,54,36,2,0,38
10/20/16,3,27,542,360,92,21,8,0,29
10/20/16,3,28,7675,375,50,14,4,3,21
10/21/16,1,2,738,315,97,15,15,0,30
10/21/16,1,3,996,300,79,13,13,11,37
10/21/16,1,4,5302,300,69,24,3,6,33
10/21/16,1,5,3062,400,134,13,6,3,22
10/21/16,1,6,542,370,14,12,6,4,22
10/21/16,1,7,8040,345,31,3,5,0,8
10/21/16,1,8,785,350,128,15,4,2,21
10/21/16,1,9,542,350,4,2,6,1,9
10/21/16,1,10,8030,380,159,2,9,0,11
10/21/16,1,11,7652,355,110,21,12,1,34
10/21/16,1,12,7652,350,112,42,12,1,55
10/21/16,1,13,8038,400,17,10,0,3,13
10/21/16,1,14,8030,360,165,2,2,1,5
10/21/16,1,15,309,350,100,16,13,1,30
10/21/16,1,16,8040,350,95,18,19,2,39
10/21/16,1,17,542,370,102,34,3,1,38
10/21/16,1,18,542,350,62,56,10,0,66
10/21/16,1,19,715,360,166,4,7,0,11
10/21/16,1,20,8032,350,101,24,7,2,33
10/21/16,1,21,542,350,115,6,8,1,15
10/21/16,1,22,715,350,88,0,25,1,26
10/21/16,1,23,542,350,120,24,6,1,31
10/21/16,1,25,542,375,88,23,8,1,32
10/21/16,1,26,542,360,85,34,1,1,36
10/21/16,1,27,542,360,46,25,1,0,26
10/21/16,1,28,7675,375,92,45,7,5,57
10/21/16,2,2,738,315,99,14,13,0,27
10/21/16,2,3,996,300,40,14,11,6,31
10/21/16,2,4,5302,300,74,32,0,1,33
10/21/16,2,5,3062,400,124,13,5,1,19
10/21/16,2,6,542,370,98,28,11,4,43
10/21/16,2,8,785,350,92,15,2,2,19
10/21/16,2,9,542,350,106,13,10,1,24
10/21/16,2,10,8030,380,113,11,10,1,22
10/21/16,2,11,7652,355,129,16,14,0,30
10/21/16,2,12,7652,350,106,23,11,1,35
10/21/16,2,13,8038,400,143,3,0,1,4
10/21/16,2,14,8030,360,156,5,1,0,6
10/21/16,2,15,309,350,95,18,12,0,30
10/21/16,2,16,8040,350,4,21,2,7,30
10/21/16,2,17,542,370,109,32,3,1,36
10/21/16,2,18,542,350,53,55,5,0,60
10/21/16,2,19,715,360,164,4,1,1,6
10/21/16,2,20,8032,350,105,25,14,1,40
10/21/16,2,21,542,350,96,12,11,1,24
10/21/16,2,22,715,350,88,6,19,0,25
10/21/16,2,23,542,350,84,21,10,0,31
10/21/16,2,25,542,375,121,9,6,1,16
10/21/16,2,26,542,360,32,9,5,0,14
10/21/16,2,27,542,360,31,35,2,0,37
10/21/16,2,28,7675,375,112,10,8,3,21
10/21/16,3,2,738,315,68,17,12,4,33
10/21/16,3,4,5302,300,88,32,0,15,47
10/21/16,3,5,3062,400,135,8,8,3,19
10/21/16,3,6,542,370,124,41,6,2,49
10/21/16,3,7,8040,345,63,6,9,1,16
10/21/16,3,8,785,350,124,17,2,3,22
10/21/16,3,9,542,350,126,16,19,1,36
10/21/16,3,10,8030,380,159,4,12,1,17
10/21/16,3,11,7652,355,129,20,11,0,31
10/21/16,3,12,7652,350,118,21,14,2,37
10/21/16,3,14,8030,360,142,2,11,4,17
10/21/16,3,15,309,140,88,15,4,0,19
10/21/16,3,16,8040,350,34,51,5,0,56
10/21/16,3,17,542,370,104,24,6,1,31
10/21/16,3,18,542,350,61,42,3,1,46
10/21/16,3,19,715,360,152,6,6,0,12
10/21/16,3,20,8032,350,96,20,13,2,35
10/21/16,3,21,542,350,83,18,3,0,21
10/21/16,3,22,715,350,52,4,15,0,19
10/21/16,3,23,542,350,73,22,4,0,26
10/21/16,3,25,542,375,85,17,4,0,21
10/21/16,3,27,542,360,82,25,5,0,30
10/21/16,3,28,7675,375,80,19,7,3,29
10/24/16,1,1,726,305,15,3,2,0,5
10/24/16,1,2,738,315,81,17,5,6,28
10/24/16,1,3,996,300,45,5,8,12,25
10/24/16,1,4,5302,300,57,30,1,0,31
10/24/16,1,5,3062,400,116,15,6,2,23
10/24/16,1,6,542,370,111,26,7,1,34
10/24/16,1,7,8040,345,107,8,14,2,24
10/24/16,1,8,785,350,118,11,3,0,14
10/24/16,1,9,542,350,103,10,10,1,21
10/24/16,1,10,8030,380,120,5,17,6,28
10/24/16,1,11,7652,355,108,10,11,1,22
10/24/16,1,12,7652,350,104,20,8,1,29
10/24/16,1,13,8038,400,85,4,0,1,5
10/24/16,1,14,8030,360,150,2,1,0,3
10/24/16,1,15,309,350,94,24,14,1,39
10/24/16,1,16,8040,350,54,36,26,4,66
10/24/16,1,17,542,370,91,43,3,3,49
10/24/16,1,18,542,350,18,18,7,0,25
10/24/16,1,19,715,360,129,7,16,1,24
10/24/16,1,20,8032,350,103,22,11,4,37
10/24/16,1,21,542,350,96,10,10,1,21
10/24/16,1,22,715,350,92,3,31,0,34
10/24/16,1,23,542,350,95,26,9,1,36
10/24/16,1,24,1001,360,30,5,1,2,8
10/24/16,1,25,542,375,87,7,9,1,17
10/24/16,1,27,542,360,84,18,4,0,22
10/24/16,1,28,7675,375,99,29,9,6,44
10/24/16,2,2,738,315,72,25,8,0,33
10/24/16,2,3,996,300,65,1,9,39,49
10/24/16,2,4,5302,300,48,37,0,2,39
10/24/16,2,5,3062,400,98,5,7,2,14
10/24/16,2,6,542,370,109,39,8,2,49
10/24/16,2,7,8040,345,137,7,9,1,17
10/24/16,2,8,785,350,134,3,5,1,9
10/24/16,2,9,542,350,100,16,13,1,30
10/24/16,2,10,8030,380,130,8,12,0,20
10/24/16,2,11,7652,355,82,51,5,0,56
10/24/16,2,12,7652,350,121,23,9,1,33
10/24/16,2,14,8030,360,135,7,3,3,13
10/24/16,2,15,309,350,65,23,6,1,30
10/24/16,2,16,8040,350,73,18,26,1,45
10/24/16,2,17,542,370,109,41,2,1,44
10/24/16,2,18,542,350,21,35,5,4,44
10/24/16,2,19,715,360,150,5,9,0,14
10/24/16,2,20,8032,350,117,21,15,6,42
10/24/16,2,21,542,350,92,20,3,1,24
10/24/16,2,22,715,350,103,1,19,0,20
10/24/16,2,23,542,350,54,16,10,1,27
10/24/16,2,24,1001,360,140,10,3,10,23
10/24/16,2,25,542,375,34,6,7,0,13
10/24/16,2,27,542,360,102,25,5,1,31
10/24/16,2,28,7675,375,79,38,13,4,55
10/24/16,3,2,738,315,81,43,18,2,63
10/24/16,3,3,996,300,62,4,18,9,31
10/24/16,3,6,542,370,118,32,12,1,45
10/24/16,3,7,8040,345,120,10,17,2,29
10/24/16,3,8,785,350,156,3,2,0,5
10/24/16,3,9,542,350,99,59,7,1,67
10/24/16,3,10,8030,380,70,3,18,1,22
10/24/16,3,11,7652,355,92,59,11,3,73
10/24/16,3,12,7652,350,107,15,14,3,32
10/24/16,3,14,8030,360,150,0,6,0,6
10/24/16,3,15,309,350,16,11,0,0,11
10/24/16,3,16,8040,350,53,7,23,5,35
10/24/16,3,17,542,370,60,40,3,1,44
10/24/16,3,18,542,350,53,40,4,0,44
10/24/16,3,19,715,360,124,7,6,0,13
10/24/16,3,20,8032,350,2,0,0,0,0
10/24/16,3,21,542,350,100,17,2,0,19
10/24/16,3,22,715,350,80,0,16,0,16
10/24/16,3,23,542,350,71,18,5,0,23
10/24/16,3,24,1001,360,54,7,7,5,19
10/24/16,3,27,542,360,72,13,8,0,21
10/24/16,3,28,7675,375,64,22,9,2,33
10/25/16,1,1,726,305,26,3,2,9,14
10/25/16,1,2,738,315,84,25,11,2,38
10/25/16,1,3,996,300,71,2,8,21,31
10/25/16,1,4,5302,300,27,17,1,9,27
10/25/16,1,5,3062,400,37,5,1,1,7
10/25/16,1,6,542,370,101,34,10,2,46
10/25/16,1,7,8040,345,107,11,12,2,25
10/25/16,1,8,785,350,131,0,10,1,11
10/25/16,1,9,542,350,89,30,17,0,47
10/25/16,1,10,8030,380,135,8,12,5,25
10/25/16,1,11,7652,355,56,14,8,0,22
10/25/16,1,12,7652,350,77,43,14,1,58
10/25/16,1,13,8038,400,113,2,0,2,4
10/25/16,1,14,8030,360,160,1,2,1,4
10/25/16,1,15,309,350,51,17,10,0,27
10/25/16,1,16,8040,350,78,21,32,1,54
10/25/16,1,17,542,370,118,4,1,0,5
10/25/16,1,18,542,350,59,11,6,3,20
10/25/16,1,19,715,360,160,4,10,1,15
10/25/16,1,21,542,350,109,24,5,1,30
10/25/16,1,22,715,350,119,2,21,1,24
10/25/16,1,23,542,350,102,24,6,1,31
10/25/16,1,24,1001,360,58,4,2,2,8
10/25/16,1,26,542,360,28,3,0,0,3
10/25/16,1,27,542,360,137,18,6,1,25
10/25/16,1,28,7675,375,105,15,11,2,28
10/25/16,2,1,726,305,83,1,17,0,18
10/25/16,2,2,738,315,93,10,10,0,20
10/25/16,2,3,996,300,91,7,13,21,41
10/25/16,2,4,5302,300,65,31,0,4,35
10/25/16,2,5,3062,400,142,14,4,2,20
10/25/16,2,6,542,370,124,17,9,1,27
10/25/16,2,7,8040,345,115,6,13,1,20
10/25/16,2,8,785,350,150,0,6,1,7
10/25/16,2,9,542,350,98,18,14,2,34
10/25/16,2,10,8030,380,163,3,4,0,7
10/25/16,2,11,7652,355,26,20,7,0,27
10/25/16,2,12,7652,350,99,22,13,0,35
10/25/16,2,13,8038,400,32,1,1,0,2
10/25/16,2,14,8030,360,150,4,3,0,7
10/25/16,2,15,309,350,91,25,8,1,34
10/25/16,2,16,8040,350,64,15,20,1,36
10/25/16,2,17,542,370,93,64,2,2,68
10/25/16,2,18,542,350,118,14,20,1,35
10/25/16,2,19,715,360,154,0,10,1,11
10/25/16,2,21,542,350,103,25,3,1,29
10/25/16,2,22,715,350,78,1,14,0,15
10/25/16,2,23,542,350,113,27,4,1,32
10/25/16,2,24,1001,360,3,1,0,1,2
10/25/16,2,25,542,375,17,9,4,0,13
10/25/16,2,26,542,360,102,22,6,0,28
10/25/16,2,27,542,360,128,17,4,1,22
10/25/16,2,28,7675,375,13,3,2,2,7
10/25/16,3,1,726,305,89,9,26,0,35
10/25/16,3,2,738,315,114,8,11,1,20
10/25/16,3,3,996,300,96,14,16,14,44
10/25/16,3,4,5302,300,60,25,0,16,41
10/25/16,3,5,3062,400,136,17,10,0,27
10/25/16,3,6,542,370,131,26,10,1,37
10/25/16,3,7,8040,345,137,16,8,2,26
10/25/16,3,8,785,350,145,2,10,0,12
10/25/16,3,9,542,350,106,39,10,2,51
10/25/16,3,10,8030,380,167,4,7,4,15
10/25/16,3,11,7652,355,26,36,10,31,77
10/25/16,3,12,7652,350,94,33,20,1,54
10/25/16,3,14,8030,360,161,4,1,1,6
10/25/16,3,15,309,350,80,23,8,0,31
10/25/16,3,16,8040,350,49,54,8,0,62
10/25/16,3,17,542,370,61,42,2,1,45
10/25/16,3,18,542,350,99,20,11,1,32
10/25/16,3,19,715,360,151,0,11,0,11
10/25/16,3,20,7748,350,7,4,0,4,8
10/25/16,3,21,542,350,81,13,5,0,18
10/25/16,3,22,715,350,135,0,16,0,16
10/25/16,3,23,542,350,80,13,8,0,21
10/25/16,3,25,542,375,74,20,7,0,27
10/25/16,3,26,542,360,67,42,4,0,46
10/25/16,3,27,542,360,117,14,6,0,20
10/26/16,1,2,738,315,84,17,16,3,36
10/26/16,1,3,996,300,94,12,8,15,35
10/26/16,1,4,5302,300,71,32,0,6,38
10/26/16,1,5,3062,400,109,21,3,3,27
10/26/16,1,6,542,370,108,41,11,4,56
10/26/16,1,7,8040,345,128,20,13,2,35
10/26/16,1,8,785,350,153,0,2,1,3
10/26/16,1,9,542,350,115,39,8,1,48
10/26/16,1,10,8030,380,168,4,4,0,8
10/26/16,1,11,7652,355,93,13,18,2,33
10/26/16,1,12,7652,350,103,33,6,0,39
10/26/16,1,14,8030,360,161,0,4,1,5
10/26/16,1,15,309,350,23,9,4,0,13
10/26/16,1,16,8040,350,85,15,24,7,46
10/26/16,1,17,542,370,87,30,3,1,34
10/26/16,1,18,542,350,94,70,10,2,82
10/26/16,1,19,715,360,164,2,10,1,13
10/26/16,1,21,542,350,79,20,8,1,29
10/26/16,1,22,715,350,119,1,24,0,25
10/26/16,1,23,542,350,114,33,2,1,36
10/26/16,1,25,542,375,80,17,16,1,34
10/26/16,1,26,542,360,75,39,2,1,42
10/26/16,1,27,542,360,89,13,8,0,21
10/26/16,2,2,738,315,97,29,17,1,47
10/26/16,2,3,996,300,80,11,12,14,37
10/26/16,2,4,5302,300,65,29,1,6,36
10/26/16,2,5,3062,400,135,8,5,1,14
10/26/16,2,6,542,370,115,72,8,1,81
10/26/16,2,7,8040,345,133,9,13,5,27
10/26/16,2,8,785,350,150,3,1,1,5
10/26/16,2,9,542,350,61,41,10,1,52
10/26/16,2,10,8030,380,175,3,2,1,6
10/26/16,2,11,7652,355,118,25,9,0,34
10/26/16,2,12,7652,350,115,13,12,1,26
10/26/16,2,14,8030,360,156,0,4,1,5
10/26/16,2,16,8040,350,69,24,21,1,46
10/26/16,2,17,542,370,115,46,4,3,53
10/26/16,2,18,542,350,94,43,16,1,60
10/26/16,2,19,715,360,143,0,15,0,15
10/26/16,2,21,542,350,123,18,4,0,22
10/26/16,2,22,715,350,117,0,24,0,24
10/26/16,2,23,542,350,84,35,5,0,40
10/26/16,2,25,542,375,117,22,12,0,34
10/26/16,2,26,542,360,54,27,3,0,30
10/26/16,2,27,542,360,121,16,7,0,23
10/26/16,2,28,7681,375,28,15,4,11,30
10/26/16,3,2,738,315,112,9,12,0,21
10/26/16,3,3,996,300,98,10,8,13,31
10/26/16,3,4,5302,300,66,35,1,19,55
10/26/16,3,5,3062,400,135,16,3,5,24
10/26/16,3,6,542,370,138,24,11,2,37
10/26/16,3,7,8040,345,124,28,18,3,49
10/26/16,3,8,785,350,159,2,4,1,7
10/26/16,3,9,542,350,92,39,14,1,54
10/26/16,3,10,8030,380,171,4,6,0,10
10/26/16,3,11,7652,355,128,36,210,0,246
10/26/16,3,12,7652,350,128,13,12,1,26
10/26/16,3,14,8030,360,167,0,1,0,1
10/26/16,3,16,8040,350,79,10,30,2,42
10/26/16,3,17,542,370,89,6,5,1,12
10/26/16,3,18,542,350,92,30,10,1,41
10/26/16,3,19,715,360,142,1,9,0,10
10/26/16,3,21,542,350,126,16,2,0,18
10/26/16,3,22,715,350,105,0,14,0,14
10/26/16,3,23,542,350,67,35,7,0,42
10/26/16,3,25,542,375,110,30,4,0,34
10/26/16,3,26,542,360,24,5,4,0,9
10/26/16,3,27,542,360,64,26,7,0,33
10/26/16,3,28,7681,375,110,17,6,3,26
10/27/16,1,2,738,315,110,11,8,0,19
10/27/16,1,3,996,300,79,7,10,11,28
10/27/16,1,4,5302,300,65,33,3,6,42
10/27/16,1,5,3062,400,135,14,4,2,20
10/27/16,1,6,542,370,122,25,15,2,42
10/27/16,1,7,8040,345,111,29,9,6,44
10/27/16,1,8,785,350,148,2,4,1,7
10/27/16,1,9,542,350,82,44,8,2,54
10/27/16,1,10,8030,380,100,5,5,2,12
10/27/16,1,11,7652,355,72,9,10,9,28
10/27/16,1,12,7652,350,103,32,12,0,44
10/27/16,1,13,8038,400,112,4,2,0,6
10/27/16,1,14,8030,360,160,1,1,1,3
10/27/16,1,15,774,350,9,9,2,0,11
10/27/16,1,16,8040,350,59,22,29,3,54
10/27/16,1,17,542,370,117,27,4,1,32
10/27/16,1,18,542,350,83,36,12,0,48
10/27/16,1,19,715,360,137,1,13,0,14
10/27/16,1,20,7748,350,62,13,0,0,13
10/27/16,1,21,542,350,105,19,4,1,24
10/27/16,1,22,715,350,131,0,20,1,21
10/27/16,1,23,542,350,83,27,6,1,34
10/27/16,1,25,542,375,94,17,8,1,26
10/27/16,1,26,542,360,76,26,3,0,29
10/27/16,1,27,542,360,10,4,1,0,5
10/27/16,1,28,7681,375,91,19,10,4,33
10/27/16,2,2,738,315,100,8,14,1,23
10/27/16,2,3,996,300,88,11,11,11,33
10/27/16,2,4,5302,300,52,26,1,4,31
10/27/16,2,5,3062,400,133,7,3,4,14
10/27/16,2,6,542,370,108,14,11,3,28
10/27/16,2,7,8040,345,43,7,4,1,12
10/27/16,2,8,785,350,160,0,3,2,5
10/27/16,2,9,542,350,69,33,2,2,37
10/27/16,2,10,8030,380,153,11,4,0,15
10/27/16,2,11,7652,355,115,12,13,0,25
10/27/16,2,12,7652,350,87,23,20,1,44
10/27/16,2,13,8038,400,150,4,0,5,9
10/27/16,2,14,8030,360,135,2,7,0,9
10/27/16,2,15,774,350,44,25,6,0,31
10/27/16,2,16,8040,350,65,12,14,1,27
10/27/16,2,17,542,370,51,46,3,2,51
10/27/16,2,18,542,350,69,34,13,2,49
10/27/16,2,19,715,360,124,84,11,0,95
10/27/16,2,20,7748,350,94,23,3,3,29
10/27/16,2,21,542,350,97,26,3,0,29
10/27/16,2,22,715,350,115,2,11,0,13
10/27/16,2,23,542,350,63,32,1,0,33
10/27/16,2,24,1001,360,71,3,5,6,14
10/27/16,2,25,542,375,103,18,8,0,26
10/27/16,2,26,542,360,95,27,5,0,32
10/27/16,2,27,542,360,68,20,8,0,28
10/27/16,2,28,7681,375,95,26,6,3,35
10/27/16,3,2,738,315,100,12,7,1,20
10/27/16,3,3,996,300,100,11,12,24,47
10/27/16,3,4,5302,300,60,26,0,12,38
10/27/16,3,5,3062,400,137,23,4,4,31
10/27/16,3,6,542,370,131,23,11,2,36
10/27/16,3,8,785,350,160,1,2,1,4
10/27/16,3,9,542,350,108,42,14,7,63
10/27/16,3,10,8030,380,174,5,4,1,10
10/27/16,3,11,7652,355,116,26,18,3,47
10/27/16,3,12,7652,350,105,36,11,0,47
10/27/16,3,14,8030,360,163,2,4,2,8
10/27/16,3,15,309,350,68,4,27,0,31
10/27/16,3,16,8040,350,79,15,26,5,46
10/27/16,3,17,542,370,64,41,5,1,47
10/27/16,3,18,542,350,57,42,4,0,46
10/27/16,3,19,715,360,124,4,11,0,15
10/27/16,3,21,542,350,86,21,2,0,23
10/27/16,3,22,715,350,117,0,12,0,12
10/27/16,3,23,542,350,60,28,4,0,32
10/27/16,3,24,1001,360,79,2,3,2,7
10/27/16,3,25,542,375,87,15,9,0,24
10/27/16,3,26,542,360,59,37,1,0,38
10/27/16,3,27,542,360,83,24,3,0,27
10/27/16,3,28,7681,375,119,14,4,5,23
10/28/16,2,1,726,305,14,42,0,0,42
10/28/16,2,2,738,315,32,5,1,0,6
10/28/16,2,4,5302,300,44,12,0,6,18
10/28/16,2,5,3062,400,112,7,3,2,12
10/28/16,2,6,542,370,42,11,7,1,19
10/28/16,2,7,8040,345,29,18,1,3,22
10/28/16,2,8,785,350,117,1,2,1,4
10/28/16,2,9,542,350,100,25,4,2,31
10/28/16,2,10,8030,380,117,5,5,1,11
10/28/16,2,11,7652,355,102,18,15,0,33
10/28/16,2,12,7652,350,64,18,12,1,31
10/28/16,2,14,8030,360,66,0,3,0,3
10/28/16,2,15,309,350,82,5,25,0,30
10/28/16,2,16,8040,350,79,22,21,1,44
10/28/16,2,17,542,370,54,15,11,3,29
10/28/16,2,18,542,350,75,12,15,1,28
10/28/16,2,19,715,360,114,2,10,0,12
10/28/16,2,21,542,350,76,4,19,0,23
10/28/16,2,22,715,350,99,14,1,0,15
10/28/16,2,23,542,350,92,7,22,0,29
10/28/16,2,24,1001,360,20,2,0,3,5
10/28/16,2,25,542,375,69,3,15,0,18
10/28/16,2,26,542,360,72,1,26,0,27
10/28/16,2,28,7681,375,82,14,7,2,23
10/28/16,3,1,726,305,46,138,16,9,163
10/28/16,3,5,3062,400,149,18,6,4,28
10/28/16,3,7,8040,345,121,60,5,1,66
10/28/16,3,8,785,350,153,1,2,2,5
10/28/16,3,9,542,350,109,31,16,3,50
10/28/16,3,10,8030,380,170,10,6,1,17
10/28/16,3,11,7652,355,131,14,24,0,38
10/28/16,3,12,7652,350,99,25,12,1,38
10/28/16,3,15,309,140,72,33,10,0,43
10/28/16,3,16,8040,350,69,33,17,6,56
10/28/16,3,17,542,370,88,71,6,1,78
10/28/16,3,18,542,350,124,19,12,1,32
10/28/16,3,19,715,360,150,1,7,0,8
10/28/16,3,21,542,350,45,12,4,0,16
10/28/16,3,22,715,350,139,1,15,0,16
10/28/16,3,23,542,350,43,26,4,0,30
10/28/16,3,25,542,375,95,26,4,0,30
10/28/16,3,26,542,17,89,35,7,0,42
10/28/16,3,28,7681,375,99,24,6,4,34
10/31/16,1,1,exp,305,76,34,25,4,63
10/31/16,1,2,738,315,22,2,7,4,13
10/31/16,1,3,996,300,46,9,4,9,22
10/31/16,1,4,5302,300,56,8,2,4,14
10/31/16,1,5,3062,400,141,15,5,4,24
10/31/16,1,7,8040,345,96,31,9,3,43
10/31/16,1,8,785,350,153,1,3,0,4
10/31/16,1,10,8030,380,142,4,7,2,13
10/31/16,1,11,7652,355,15,2,0,0,2
10/31/16,1,12,7652,350,79,13,5,0,18
10/31/16,1,15,774,350,60,5,32,0,37
10/31/16,1,16,8040,350,26,48,6,1,55
10/31/16,1,17,542,370,69,50,11,1,62
10/31/16,1,18,542,350,83,19,12,1,32
10/31/16,1,19,715,360,149,3,4,0,7
10/31/16,1,21,542,350,62,1,9,0,10
10/31/16,1,22,715,350,90,0,16,0,16
10/31/16,1,23,542,350,46,20,3,0,23
10/31/16,1,25,542,375,54,10,7,0,17
10/31/16,1,26,542,360,50,40,1,0,41
10/31/16,1,28,7681,375,81,25,11,2,38
10/31/16,2,1,exp,305,89,17,16,3,36
10/31/16,2,2,738,315,113,18,4,0,22
10/31/16,2,3,996,300,113,20,15,9,44
10/31/16,2,4,5302,300,62,15,0,7,22
10/31/16,2,5,3062,400,152,0,7,2,9
10/31/16,2,7,8040,345,115,20,9,3,32
10/31/16,2,8,785,350,157,1,5,1,7
10/31/16,2,10,8030,380,129,1,2,1,4
10/31/16,2,12,7652,350,64,12,12,1,25
10/31/16,2,15,774,350,57,35,8,0,43
10/31/16,2,16,8040,350,49,59,20,0,79
10/31/16,2,17,542,370,87,30,8,0,38
10/31/16,2,18,542,350,90,13,14,1,28
10/31/16,2,19,715,360,140,2,10,0,12
10/31/16,2,21,542,350,80,20,6,0,26
10/31/16,2,22,715,350,98,1,10,0,11
10/31/16,2,23,542,350,58,21,5,0,26
10/31/16,2,25,542,375,76,12,8,0,20
10/31/16,2,26,542,360,34,40,2,0,42
10/31/16,2,28,7681,375,103,19,2,3,24
10/31/16,3,1,exp,305,54,10,21,2,33
10/31/16,3,2,738,315,115,14,10,0,24
10/31/16,3,3,996,300,95,16,9,29,54
10/31/16,3,4,5302,300,20,8,3,8,19
10/31/16,3,5,3062,400,160,1,3,2,6
10/31/16,3,6,542,370,90,24,16,2,42
10/31/16,3,7,8040,345,121,34,9,1,44
10/31/16,3,8,785,350,150,0,3,3,6
10/31/16,3,15,774,350,66,40,4,0,44
10/31/16,3,16,8040,350,35,65,11,4,80
10/31/16,3,17,542,370,90,39,4,1,44
10/31/16,3,18,542,350,74,17,17,1,35
10/31/16,3,19,715,360,143,0,11,0,11
10/31/16,3,20,775,350,5,14,2,0,16
10/31/16,3,21,542,350,58,20,4,0,24
10/31/16,3,22,715,350,140,0,11,0,11
10/31/16,3,23,542,350,69,20,8,0,28
10/31/16,3,25,542,375,81,17,11,0,28
10/31/16,3,26,542,360,22,29,0,0,29
10/31/16,3,27,542,360,14,4,1,0,5
10/31/16,3,28,7681,375,78,26,1,4,31
11/01/16,1,1,exp,305,57,74,7,9,90
11/01/16,1,2,738,315,114,20,3,1,24
11/01/16,1,3,996,300,106,9,12,12,33
11/01/16,1,4,5302,300,61,14,0,7,21
11/01/16,1,5,3062,400,146,4,5,3,12
11/01/16,1,6,542,370,107,29,24,3,56
11/01/16,1,7,8040,345,127,28,8,3,39
11/01/16,1,8,785,350,156,1,2,4,7
11/01/16,1,9,542,350,98,37,4,2,43
11/01/16,1,11,7652,355,12,8,4,4,16
11/01/16,1,15,774,350,87,41,3,0,44
11/01/16,1,16,8040,350,35,61,11,0,72
11/01/16,1,17,542,370,98,57,2,2,61
11/01/16,1,18,542,350,71,19,21,2,42
11/01/16,1,19,715,360,174,0,8,1,9
11/01/16,1,20,775,350,58,21,11,2,34
11/01/16,1,21,542,350,81,24,3,1,28
11/01/16,1,22,715,350,151,3,13,1,17
11/01/16,1,23,542,350,109,23,7,1,31
11/01/16,1,25,542,375,74,28,0,0,28
11/01/16,1,26,542,360,45,40,2,1,43
11/01/16,1,27,542,360,97,25,3,1,29
11/01/16,1,28,7681,375,96,28,1,4,33
11/01/16,2,1,exp,305,75,23,23,3,49
11/01/16,2,2,738,315,107,9,13,0,22
11/01/16,2,3,996,300,96,8,11,28,47
11/01/16,2,5,3062,400,67,1,6,2,9
11/01/16,2,6,542,370,113,22,16,1,39
11/01/16,2,7,8040,345,119,28,7,1,36
11/01/16,2,8,785,350,141,2,6,2,10
11/01/16,2,9,542,350,95,36,11,2,49
11/01/16,2,11,7652,355,120,16,19,1,36
11/01/16,2,14,exp,360,26,7,7,5,19
11/01/16,2,15,774,350,66,34,12,0,46
11/01/16,2,16,8040,350,41,45,15,0,60
11/01/16,2,17,542,370,2,1,0,0,1
11/01/16,2,18,542,350,79,23,14,2,39
11/01/16,2,19,715,360,159,1,10,1,12
11/01/16,2,20,775,350,75,36,16,5,57
11/01/16,2,22,715,350,128,0,14,0,14
11/01/16,2,23,542,350,131,15,4,1,20
11/01/16,2,25,542,375,55,19,4,1,24
11/01/16,2,26,542,360,55,49,1,0,50
11/01/16,2,27,542,360,99,25,4,0,29
11/01/16,2,28,7681,375,99,24,2,7,33
11/01/16,3,1,exp,305,53,4,9,0,13
11/01/16,3,2,738,315,69,7,6,0,13
11/01/16,3,3,996,300,81,10,8,30,48
11/01/16,3,5,3062,400,156,8,6,3,17
11/01/16,3,6,542,370,136,25,16,2,43
11/01/16,3,7,8040,345,136,13,9,2,24
11/01/16,3,8,785,350,100,0,6,0,6
11/01/16,3,9,542,350,122,47,6,2,55
11/01/16,3,11,7652,355,129,31,11,0,42
11/01/16,3,14,exp,360,27,9,7,3,19
11/01/16,3,15,774,350,42,29,6,0,35
11/01/16,3,16,8040,350,35,32,15,3,50
11/01/16,3,18,542,350,87,31,18,1,50
11/01/16,3,19,715,360,148,1,8,0,9
11/01/16,3,20,775,350,75,27,13,1,41
11/01/16,3,21,542,350,58,11,7,0,18
11/01/16,3,22,715,350,127,0,12,24,36
11/01/16,3,23,542,350,61,20,3,0,23
11/01/16,3,25,542,375,29,33,0,0,33
11/01/16,3,26,542,360,42,36,1,0,37
11/01/16,3,27,542,360,60,17,2,0,19
11/01/16,3,28,7681,375,81,23,10,2,35
11/02/16,1,2,738,315,101,11,13,0,24
11/02/16,1,3,996,300,109,4,9,17,30
11/02/16,1,5,3062,400,148,4,8,2,14
11/02/16,1,6,542,370,134,21,15,1,37
11/02/16,1,7,8040,345,142,19,7,2,28
11/02/16,1,8,785,350,18,0,0,1,1
11/02/16,1,9,542,350,81,21,13,4,38
11/02/16,1,11,7652,355,96,23,18,2,43
11/02/16,1,15,774,350,85,43,6,0,49
11/02/16,1,16,8040,350,73,66,27,4,97
11/02/16,1,17,542,370,39,12,5,1,18
11/02/16,1,18,542,350,95,7,23,4,34
11/02/16,1,19,715,360,153,0,13,0,13
11/02/16,1,20,775,350,116,15,16,3,34
11/02/16,1,21,542,350,112,14,13,1,28
11/02/16,1,22,715,350,141,1,11,1,13
11/02/16,1,23,542,350,75,10,4,0,14
11/02/16,1,25,542,375,92,29,5,1,35
11/02/16,1,26,542,360,124,26,6,1,33
11/02/16,1,27,542,360,118,16,8,1,25
11/02/16,2,1,999,305,7,0,1,7,8
11/02/16,2,2,738,315,118,12,14,0,26
11/02/16,2,3,996,300,116,11,8,18,37
11/02/16,2,5,3062,400,147,1,5,3,9
11/02/16,2,6,542,370,127,21,21,2,44
11/02/16,2,7,8040,345,150,6,6,2,14
11/02/16,2,8,785,350,158,0,1,2,3
11/02/16,2,10,642,380,70,4,6,4,14
11/02/16,2,11,7652,355,127,12,23,0,35
11/02/16,2,15,774,350,51,30,8,0,38
11/02/16,2,16,8040,350,5,4,2,1,7
11/02/16,2,17,542,370,75,51,5,1,57
11/02/16,2,18,542,350,44,12,9,3,24
11/02/16,2,19,715,360,155,1,5,1,7
11/02/16,2,20,775,350,92,17,14,3,34
11/02/16,2,21,542,350,78,11,12,0,23
11/02/16,2,22,715,350,137,0,8,1,9
11/02/16,2,23,542,350,124,16,5,2,23
11/02/16,2,25,542,375,68,28,1,1,30
11/02/16,2,26,542,360,107,25,3,1,29
11/02/16,2,27,542,360,92,28,4,1,33
11/02/16,3,1,999,305,100,31,3,8,42
11/02/16,3,2,738,315,115,11,10,0,21
11/02/16,3,3,996,300,103,16,13,25,54
11/02/16,3,5,3062,400,161,4,4,3,11
11/02/16,3,6,542,370,121,24,19,1,44
11/02/16,3,7,8040,345,135,8,7,4,19
11/02/16,3,8,785,350,159,2,2,1,5
11/02/16,3,10,642,380,160,20,2,2,24
11/02/16,3,15,774,350,49,36,2,0,38
11/02/16,3,17,542,370,63,20,2,3,25
11/02/16,3,19,715,360,148,10,1,0,11
11/02/16,3,20,775,350,78,29,8,5,42
11/02/16,3,21,16,5,117,13,7,0,20
11/02/16,3,22,715,350,113,0,3,0,3
11/02/16,3,23,542,350,59,10,3,0,13
11/02/16,3,25,542,375,76,30,7,0,37
11/02/16,3,26,542,360,97,31,0,0,31
11/02/16,3,27,542,360,66,37,4,0,41
11/03/16,1,1,999,305,95,27,3,9,39
11/03/16,1,2,738,315,114,16,9,3,28
11/03/16,1,3,996,300,97,17,10,17,44
11/03/16,1,5,3062,400,151,7,4,2,13
11/03/16,1,6,542,370,149,15,14,3,32
11/03/16,1,7,8040,345,32,0,4,0,4
11/03/16,1,8,785,350,160,1,1,2,4
11/03/16,1,10,642,380,157,13,5,2,20
11/03/16,1,11,7652,355,91,17,15,1,33
11/03/16,1,15,774,350,81,44,10,0,54
11/03/16,1,18,542,350,38,12,5,4,21
11/03/16,1,19,715,360,146,16,4,1,21
11/03/16,1,20,775,350,85,19,13,1,33
11/03/16,1,21,542,350,119,17,12,1,30
11/03/16,1,22,715,350,162,0,9,1,10
11/03/16,1,23,542,350,142,23,5,2,30
11/03/16,1,25,542,375,89,50,9,1,60
11/03/16,1,26,542,360,131,34,7,1,42
11/03/16,1,27,542,360,108,35,4,0,39
11/03/16,1,28,775,375,59,32,11,12,55
11/03/16,2,1,999,305,99,37,6,5,48
11/03/16,2,2,738,315,119,7,10,1,18
11/03/16,2,3,996,300,17,0,2,13,15
11/03/16,2,5,3062,400,143,9,4,3,16
11/03/16,2,6,542,370,148,9,12,3,24
11/03/16,2,8,785,350,165,0,0,0,0
11/03/16,2,10,642,380,164,13,1,2,16
11/03/16,2,11,7652,355,143,14,7,0,21
11/03/16,2,12,542,350,23,12,7,11,30
11/03/16,2,15,774,350,59,19,8,8,35
11/03/16,2,17,542,370,45,12,12,1,25
11/03/16,2,18,542,350,73,15,10,2,27
11/03/16,2,19,715,360,143,1,10,0,11
11/03/16,2,20,775,350,66,14,16,1,31
11/03/16,2,21,542,350,16,3,5,0,8
11/03/16,2,22,715,350,110,3,8,0,11
11/03/16,2,23,542,350,20,6,2,0,8
11/03/16,2,24,1001,360,98,9,2,7,18
11/03/16,2,25,542,375,63,18,11,1,30
11/03/16,2,26,542,360,73,24,6,1,31
11/03/16,2,27,542,360,55,20,3,0,23
11/03/16,2,28,775,375,48,43,8,7,58
11/03/16,3,1,999,305,99,40,2,4,46
11/03/16,3,2,738,315,116,19,6,0,25
11/03/16,3,3,996,300,10,1,1,18,20
11/03/16,3,5,3062,400,149,7,7,3,17
11/03/16,3,6,542,370,142,19,20,2,41
11/03/16,3,8,785,350,164,0,0,1,1
11/03/16,3,10,642,380,154,35,1,2,38
11/03/16,3,11,7652,355,135,17,13,0,30
11/03/16,3,12,542,350,122,32,12,2,46
11/03/16,3,15,774,350,77,20,6,0,26
11/03/16,3,17,542,370,127,17,3,2,22
11/03/16,3,18,542,350,70,22,10,1,33
11/03/16,3,19,715,360,100,2,14,0,16
11/03/16,3,20,775,350,71,25,10,0,35
11/03/16,3,22,715,350,49,0,3,0,3
11/03/16,3,24,1001,360,73,8,1,3,12
11/03/16,3,25,542,375,46,28,6,0,34
11/03/16,3,26,542,360,64,19,5,0,24
11/03/16,3,27,542,360,75,28,2,0,30
11/03/16,3,28,775,375,36,38,9,2,49
11/04/16,1,1,999,305,84,24,2,6,32
11/04/16,1,2,738,315,115,16,12,3,31
11/04/16,1,3,996,300,95,12,9,5,26
11/04/16,1,5,3062,400,146,2,8,6,16
11/04/16,1,8,785,350,160,0,1,2,3
11/04/16,1,10,642,380,168,12,1,1,14
11/04/16,1,11,7652,355,27,19,7,1,27
11/04/16,1,12,542,350,121,26,15,3,44
11/04/16,1,15,774,350,92,47,12,1,60
11/04/16,1,16,8040,350,4,0,1,0,1
11/04/16,1,17,542,370,136,14,15,1,30
11/04/16,1,18,542,350,106,34,17,1,52
11/04/16,1,19,715,360,154,3,17,1,21
11/04/16,1,20,775,350,39,26,6,2,34
11/04/16,1,21,542,350,106,12,7,1,20
11/04/16,1,22,715,350,116,0,9,4,13
11/04/16,1,24,1001,360,113,7,2,3,12
11/04/16,1,25,542,375,6,3,2,0,5
11/04/16,1,27,542,360,123,31,1,1,33
11/04/16,1,28,775,375,89,34,10,7,51
11/04/16,2,2,738,315,106,5,9,1,15
11/04/16,2,3,996,300,92,5,10,5,20
11/04/16,2,5,3062,400,148,2,6,3,11
11/04/16,2,8,785,350,145,0,3,3,6
11/04/16,2,10,642,380,158,13,0,3,16
11/04/16,2,12,542,350,111,29,9,1,39
11/04/16,2,14,785,360,16,3,10,7,20
11/04/16,2,15,774,350,51,37,3,1,41
11/04/16,2,16,8040,350,100,20,26,4,50
11/04/16,2,17,542,370,127,16,8,2,26
11/04/16,2,18,542,350,102,23,10,2,35
11/04/16,2,19,715,360,131,1,21,0,22
11/04/16,2,21,542,350,100,9,14,1,24
11/04/16,2,22,715,350,120,2,7,2,11
11/04/16,2,24,1001,360,133,6,4,5,15
11/04/16,2,25,542,375,55,9,4,0,13
11/04/16,2,27,542,360,110,19,7,1,27
11/04/16,2,28,775,375,69,14,22,9,45
11/04/16,3,2,738,315,108,18,10,7,35
11/04/16,3,3,996,300,123,10,17,7,34
11/04/16,3,5,3062,400,156,8,4,4,16
11/04/16,3,6,542,370,44,34,10,11,55
11/04/16,3,8,785,350,164,1,1,2,4
11/04/16,3,10,642,380,165,12,3,3,18
11/04/16,3,12,542,350,128,39,4,2,45
11/04/16,3,14,785,360,100,33,30,5,68
11/04/16,3,15,774,140,60,36,5,2,43
11/04/16,3,16,8040,350,76,10,21,4,35
11/04/16,3,17,542,370,126,10,7,4,21
11/04/16,3,18,542,350,76,24,6,3,33
11/04/16,3,19,715,360,125,0,14,0,14
11/04/16,3,21,542,350,108,12,8,0,20
11/04/16,3,22,715,350,114,0,12,0,12
11/04/16,3,24,1001,360,111,4,3,7,14
11/04/16,3,25,542,375,89,14,4,0,18
11/04/16,3,27,542,360,86,19,6,0,25
11/04/16,3,28,775,375,79,22,14,7,43
11/07/16,1,2,738,315,32,2,7,1,10
11/07/16,1,3,996,300,94,21,15,8,44
11/07/16,1,5,3062,400,158,5,3,3,11
11/07/16,1,6,542,370,110,13,11,2,26
11/07/16,1,8,785,350,163,1,0,2,3
11/07/16,1,9,542,350,17,3,3,0,6
11/07/16,1,10,642,380,166,6,2,1,9
11/07/16,1,11,7652,355,33,7,8,6,21
11/07/16,1,12,542,350,136,20,8,3,31
11/07/16,1,14,774,360,49,43,17,2,62
11/07/16,1,15,774,350,65,51,6,1,58
11/07/16,1,16,8032,350,118,24,22,1,47
11/07/16,1,17,542,370,115,10,8,2,20
11/07/16,1,18,542,350,102,13,9,2,24
11/07/16,1,19,715,360,34,6,3,0,9
11/07/16,1,20,775,350,77,16,9,0,25
11/07/16,1,21,542,350,101,9,17,1,27
11/07/16,1,22,715,350,157,1,7,0,8
11/07/16,1,23,542,350,27,6,3,0,9
11/07/16,1,25,542,375,100,24,7,1,32
11/07/16,1,27,542,360,110,18,10,0,28
11/07/16,1,28,775,375,93,5,14,5,24
11/07/16,2,1,996,305,62,14,3,11,28
11/07/16,2,2,738,315,30,4,3,7,14
11/07/16,2,3,996,300,86,3,13,3,19
11/07/16,2,5,3062,400,148,9,2,1,12
11/07/16,2,6,542,370,118,22,17,1,40
11/07/16,2,8,785,350,162,1,0,1,2
11/07/16,2,9,542,350,121,15,16,2,33
11/07/16,2,10,642,380,176,1,1,3,5
11/07/16,2,11,7652,355,123,27,7,1,35
11/07/16,2,12,542,350,117,21,14,1,36
11/07/16,2,14,774,360,101,17,29,3,49
11/07/16,2,15,774,350,55,31,2,1,34
11/07/16,2,16,8032,350,98,46,16,2,64
11/07/16,2,17,542,370,127,12,4,5,21
11/07/16,2,18,542,350,95,20,12,1,33
11/07/16,2,20,775,350,96,20,21,1,42
11/07/16,2,21,542,350,89,13,14,1,28
11/07/16,2,22,715,350,143,2,7,1,10
11/07/16,2,23,542,350,42,2,5,1,8
11/07/16,2,25,542,375,81,32,2,1,35
11/07/16,2,27,542,360,66,26,7,0,33
11/07/16,2,28,775,375,64,15,18,1,34
11/07/16,3,1,996,305,107,22,8,4,34
11/07/16,3,2,738,315,115,12,8,1,21
11/07/16,3,3,996,300,114,12,8,7,27
11/07/16,3,5,3062,400,96,6,0,3,9
11/07/16,3,6,542,370,138,19,9,1,29
11/07/16,3,8,785,350,162,1,2,0,3
11/07/16,3,9,542,350,133,19,2,2,23
11/07/16,3,10,642,380,168,7,2,2,11
11/07/16,3,11,7652,355,79,66,15,0,81
11/07/16,3,12,542,350,118,29,16,1,46
11/07/16,3,14,774,360,112,22,30,2,54
11/07/16,3,15,774,350,61,27,7,0,34
11/07/16,3,16,8032,350,67,29,15,2,46
11/07/16,3,17,542,370,62,10,10,6,26
11/07/16,3,18,542,350,91,32,3,1,36
11/07/16,3,21,542,350,75,10,9,0,19
11/07/16,3,22,715,350,112,0,10,0,10
11/07/16,3,25,542,375,28,35,0,0,35
11/07/16,3,26,542,360,64,19,5,0,24
11/07/16,3,27,542,360,58,20,6,0,26
11/07/16,3,28,775,375,84,9,12,7,28
11/08/16,1,1,996,305,98,16,13,3,32
11/08/16,1,2,738,315,86,8,13,3,24
11/08/16,1,3,996,300,112,7,9,4,20
11/08/16,1,4,5302,300,29,8,0,4,12
11/08/16,1,6,542,370,134,26,4,3,33
11/08/16,1,7,8040,345,6,0,1,0,1
11/08/16,1,8,785,350,161,1,1,2,4
11/08/16,1,9,542,350,110,18,18,1,37
11/08/16,1,10,642,380,166,7,3,2,12
11/08/16,1,11,7652,355,84,41,6,4,51
11/08/16,1,12,542,350,106,30,16,3,49
11/08/16,1,14,774,360,95,25,26,3,54
11/08/16,1,15,774,350,60,27,5,1,33
11/08/16,1,16,8032,350,122,15,20,2,37
11/08/16,1,17,542,370,145,10,7,2,19
11/08/16,1,18,542,350,98,47,11,9,67
11/08/16,1,19,785,360,67,6,1,0,7
11/08/16,1,21,542,350,97,6,14,1,21
11/08/16,1,22,715,350,163,0,5,1,6
11/08/16,1,25,542,375,101,28,8,1,37
11/08/16,1,26,542,360,55,8,2,1,11
11/08/16,1,27,542,360,19,10,1,0,11
11/08/16,1,28,775,375,65,3,15,3,21
11/08/16,2,1,996,305,99,10,7,4,21
11/08/16,2,2,738,315,95,12,7,3,22
11/08/16,2,3,996,300,73,5,12,4,21
11/08/16,2,4,5302,300,26,7,0,6,13
11/08/16,2,5,8038,400,3,5,2,7,14
11/08/16,2,6,542,370,114,13,9,2,24
11/08/16,2,7,8040,345,137,11,5,3,19
11/08/16,2,8,785,350,162,0,1,1,2
11/08/16,2,9,542,350,95,19,13,2,34
11/08/16,2,10,642,380,176,1,1,0,2
11/08/16,2,11,7652,355,99,36,5,0,41
11/08/16,2,12,542,350,80,10,5,1,16
11/08/16,2,14,774,360,71,13,30,1,44
11/08/16,2,16,8032,350,84,27,20,2,49
11/08/16,2,17,542,370,156,16,1,4,21
11/08/16,2,18,542,350,117,33,5,1,39
11/08/16,2,19,785,360,97,50,0,0,50
11/08/16,2,21,542,350,113,17,12,1,30
11/08/16,2,22,715,350,150,0,7,1,8
11/08/16,2,25,542,375,95,37,4,1,42
11/08/16,2,26,542,360,116,23,4,1,28
11/08/16,2,27,542,360,86,26,3,1,30
11/08/16,3,2,738,315,99,22,15,0,37
11/08/16,3,3,996,300,107,10,10,5,25
11/08/16,3,4,5302,300,24,4,1,3,8
11/08/16,3,5,8038,400,65,14,29,30,73
11/08/16,3,6,542,370,137,14,11,2,27
11/08/16,3,7,8040,345,146,11,8,2,21
11/08/16,3,8,785,350,158,1,2,1,4
11/08/16,3,9,542,350,87,26,19,1,46
11/08/16,3,10,642,380,177,1,2,1,4
11/08/16,3,11,7652,355,117,43,13,0,56
11/08/16,3,14,774,360,118,19,33,1,53
11/08/16,3,15,774,350,61,27,7,0,34
11/08/16,3,16,8032,350,99,40,10,3,53
11/08/16,3,17,542,370,149,8,4,1,13
11/08/16,3,18,542,350,110,34,9,1,44
11/08/16,3,19,785,360,79,36,0,0,36
11/08/16,3,21,542,350,100,18,14,0,32
11/08/16,3,22,715,350,140,0,8,0,8
11/08/16,3,25,542,375,22,6,1,0,7
11/08/16,3,26,542,360,103,43,3,0,46
11/08/16,3,27,542,360,88,29,5,0,34
11/09/16,1,1,996,305,80,7,8,10,25
11/09/16,1,2,738,315,31,26,9,1,36
11/09/16,1,3,996,300,69,10,8,2,20
11/09/16,1,4,5302,300,45,4,0,2,6
11/09/16,1,5,8038,400,123,13,11,6,30
11/09/16,1,6,542,370,140,12,13,2,27
11/09/16,1,7,8040,345,140,11,8,4,23
11/09/16,1,8,785,350,151,1,1,3,5
11/09/16,1,10,642,380,178,3,0,1,4
11/09/16,1,11,7652,355,106,53,14,4,71
11/09/16,1,14,774,360,106,7,31,3,41
11/09/16,1,15,774,350,100,26,4,1,31
11/09/16,1,16,8032,350,111,35,17,1,53
11/09/16,1,17,542,370,154,8,5,3,16
11/09/16,1,18,542,350,119,24,10,8,42
11/09/16,1,19,785,360,136,13,3,1,17
11/09/16,1,21,542,350,126,14,9,1,24
11/09/16,1,22,715,350,149,2,7,1,10
11/09/16,1,23,775,350,44,18,6,0,24
11/09/16,1,24,1001,360,10,1,1,4,6
11/09/16,1,26,542,360,115,34,3,1,38
11/09/16,1,27,542,360,107,18,8,1,27
11/09/16,2,1,996,305,119,6,5,4,15
11/09/16,2,2,738,315,79,40,10,2,52
11/09/16,2,3,996,300,15,2,0,0,2
11/09/16,2,5,8038,400,146,3,2,3,8
11/09/16,2,6,542,370,134,15,14,2,31
11/09/16,2,7,8040,345,146,17,3,2,22
11/09/16,2,8,785,350,161,2,1,1,4
11/09/16,2,10,642,380,56,1,3,0,4
11/09/16,2,11,7652,355,100,39,8,1,48
11/09/16,2,14,774,360,99,20,23,2,45
11/09/16,2,15,774,350,84,36,3,1,40
11/09/16,2,16,8032,350,105,29,13,3,45
11/09/16,2,17,542,370,144,17,3,2,22
11/09/16,2,18,542,350,99,14,12,3,29
11/09/16,2,19,785,360,132,27,0,1,28
11/09/16,2,20,775,350,26,80,4,7,91
11/09/16,2,21,542,350,103,13,0,1,14
11/09/16,2,22,715,350,137,4,10,0,14
11/09/16,2,23,775,350,62,36,6,0,42
11/09/16,2,24,1001,360,108,20,1,6,27
11/09/16,2,26,542,360,115,23,4,0,27
11/09/16,2,27,542,360,56,21,3,0,24
11/09/16,3,1,996,305,108,15,9,9,33
11/09/16,3,2,738,315,79,58,10,2,70
11/09/16,3,3,996,300,96,20,3,6,29
11/09/16,3,5,8038,400,164,0,0,2,2
11/09/16,3,6,542,370,146,20,0,1,21
11/09/16,3,7,8040,345,137,20,4,2,26
11/09/16,3,8,785,350,156,0,1,1,2
11/09/16,3,11,7652,355,107,52,9,2,63
11/09/16,3,14,774,360,115,21,28,2,51
11/09/16,3,15,774,350,71,26,7,0,33
11/09/16,3,16,8032,350,89,33,9,1,43
11/09/16,3,17,542,370,113,12,10,4,26
11/09/16,3,18,542,350,121,24,5,1,30
11/09/16,3,19,785,360,131,13,3,0,16
11/09/16,3,20,775,350,46,70,8,2,80
11/09/16,3,21,542,5,67,8,5,0,13
11/09/16,3,22,715,350,132,0,12,0,12
11/09/16,3,23,775,350,43,32,5,0,37
11/09/16,3,24,1001,360,77,15,4,4,23
11/09/16,3,26,542,360,62,26,1,0,27
11/10/16,1,1,996,305,119,7,5,5,17
11/10/16,1,2,738,315,68,60,5,0,65
11/10/16,1,3,996,300,123,2,16,7,25
11/10/16,1,5,8038,400,121,1,0,3,4
11/10/16,1,6,542,370,130,30,8,3,41
11/10/16,1,7,8040,345,134,22,8,2,32
11/10/16,1,8,785,350,158,0,1,2,3
11/10/16,1,9,542,350,20,5,13,3,21
11/10/16,1,11,7652,355,107,37,12,2,51
11/10/16,1,14,774,360,88,21,35,1,57
11/10/16,1,15,774,350,109,22,9,1,32
11/10/16,1,16,8032,350,100,40,11,3,54
11/10/16,1,17,542,370,126,10,11,2,23
11/10/16,1,18,542,350,133,18,14,1,33
11/10/16,1,19,785,360,153,10,0,1,11
11/10/16,1,20,775,350,77,46,18,6,70
11/10/16,1,22,715,350,142,1,10,2,13
11/10/16,1,23,775,350,89,18,17,0,35
11/10/16,1,24,1001,360,78,33,15,1,49
11/10/16,1,26,542,360,110,29,2,1,32
11/10/16,1,27,542,360,10,4,0,0,4
11/10/16,2,1,996,305,59,5,3,4,12
11/10/16,2,2,738,315,102,26,7,0,33
11/10/16,2,3,996,300,89,6,26,5,37
11/10/16,2,6,542,370,144,16,4,2,22
11/10/16,2,7,8040,345,141,9,3,2,14
11/10/16,2,8,785,350,162,0,0,2,2
11/10/16,2,9,542,350,117,26,14,2,42
11/10/16,2,11,7652,355,95,37,7,4,48
11/10/16,2,14,774,360,86,25,32,1,58
11/10/16,2,15,774,350,117,29,7,1,37
11/10/16,2,16,8032,350,126,24,12,1,37
11/10/16,2,17,542,370,136,20,10,1,31
11/10/16,2,18,542,350,115,30,15,2,47
11/10/16,2,19,785,360,172,4,2,1,7
11/10/16,2,20,775,350,110,65,9,2,76
11/10/16,2,21,747,350,33,3,8,0,11
11/10/16,2,22,715,350,156,2,9,2,13
11/10/16,2,23,775,350,104,32,11,1,44
11/10/16,2,24,1001,360,109,36,6,6,48
11/10/16,2,26,542,360,128,39,1,1,41
11/10/16,2,27,542,360,123,20,14,1,35
11/10/16,3,1,996,305,36,9,1,5,15
11/10/16,3,2,738,315,85,51,7,2,60
11/10/16,3,3,996,300,100,10,26,6,42
11/10/16,3,6,542,370,125,17,15,2,34
11/10/16,3,7,8040,345,135,10,5,2,17
11/10/16,3,8,785,350,160,2,0,1,3
11/10/16,3,9,542,350,127,20,19,3,42
11/10/16,3,11,7652,355,98,74,9,1,84
11/10/16,3,14,774,360,79,34,14,1,49
11/10/16,3,15,774,350,97,31,2,0,33
11/10/16,3,16,8032,350,83,36,15,1,52
11/10/16,3,17,542,370,113,12,8,5,25
11/10/16,3,18,542,350,2,2,0,3,5
11/10/16,3,19,785,360,170,0,2,0,2
11/10/16,3,20,775,350,67,38,12,2,52
11/10/16,3,21,747,350,90,8,10,0,18
11/10/16,3,22,715,350,127,7,7,0,14
11/10/16,3,23,775,350,53,20,2,0,22
11/10/16,3,24,1001,360,79,18,4,5,27
11/10/16,3,26,542,360,87,21,4,0,25
11/10/16,3,27,542,360,82,16,10,0,26
11/11/16,1,1,996,305,120,12,2,4,18
11/11/16,1,2,738,315,85,56,6,0,62
11/11/16,1,3,996,300,119,7,13,5,25
11/11/16,1,6,542,370,88,14,3,2,19
11/11/16,1,7,8040,345,135,17,9,2,28
11/11/16,1,8,785,350,151,0,3,1,4
11/11/16,1,9,542,350,136,31,9,4,44
11/11/16,1,11,7652,355,136,38,10,1,49
11/11/16,1,12,542,350,85,6,5,1,12
11/11/16,1,14,774,360,63,62,22,5,89
11/11/16,1,15,774,350,139,15,9,1,25
11/11/16,1,17,542,370,122,21,12,2,35
11/11/16,1,18,542,350,100,19,24,3,46
11/11/16,1,19,785,360,178,0,1,1,2
11/11/16,1,20,775,350,90,34,8,3,45
11/11/16,1,21,747,350,88,8,18,0,26
11/11/16,1,22,715,350,135,10,10,1,21
11/11/16,1,23,775,350,94,28,9,0,37
11/11/16,1,26,542,360,103,18,10,1,29
11/11/16,1,27,542,360,118,20,7,1,28
11/11/16,1,28,775,375,48,11,7,0,18
11/11/16,2,1,996,305,116,17,2,3,22
11/11/16,2,2,738,315,103,11,11,0,22
11/11/16,2,3,996,300,112,7,14,0,21
11/11/16,2,7,8040,345,68,4,6,5,15
11/11/16,2,8,785,350,157,2,1,2,5
11/11/16,2,9,542,350,117,18,7,2,27
11/11/16,2,11,7652,355,106,50,7,1,58
11/11/16,2,12,542,350,121,20,11,2,33
11/11/16,2,14,774,360,66,34,18,2,54
11/11/16,2,15,774,350,92,21,5,0,26
11/11/16,2,16,8032,350,77,21,23,3,47
11/11/16,2,17,542,370,102,19,2,2,23
11/11/16,2,18,542,350,101,8,11,4,23
11/11/16,2,19,785,360,114,1,5,0,6
11/11/16,2,20,775,350,66,35,6,4,45
11/11/16,2,21,747,350,74,7,15,0,22
11/11/16,2,22,715,350,113,5,5,0,10
11/11/16,2,23,775,350,94,28,9,0,37
11/11/16,2,26,542,360,92,25,0,0,25
11/11/16,2,27,542,360,93,12,5,0,17
11/11/16,3,1,996,305,118,13,1,4,18
11/11/16,3,2,738,315,104,20,9,2,31
11/11/16,3,3,996,300,118,7,7,5,19
11/11/16,3,6,542,370,119,21,12,8,41
11/11/16,3,8,785,350,105,2,1,1,4
11/11/16,3,9,542,350,128,20,27,2,49
11/11/16,3,10,8030,380,34,14,13,5,32
11/11/16,3,11,7652,355,130,25,13,2,40
11/11/16,3,12,542,350,122,30,11,3,44
11/11/16,3,14,774,360,90,30,23,1,54
11/11/16,3,15,774,140,80,14,6,0,20
11/11/16,3,16,8032,350,121,4,15,2,21
11/11/16,3,17,542,370,108,15,4,3,22
11/11/16,3,18,542,350,95,10,13,1,24
11/11/16,3,19,785,360,168,0,1,0,1
11/11/16,3,20,775,350,47,49,8,3,60
11/11/16,3,21,747,350,77,3,18,0,21
11/11/16,3,22,715,350,128,7,7,0,14
11/11/16,3,23,775,350,29,27,1,0,28
11/11/16,3,26,542,17,98,26,8,0,34
11/11/16,3,27,542,360,113,13,10,0,23
11/14/16,1,1,996,305,92,4,12,6,22
11/14/16,1,2,738,315,52,60,0,10,70
11/14/16,1,3,996,300,85,11,10,3,24
11/14/16,1,6,542,370,123,29,7,1,37
11/14/16,1,9,542,350,114,23,17,1,41
11/14/16,1,10,8030,380,93,20,13,1,34
11/14/16,1,11,7652,355,111,29,10,0,39
11/14/16,1,12,542,350,96,35,7,1,43
11/14/16,1,14,774,360,23,8,22,1,31
11/14/16,1,15,774,350,120,12,6,1,19
11/14/16,1,16,8032,350,69,6,14,1,21
11/14/16,1,17,542,370,148,9,4,1,14
11/14/16,1,18,542,350,126,13,16,4,33
11/14/16,1,19,715,360,175,1,0,1,2
11/14/16,1,20,775,350,76,45,15,1,61
11/14/16,1,21,747,350,101,8,11,1,20
11/14/16,1,22,715,350,46,2,7,0,9
11/14/16,1,23,775,350,121,22,7,0,29
11/14/16,1,26,542,360,76,21,3,0,24
11/14/16,1,27,542,360,97,24,5,1,30
11/14/16,1,28,775,375,54,3,10,3,16
11/14/16,2,1,996,305,105,7,4,6,17
11/14/16,2,2,738,315,86,30,5,7,42
11/14/16,2,3,996,300,104,6,16,8,30
11/14/16,2,6,542,370,133,18,15,2,35
11/14/16,2,9,542,350,119,16,17,2,35
11/14/16,2,10,8030,380,107,26,2,1,29
11/14/16,2,11,7652,355,121,24,17,0,41
11/14/16,2,12,542,350,111,36,13,2,51
11/14/16,2,15,774,350,126,18,5,1,24
11/14/16,2,16,8032,350,102,21,28,1,50
11/14/16,2,17,542,370,127,13,9,1,23
11/14/16,2,18,542,350,104,8,20,3,31
11/14/16,2,19,715,360,174,1,0,1,2
11/14/16,2,20,775,350,80,57,23,7,87
11/14/16,2,21,747,350,97,8,10,0,18
11/14/16,2,23,775,350,98,46,4,0,50
11/14/16,2,25,542,375,39,2,3,0,5
11/14/16,2,27,542,360,81,28,6,0,34
11/14/16,2,28,775,375,81,3,17,6,26
11/14/16,3,1,996,305,112,21,3,4,28
11/14/16,3,2,738,315,84,16,8,0,24
11/14/16,3,6,542,370,147,14,12,1,27
11/14/16,3,9,542,350,125,24,13,1,38
11/14/16,3,10,8030,380,123,20,9,5,34
11/14/16,3,11,7652,355,49,19,8,0,27
11/14/16,3,12,542,350,94,30,8,2,40
11/14/16,3,15,774,350,121,9,4,0,13
11/14/16,3,16,8032,350,91,3,21,2,26
11/14/16,3,17,542,370,117,14,9,2,25
11/14/16,3,18,542,350,104,8,16,1,25
11/14/16,3,19,715,360,172,1,1,0,2
11/14/16,3,20,775,350,45,25,11,0,36
11/14/16,3,21,747,350,88,8,8,0,16
11/14/16,3,22,715,350,61,1,12,0,13
11/14/16,3,23,775,350,81,38,5,0,43
11/14/16,3,25,542,375,71,21,1,0,22
11/14/16,3,27,542,360,57,23,4,0,27
11/14/16,3,28,775,375,71,8,16,1,25
11/15/16,1,1,996,305,34,5,4,2,11
11/15/16,1,2,738,315,114,26,8,1,35
11/15/16,1,3,996,300,75,15,17,9,41
11/15/16,1,5,8035,400,112,0,4,6,10
11/15/16,1,6,542,370,142,24,11,2,37
11/15/16,1,9,542,350,139,22,13,1,36
11/15/16,1,10,8030,380,168,5,0,2,7
11/15/16,1,11,7652,355,26,22,1,6,29
11/15/16,1,15,774,350,112,12,12,2,26
11/15/16,1,16,8032,350,138,19,17,2,38
11/15/16,1,17,542,370,144,14,8,3,25
11/15/16,1,18,542,350,110,10,16,5,31
11/15/16,1,19,715,360,175,1,1,0,2
11/15/16,1,20,775,350,48,55,14,3,72
11/15/16,1,21,747,350,112,6,15,0,21
11/15/16,1,22,715,350,115,7,10,0,17
11/15/16,1,23,775,350,88,19,6,0,25
11/15/16,1,24,1001,360,5,1,2,7,10
11/15/16,1,25,542,375,111,23,5,0,28
11/15/16,1,26,542,360,174,35,9,1,45
11/15/16,1,27,542,360,102,22,11,1,34
11/15/16,1,28,775,375,124,14,13,2,29
11/15/16,2,2,738,315,114,10,13,2,25
11/15/16,2,3,996,300,109,19,20,8,47
11/15/16,2,5,8035,400,150,1,2,1,4
11/15/16,2,6,542,370,127,32,12,2,46
11/15/16,2,9,542,350,109,33,24,1,58
11/15/16,2,10,8030,380,153,3,3,3,9
11/15/16,2,11,7652,355,136,14,11,0,25
11/15/16,2,12,542,350,63,33,9,5,47
11/15/16,2,16,8032,350,127,13,13,2,28
11/15/16,2,17,542,370,110,8,8,2,18
11/15/16,2,18,542,350,91,13,9,1,23
11/15/16,2,19,715,360,173,1,0,1,2
11/15/16,2,20,775,350,33,86,4,7,97
11/15/16,2,21,747,350,95,6,15,0,21
11/15/16,2,22,715,350,105,2,11,2,15
11/15/16,2,23,775,350,76,21,6,1,28
11/15/16,2,24,1001,360,84,31,3,4,38
11/15/16,2,25,542,375,59,25,5,1,31
11/15/16,2,26,542,360,68,9,2,1,12
11/15/16,2,27,542,360,46,26,4,0,30
11/15/16,2,28,775,375,75,14,10,23,47
11/15/16,3,2,738,315,104,25,16,0,41
11/15/16,3,3,996,300,108,23,12,5,40
11/15/16,3,5,8035,400,163,2,2,0,4
11/15/16,3,6,542,370,115,49,17,3,69
11/15/16,3,9,542,350,111,22,26,4,52
11/15/16,3,10,8030,380,178,2,2,0,4
11/15/16,3,11,7652,355,110,3,7,1,11
11/15/16,3,12,542,350,103,74,7,7,88
11/15/16,3,16,8032,350,84,19,19,2,40
11/15/16,3,17,542,370,138,7,7,1,15
11/15/16,3,19,715,360,172,1,1,0,2
11/15/16,3,20,775,350,57,35,20,2,57
11/15/16,3,21,747,350,71,2,24,0,26
11/15/16,3,22,715,350,111,3,12,0,15
11/15/16,3,23,775,350,70,19,3,0,22
11/15/16,3,24,1001,360,61,27,23,2,52
11/15/16,3,25,542,375,54,28,4,0,32
11/15/16,3,27,542,360,64,22,5,0,27
11/15/16,3,28,775,375,94,22,11,2,35
11/16/16,1,2,738,315,43,8,3,1,12
11/16/16,1,3,996,300,76,22,14,11,47
11/16/16,1,4,5302,300,34,12,0,1,13
11/16/16,1,5,8035,400,149,1,7,3,11
11/16/16,1,6,542,370,113,43,11,3,57
11/16/16,1,8,785,350,139,10,11,2,23
11/16/16,1,9,542,350,125,18,12,6,36
11/16/16,1,10,8030,380,174,4,4,1,9
11/16/16,1,11,7652,355,137,14,12,0,26
11/16/16,1,12,542,350,131,30,4,1,35
11/16/16,1,16,8032,350,119,25,21,5,51
11/16/16,1,17,542,370,111,12,4,7,23
11/16/16,1,19,715,360,182,1,0,1,2
11/16/16,1,20,775,350,53,92,10,3,105
11/16/16,1,21,747,350,81,8,22,0,30
11/16/16,1,22,715,350,142,2,16,2,20
11/16/16,1,23,775,350,97,43,5,0,48
11/16/16,1,24,1001,360,93,24,9,3,36
11/16/16,1,25,542,375,86,35,8,1,44
11/16/16,1,28,775,375,71,25,12,2,39
11/16/16,2,3,996,300,93,29,14,4,47
11/16/16,2,5,8035,400,149,0,6,1,7
11/16/16,2,6,542,370,118,16,11,1,28
11/16/16,2,8,785,350,98,17,9,2,28
11/16/16,2,9,542,350,113,24,8,2,34
11/16/16,2,10,8030,380,177,3,2,0,5
11/16/16,2,11,7652,355,129,16,12,2,30
11/16/16,2,12,542,350,100,60,4,1,65
11/16/16,2,14,641,360,64,4,3,9,16
11/16/16,2,16,8032,350,103,36,12,1,49
11/16/16,2,17,542,370,9,1,1,1,3
11/16/16,3,1,996,305,112,6,8,8,22
11/16/16,3,3,996,300,16,4,5,0,9
11/16/16,3,5,8035,400,155,1,9,0,10
11/16/16,3,6,542,370,140,18,16,3,37
11/16/16,3,8,785,350,142,13,6,2,21
11/16/16,3,9,542,350,124,46,13,4,63
11/16/16,3,10,8030,380,171,2,1,2,5
11/16/16,3,11,7652,355,136,37,12,1,50
11/16/16,3,12,542,350,127,53,8,4,65
11/16/16,3,14,641,360,142,12,8,4,24
11/16/16,3,15,774,350,53,4,3,0,7
11/16/16,3,16,8032,350,119,29,11,3,43
11/16/16,3,19,715,360,163,1,0,0,1
11/16/16,3,20,775,350,79,36,17,4,57
11/16/16,3,21,747,5,106,9,17,0,26
11/16/16,3,22,715,350,122,1,9,0,10
11/16/16,3,23,775,350,66,33,4,0,37
11/16/16,3,24,1001,360,77,30,3,3,36
11/16/16,3,25,542,375,72,35,4,0,39
11/16/16,3,28,775,375,64,10,15,1,26
11/17/16,1,1,999,305,7,2,0,1,3
11/17/16,1,3,996,300,33,8,2,5,15
11/17/16,1,4,5302,300,82,19,0,2,21
11/17/16,1,5,8035,400,8,0,0,1,1
11/17/16,1,6,542,370,8,1,0,1,2
11/17/16,1,8,785,350,8,1,0,2,3
11/17/16,1,9,542,350,6,1,4,1,6
11/17/16,1,11,7652,355,5,5,0,1,6
11/17/16,1,12,542,350,5,2,0,1,3
11/17/16,1,14,641,360,139,22,1,1,24
11/17/16,1,15,774,350,9,0,1,0,1
11/17/16,1,16,8032,350,4,2,1,1,4
11/17/16,1,19,785,360,189,1,0,1,2
11/17/16,1,20,775,350,81,36,17,0,53
11/17/16,1,21,747,350,125,10,24,0,34
11/17/16,1,22,715,350,142,2,24,1,27
11/17/16,1,23,775,350,37,15,2,0,17
11/17/16,1,24,1001,360,123,29,4,5,38
11/17/16,1,25,542,375,106,48,7,1,56
11/17/16,1,28,775,375,40,6,6,1,13
11/17/16,2,1,999,305,103,4,4,5,13
11/17/16,2,4,5302,300,95,20,1,4,25
11/17/16,2,5,8035,400,142,4,4,1,9
11/17/16,2,6,542,370,112,24,5,1,30
11/17/16,2,7,8040,345,80,7,8,2,17
11/17/16,2,8,785,350,125,10,8,2,20
11/17/16,2,9,542,350,105,30,6,2,38
11/17/16,2,10,8030,380,161,0,1,0,1
11/17/16,2,11,7652,355,131,22,8,0,30
11/17/16,2,12,542,350,108,44,2,2,48
11/17/16,2,14,641,360,138,9,9,1,19
11/17/16,2,16,8032,350,125,10,17,2,29
11/17/16,2,24,1001,360,5,0,1,1,2
11/17/16,3,1,999,305,117,9,7,4,20
11/17/16,3,4,5302,300,90,26,1,9,36
11/17/16,3,5,8035,400,126,1,6,1,8
11/17/16,3,6,542,370,136,30,4,3,37
11/17/16,3,7,8040,345,145,22,8,2,32
11/17/16,3,8,785,350,130,17,8,2,27
11/17/16,3,9,542,350,126,24,15,6,45
11/17/16,3,10,8030,380,151,6,0,1,7
11/17/16,3,11,7652,355,127,23,12,3,38
11/17/16,3,12,542,350,113,51,9,1,61
11/17/16,3,14,641,360,141,17,11,2,30
11/17/16,3,16,8032,350,100,19,10,2,31
11/17/16,3,17,542,370,2,8,4,3,15
11/17/16,3,19,785,360,152,0,0,0,0
11/17/16,3,20,775,350,62,58,10,3,71
11/17/16,3,21,747,350,91,6,19,0,25
11/17/16,3,22,715,350,122,0,11,0,11
11/17/16,3,24,1001,360,76,12,15,8,35
11/17/16,3,25,542,375,49,5,16,0,21
11/18/16,1,1,999,305,25,1,7,0,8
11/18/16,1,4,5302,300,5,0,1,1,2
11/18/16,1,5,8035,400,8,0,0,1,1
11/18/16,1,6,542,370,9,0,0,1,1
11/18/16,1,7,8040,345,8,1,0,1,2
11/18/16,1,8,785,350,8,2,0,1,3
11/18/16,1,9,542,350,7,3,0,1,4
11/18/16,1,10,8030,380,9,0,0,1,1
11/18/16,1,11,7652,355,8,3,0,1,4
11/18/16,1,12,542,350,5,5,0,1,6
11/18/16,1,14,641,360,157,3,7,2,12
11/18/16,1,16,8032,350,3,4,2,2,8
11/18/16,1,17,542,370,78,102,9,4,115
11/18/16,1,19,785,360,185,1,1,1,3
11/18/16,1,20,775,350,75,42,26,2,70
11/18/16,1,21,747,350,111,18,18,0,36
11/18/16,1,22,715,350,127,2,20,2,24
11/18/16,1,25,542,375,9,0,8,0,8
11/18/16,1,27,542,360,55,17,2,0,19
11/18/16,2,4,5302,300,77,22,2,4,28
11/18/16,2,5,8035,400,115,0,6,1,7
11/18/16,2,6,542,370,117,27,10,1,38
11/18/16,2,7,8040,345,111,26,11,2,39
11/18/16,2,8,8032,350,123,18,9,2,29
11/18/16,2,9,542,350,94,34,5,3,42
11/18/16,2,10,8030,380,168,1,1,0,2
11/18/16,2,11,7652,355,126,23,14,2,39
11/18/16,2,12,542,350,111,41,9,3,53
11/18/16,2,14,641,360,135,6,6,3,15
11/18/16,2,16,8032,350,20,6,13,3,22
11/18/16,2,17,542,370,4,2,0,1,3
11/18/16,3,4,5302,300,98,22,1,4,27
11/18/16,3,5,8035,400,150,2,13,4,19
11/18/16,3,6,542,370,34,4,4,2,10
11/18/16,3,7,8040,345,30,4,10,2,16
11/18/16,3,8,8032,350,139,13,14,3,30
11/18/16,3,9,542,350,143,25,6,3,34
11/18/16,3,10,8030,380,178,2,0,2,4
11/18/16,3,11,7652,355,130,41,5,4,50
11/18/16,3,12,542,350,125,30,7,5,42
11/18/16,3,14,641,360,146,5,8,4,17
11/18/16,3,16,8032,350,79,8,42,2,52
11/18/16,3,17,542,370,52,5,9,3,17
11/18/16,3,20,775,350,102,13,27,2,42
11/18/16,3,21,747,350,114,4,21,0,25
11/18/16,3,22,715,350,131,1,17,0,18
11/18/16,3,23,775,350,7,4,0,0,4
11/18/16,3,24,exp,360,11,4,1,2,7
11/18/16,3,27,542,360,101,22,7,0,29
11/18/16,3,28,exp,375,20,5,3,6,14
11/21/16,1,14,641,360,140,2,7,1,10
11/21/16,1,17,542,370,75,78,5,1,84
11/21/16,1,20,775,350,98,18,13,10,41
11/21/16,1,21,747,350,83,10,25,0,35
11/21/16,1,22,715,350,128,2,18,3,23
11/21/16,1,27,542,360,103,29,8,1,38
11/21/16,1,28,exp,375,2,1,0,0,1
11/21/16,2,1,996,305,48,2,5,8,15
11/21/16,2,4,5302,300,49,18,0,3,21
11/21/16,2,5,8035,400,120,1,4,0,5
11/21/16,2,7,8040,345,142,15,4,2,21
11/21/16,2,8,8032,350,126,17,8,1,26
11/21/16,2,9,542,350,122,21,8,6,35
11/21/16,2,10,8030,380,167,2,1,0,3
11/21/16,2,11,7652,355,137,17,9,1,27
11/21/16,2,12,542,350,110,53,5,1,59
11/21/16,2,14,641,360,142,6,8,1,15
11/21/16,2,16,8032,350,92,20,43,1,64
11/21/16,2,17,542,370,5,6,0,2,8
11/21/16,2,28,exp,375,7,0,1,0,1
11/21/16,3,1,996,305,112,11,8,7,26
11/21/16,3,4,5302,300,26,4,2,1,7
11/21/16,3,5,8035,400,159,0,9,1,10
11/21/16,3,7,8040,345,138,20,3,1,24
11/21/16,3,8,8032,350,129,13,9,4,26
11/21/16,3,9,542,350,129,30,9,1,40
11/21/16,3,10,8030,380,181,1,0,1,2
11/21/16,3,11,7652,355,144,13,15,5,33
11/21/16,3,12,542,350,115,53,7,1,61
11/21/16,3,14,641,360,36,0,5,0,5
11/21/16,3,16,8032,350,89,28,38,1,67
11/21/16,3,17,542,370,79,65,4,0,69
11/21/16,3,20,775,350,96,48,18,2,68
11/21/16,3,21,747,350,75,4,28,0,32
11/21/16,3,22,715,350,136,2,8,0,10
11/21/16,3,27,542,360,67,25,6,0,31
11/21/16,3,28,exp,375,23,3,4,1,8
11/22/16,1,1,996,305,7,0,0,2,2
11/22/16,1,3,996,300,54,20,1,3,24
11/22/16,1,5,8035,400,6,1,0,1,2
11/22/16,1,7,8040,345,6,0,1,1,2
11/22/16,1,8,8032,350,5,0,1,1,2
11/22/16,1,9,542,350,5,2,2,1,5
11/22/16,1,10,8030,380,8,0,0,1,1
11/22/16,1,11,7652,355,5,2,0,1,3
11/22/16,1,12,542,350,4,3,0,1,4
11/22/16,1,16,8032,350,80,10,39,3,52
11/22/16,1,17,542,370,88,49,8,3,60
11/22/16,1,20,775,350,82,60,23,2,85
11/22/16,1,22,715,350,155,0,13,2,15
11/22/16,1,23,775,350,58,31,2,1,34
11/22/16,1,26,542,360,62,23,1,1,25
11/22/16,1,27,542,360,121,28,10,1,39
11/22/16,2,1,996,305,98,11,10,4,25
11/22/16,2,3,996,300,115,20,6,5,31
11/22/16,2,5,8035,400,141,1,2,1,4
11/22/16,2,7,8040,345,140,8,6,2,16
11/22/16,2,8,8032,350,130,13,9,2,24
11/22/16,2,9,542,350,72,24,9,2,35
11/22/16,2,10,8030,380,162,6,1,2,9
11/22/16,2,11,7652,355,122,18,12,0,30
11/22/16,2,12,542,350,124,30,2,1,33
11/22/16,2,14,641,360,46,7,11,3,21
11/22/16,2,16,8032,350,91,25,28,2,55
11/22/16,2,17,542,370,5,1,0,2,3
11/22/16,2,20,775,350,6,2,1,1,4
11/22/16,3,1,996,305,120,5,9,5,19
11/22/16,3,3,996,300,111,29,8,3,40
11/22/16,3,7,8040,345,142,27,7,3,37
11/22/16,3,8,8032,350,56,4,4,2,10
11/22/16,3,10,8030,380,176,5,1,1,7
11/22/16,3,11,7652,355,69,11,7,2,20
11/22/16,3,12,542,350,125,55,8,3,66
11/22/16,3,14,641,360,154,13,6,6,25
11/22/16,3,16,8032,350,76,12,38,1,51
11/22/16,3,17,542,370,120,14,6,7,27
11/22/16,3,19,715,360,45,0,1,0,1
11/22/16,3,20,775,350,89,18,20,2,40
11/22/16,3,22,715,350,132,1,9,0,10
11/22/16,3,23,775,350,81,35,10,1,46
11/22/16,3,24,exp,360,14,4,2,0,6
11/22/16,3,26,542,360,89,31,3,0,34
11/22/16,3,27,542,360,89,20,10,1,31
11/23/16,1,3,996,300,24,4,1,4,9
11/23/16,1,7,8040,345,20,1,2,1,4
11/23/16,1,11,7652,355,44,15,1,2,18
11/23/16,1,14,641,360,131,8,8,3,19
11/23/16,1,16,8032,350,95,14,35,6,55
11/23/16,1,17,542,370,130,30,8,3,41
11/23/16,1,18,542,350,63,12,8,10,30
11/23/16,1,19,785,360,168,1,9,1,11
11/23/16,1,20,775,350,107,28,16,2,46
11/23/16,1,22,715,350,159,0,8,3,11
11/23/16,1,23,775,350,87,42,9,0,51
11/23/16,1,25,542,375,38,22,9,0,31
11/23/16,1,27,542,360,111,29,6,1,36
11/23/16,2,1,996,305,109,5,8,5,18
11/23/16,2,3,996,300,119,0,1,5,6
11/23/16,2,6,542,370,72,18,3,4,25
11/23/16,2,7,8040,345,136,24,7,2,33
11/23/16,2,8,8032,350,52,5,8,5,18
11/23/16,2,10,8030,380,149,5,6,1,12
11/23/16,2,12,542,350,123,26,10,2,38
11/23/16,2,14,641,360,149,3,3,2,8
11/23/16,2,16,8032,350,116,34,41,2,77
11/23/16,2,17,542,370,15,1,0,0,1
11/23/16,3,1,996,305,70,7,5,6,18
11/23/16,3,3,996,300,30,2,7,1,10
11/23/16,3,6,542,370,99,4,2,1,7
11/23/16,3,7,8040,345,84,7,2,1,10
11/23/16,3,8,8032,350,54,15,9,1,25
11/23/16,3,10,8030,380,119,4,3,1,8
11/23/16,3,11,7652,355,77,10,3,4,17
11/23/16,3,12,542,350,91,8,11,3,22
11/23/16,3,14,641,360,100,10,3,1,14
11/23/16,3,16,8032,350,57,10,27,1,38
11/28/16,1,1,996,305,106,13,10,9,32
11/28/16,1,6,542,370,150,11,2,2,15
11/28/16,1,8,8032,350,115,14,21,1,36
11/28/16,1,11,7652,355,131,26,7,1,34
11/28/16,1,14,641,360,139,6,7,1,14
11/28/16,1,16,8032,350,79,59,24,3,86
11/28/16,1,17,542,370,142,22,8,1,31
11/28/16,1,18,542,350,100,47,10,4,61
11/28/16,1,19,785,360,149,1,2,0,3
11/28/16,1,20,775,350,83,38,16,2,56
11/28/16,1,21,747,350,12,0,1,0,1
11/28/16,1,22,715,350,152,2,13,4,19
11/28/16,1,23,775,350,93,42,5,1,48
11/28/16,1,25,542,375,62,27,2,0,29
11/28/16,1,28,exp,375,10,5,2,0,7
11/28/16,2,1,996,305,99,28,9,6,43
11/28/16,2,3,996,300,23,9,12,3,24
11/28/16,2,6,542,370,152,13,3,1,17
11/28/16,2,7,8040,345,5,5,5,7,17
11/28/16,2,8,8032,350,129,13,17,6,36
11/28/16,2,9,542,350,111,29,3,9,41
11/28/16,2,11,7652,355,146,16,8,0,24
11/28/16,2,14,641,360,155,7,6,0,13
11/28/16,2,15,774,350,37,7,2,0,9
11/28/16,2,16,8032,350,99,18,42,3,63
11/28/16,2,17,542,370,142,22,8,1,31
11/28/16,2,18,542,350,76,66,2,1,69
11/28/16,2,19,785,360,153,1,9,1,11
11/28/16,2,20,775,350,57,40,10,1,51
11/28/16,2,21,747,350,134,11,4,1,16
11/28/16,2,22,715,350,109,0,9,2,11
11/28/16,2,23,775,350,60,29,2,0,31
11/28/16,2,25,542,375,38,42,0,1,43
11/28/16,3,1,996,305,107,24,7,5,36
11/28/16,3,3,996,300,79,46,33,7,86
11/28/16,3,6,542,370,154,15,5,1,21
11/28/16,3,7,8040,345,75,9,15,2,26
11/28/16,3,8,8032,350,124,18,20,2,40
11/28/16,3,9,542,350,138,7,8,2,17
11/28/16,3,11,7652,355,144,8,6,2,16
11/28/16,3,14,641,360,26,0,0,2,2
11/28/16,3,15,774,350,101,15,7,0,22
11/28/16,3,16,8032,350,61,28,21,1,50
11/28/16,3,17,542,370,86,36,5,1,42
11/28/16,3,18,542,350,57,5,6,2,13
11/28/16,3,19,785,360,147,0,8,0,8
11/28/16,3,21,747,350,139,4,5,0,9
11/28/16,3,22,715,350,131,1,11,0,12
11/28/16,3,23,775,350,16,16,1,0,17
11/28/16,3,25,542,375,31,36,2,0,38
11/28/16,3,28,7625,375,36,12,1,0,13
11/29/16,1,1,996,305,99,9,6,6,21
11/29/16,1,3,996,300,57,29,30,9,68
11/29/16,1,6,542,370,146,20,3,2,25
11/29/16,1,7,8040,345,129,21,13,2,36
11/29/16,1,8,8032,350,108,17,20,1,38
11/29/16,1,9,542,350,132,12,10,5,27
11/29/16,1,11,7652,355,139,14,11,0,25
11/29/16,1,15,774,350,130,15,5,1,21
11/29/16,1,16,8032,350,82,47,32,3,82
11/29/16,1,17,542,370,137,19,9,1,29
11/29/16,1,18,542,350,33,23,5,3,31
11/29/16,1,19,785,360,127,1,5,0,6
11/29/16,1,21,747,350,156,8,6,1,15
11/29/16,1,22,715,350,147,1,18,1,20
11/29/16,1,23,775,350,24,27,0,0,27
11/29/16,1,25,542,375,113,36,4,1,41
11/29/16,1,26,542,360,28,5,2,0,7
11/29/16,1,28,7625,375,107,15,6,7,28
11/29/16,2,3,996,300,78,26,37,3,66
11/29/16,2,5,8035,400,34,1,2,4,7
11/29/16,2,6,542,370,71,3,3,0,6
11/29/16,2,7,8040,345,131,17,25,2,44
11/29/16,2,8,8032,350,127,23,16,0,39
11/29/16,2,9,542,350,150,10,3,2,15
11/29/16,2,11,7652,355,146,14,5,0,19
11/29/16,2,12,285,350,96,40,11,7,58
11/29/16,2,15,774,350,104,21,8,1,30
11/29/16,2,16,8032,350,102,33,33,1,67
11/29/16,2,17,542,370,135,24,1,2,27
11/29/16,2,18,542,350,70,36,7,0,43
11/29/16,2,19,785,360,157,1,5,0,6
11/29/16,2,20,92,350,114,28,2,7,37
11/29/16,2,21,747,350,123,6,6,0,12
11/29/16,2,22,715,350,145,2,9,2,13
11/29/16,2,23,775,350,70,20,4,0,24
11/29/16,2,25,542,375,84,26,5,1,32
11/29/16,2,26,542,360,81,39,2,1,42
11/29/16,2,28,7625,375,107,9,11,3,23
11/29/16,3,1,996,305,55,28,28,8,64
11/29/16,3,3,996,300,84,31,29,9,69
11/29/16,3,5,8035,400,158,1,6,0,7
11/29/16,3,7,8040,345,138,16,21,1,38
11/29/16,3,8,8032,350,116,17,27,2,46
11/29/16,3,9,542,350,147,9,12,5,26
11/29/16,3,11,7652,355,127,19,6,3,28
11/29/16,3,12,285,350,113,57,10,9,76
11/29/16,3,15,774,350,103,16,11,0,27
11/29/16,3,16,8032,350,62,52,26,1,79
11/29/16,3,17,542,370,102,15,4,3,22
11/29/16,3,18,542,350,70,53,6,3,62
11/29/16,3,19,785,360,158,2,2,0,4
11/29/16,3,20,92,350,103,23,5,5,33
11/29/16,3,21,747,350,92,8,11,0,19
11/29/16,3,22,715,350,138,3,12,0,15
11/29/16,3,23,775,350,77,13,4,0,17
11/29/16,3,25,542,375,44,31,4,0,35
11/29/16,3,26,542,360,44,31,4,0,35
11/29/16,3,28,7625,375,109,9,11,3,23
11/30/16,1,1,996,305,79,19,23,7,49
11/30/16,1,3,996,300,64,22,33,5,60
11/30/16,1,5,8035,400,150,2,6,2,10
11/30/16,1,7,8040,345,115,14,23,3,40
11/30/16,1,8,8032,350,96,15,17,1,33
11/30/16,1,9,542,350,134,16,5,1,22
11/30/16,1,11,7652,355,134,13,4,2,19
11/30/16,1,12,285,350,99,24,10,5,39
11/30/16,1,15,774,350,119,9,10,1,20
11/30/16,1,16,8032,350,71,36,24,2,62
11/30/16,1,17,542,370,85,24,7,9,40
11/30/16,1,18,542,350,106,54,12,3,69
11/30/16,1,19,785,360,165,1,7,1,9
11/30/16,1,20,92,350,106,44,5,5,54
11/30/16,1,21,747,350,138,15,4,1,20
11/30/16,1,22,715,350,154,0,13,1,14
11/30/16,1,24,1001,360,19,4,2,9,15
11/30/16,1,25,542,375,92,49,5,1,55
11/30/16,1,26,542,360,122,35,7,1,43
11/30/16,1,28,7625,375,131,8,8,3,19
11/30/16,2,1,996,305,85,2,27,3,32
11/30/16,2,3,996,300,77,14,20,5,39
11/30/16,2,5,8035,400,148,2,4,1,7
11/30/16,2,7,8040,345,121,10,23,1,34
11/30/16,2,8,8032,350,120,12,20,2,34
11/30/16,2,9,542,350,141,4,6,2,12
11/30/16,2,11,7652,355,138,14,9,0,23
11/30/16,2,12,285,350,119,46,3,8,57
11/30/16,2,15,774,350,123,16,6,1,23
11/30/16,2,16,8032,350,83,20,36,1,57
11/30/16,2,17,542,370,108,30,10,1,41
11/30/16,2,18,542,350,74,37,6,1,44
11/30/16,2,19,785,360,162,2,5,1,8
11/30/16,2,20,92,350,87,48,5,2,55
11/30/16,2,21,747,350,124,11,3,0,14
11/30/16,2,22,715,350,123,1,10,3,14
11/30/16,2,24,1001,360,119,10,4,3,17
11/30/16,2,25,542,375,83,24,1,0,25
11/30/16,2,26,542,360,81,16,3,0,19
11/30/16,2,28,7625,375,123,8,8,3,19
11/30/16,3,1,996,305,82,14,44,3,61
11/30/16,3,3,996,300,19,4,21,0,25
11/30/16,3,5,8035,400,159,2,6,0,8
11/30/16,3,7,8040,345,123,14,21,8,43
11/30/16,3,8,8032,350,133,21,8,3,32
11/30/16,3,9,542,350,143,12,11,1,24
11/30/16,3,11,7652,355,145,11,8,2,21
11/30/16,3,12,285,350,114,36,6,6,48
11/30/16,3,15,774,350,115,31,2,0,33
11/30/16,3,16,8032,350,66,53,27,1,81
11/30/16,3,18,542,350,84,39,23,2,64
11/30/16,3,19,785,360,143,2,11,0,13
11/30/16,3,20,92,350,108,52,3,3,58
11/30/16,3,21,747,350,144,6,4,0,10
11/30/16,3,22,715,350,136,1,10,0,11
11/30/16,3,24,1001,360,112,20,33,4,57
11/30/16,3,25,542,375,116,17,4,0,21
11/30/16,3,26,542,360,37,4,0,0,4
11/30/16,3,28,7625,375,127,16,4,3,23
12/01/16,1,1,996,305,92,17,25,5,47
12/01/16,1,3,996,300,56,7,10,4,21
12/01/16,1,5,8035,400,152,1,4,2,7
12/01/16,1,7,8040,345,108,14,22,2,38
12/01/16,1,8,8032,350,111,17,13,2,32
12/01/16,1,9,542,350,146,13,7,2,22
12/01/16,1,11,7652,355,137,9,11,2,22
12/01/16,1,12,285,350,115,32,13,7,52
12/01/16,1,15,774,350,108,25,9,1,35
12/01/16,1,16,8032,350,85,24,29,2,55
12/01/16,1,18,542,350,103,43,12,4,59
12/01/16,1,19,785,360,170,1,10,1,12
12/01/16,1,20,92,350,89,79,0,2,81
12/01/16,1,21,747,350,161,3,9,1,13
12/01/16,1,22,715,350,79,0,10,2,12
12/01/16,1,24,1001,360,133,13,6,8,27
12/01/16,1,25,542,375,128,19,6,1,26
12/01/16,1,26,542,360,130,33,4,1,38
12/01/16,1,28,7625,375,130,14,10,2,26
12/01/16,2,1,996,305,94,6,28,4,38
12/01/16,2,3,996,300,114,11,9,5,25
12/01/16,2,5,8035,400,22,0,2,2,4
12/01/16,2,7,8040,345,126,16,21,2,39
12/01/16,2,8,8032,350,106,10,16,1,27
12/01/16,2,9,542,350,125,5,10,3,18
12/01/16,2,11,7652,355,135,4,12,0,16
12/01/16,2,12,285,350,121,19,15,4,38
12/01/16,2,15,774,350,134,12,4,2,18
12/01/16,2,16,8032,350,91,39,30,2,71
12/01/16,2,18,542,350,92,37,10,0,47
12/01/16,2,19,785,360,150,2,6,1,9
12/01/16,2,20,92,350,111,22,2,2,26
12/01/16,2,21,747,350,123,14,3,0,17
12/01/16,2,24,1001,360,133,11,7,9,27
12/01/16,2,25,542,375,107,19,6,1,26
12/01/16,2,26,542,360,96,19,11,1,31
12/01/16,2,28,7625,375,122,8,9,3,20
12/01/16,3,3,996,300,119,7,10,6,23
12/01/16,3,7,8040,345,129,14,23,3,40
12/01/16,3,8,8032,350,119,13,17,3,33
12/01/16,3,9,542,350,110,36,9,1,46
12/01/16,3,10,774,380,141,30,14,11,55
12/01/16,3,11,7652,355,150,3,8,3,14
12/01/16,3,12,285,350,120,25,13,8,46
12/01/16,3,15,774,350,137,14,2,0,16
12/01/16,3,16,8032,350,73,36,39,1,76
12/01/16,3,18,542,350,100,37,10,2,49
12/01/16,3,19,785,360,143,0,7,0,7
12/01/16,3,20,92,350,131,19,3,2,24
12/01/16,3,21,747,350,138,9,7,0,16
12/01/16,3,24,1001,360,11,1,2,2,5
12/01/16,3,25,542,375,100,3,33,0,36
12/01/16,3,26,542,360,141,25,1,0,26
12/01/16,3,28,7625,375,113,13,13,6,32
12/05/16,1,1,996,305,76,3,3,6,12
12/05/16,1,3,996,300,111,12,7,4,23
12/05/16,1,5,8035,400,39,0,3,1,4
12/05/16,1,7,8040,345,122,12,24,2,38
12/05/16,1,8,8032,350,113,15,27,4,46
12/05/16,1,9,542,350,64,8,3,4,15
12/05/16,1,10,774,380,138,6,17,8,31
12/05/16,1,11,7652,355,131,6,6,2,14
12/05/16,1,15,774,350,115,10,5,1,16
12/05/16,1,16,8032,350,105,38,28,3,69
12/05/16,1,17,542,370,17,3,1,7,11
12/05/16,1,18,542,350,125,25,9,3,37
12/05/16,1,19,715,360,184,1,7,1,9
12/05/16,1,20,92,350,134,20,3,2,25
12/05/16,1,21,747,350,157,4,9,1,14
12/05/16,1,25,542,375,146,16,9,2,27
12/05/16,1,26,542,360,156,24,2,1,27
12/05/16,1,28,7625,375,108,41,7,2,50
12/05/16,2,1,996,305,119,6,3,8,17
12/05/16,2,3,996,300,82,10,9,3,22
12/05/16,2,5,8035,400,158,0,6,2,8
12/05/16,2,7,8040,345,5,0,1,0,1
12/05/16,2,8,8032,350,123,8,25,2,35
12/05/16,2,9,542,350,126,13,6,1,20
12/05/16,2,10,774,380,140,40,9,4,53
12/05/16,2,11,7652,355,143,12,4,53,69
12/05/16,2,15,774,350,125,8,7,2,17
12/05/16,2,16,8032,350,109,26,38,2,66
12/05/16,2,17,542,370,117,14,9,1,24
12/05/16,2,18,542,350,110,28,7,2,37
12/05/16,2,19,715,360,141,2,9,0,11
12/05/16,2,20,92,350,132,11,4,2,17
12/05/16,2,21,747,350,20,1,4,0,5
12/05/16,2,23,997,350,15,0,1,1,2
12/05/16,2,25,542,375,72,32,4,0,36
12/05/16,2,26,542,360,100,26,5,1,32
12/05/16,2,28,7625,375,21,21,1,1,23
12/05/16,3,1,996,305,116,11,8,6,25
12/05/16,3,5,8035,400,158,4,4,1,9
12/05/16,3,8,8032,350,129,14,20,2,36
12/05/16,3,9,542,350,11,0,2,0,2
12/05/16,3,10,774,380,69,33,39,9,81
12/05/16,3,11,7652,355,156,8,3,0,11
12/05/16,3,15,774,350,19,0,1,0,1
12/05/16,3,16,8032,350,89,19,34,3,56
12/05/16,3,17,542,370,100,30,9,2,41
12/05/16,3,18,542,350,109,18,20,1,39
12/05/16,3,19,715,360,150,1,9,0,10
12/05/16,3,20,92,350,5,1,0,1,2
12/05/16,3,25,542,375,78,37,6,0,43
12/05/16,3,26,542,360,115,22,3,0,25
12/05/16,3,27,542,360,78,18,4,0,22
12/06/16,1,1,996,305,117,9,5,5,19
12/06/16,1,3,996,300,47,6,16,3,25
12/06/16,1,5,8035,400,162,0,3,1,4
12/06/16,1,8,8032,350,126,14,16,5,35
12/06/16,1,10,774,380,140,10,8,3,21
12/06/16,1,11,7652,355,141,15,10,0,25
12/06/16,1,12,8040,350,28,8,10,10,28
12/06/16,1,14,641,360,90,8,8,0,16
12/06/16,1,15,774,350,18,0,3,0,3
12/06/16,1,17,542,370,121,14,12,5,31
12/06/16,1,18,542,350,123,25,14,2,41
12/06/16,1,19,715,360,167,1,11,0,12
12/06/16,1,21,747,350,61,0,4,0,4
12/06/16,1,25,542,375,96,27,6,2,35
12/06/16,1,26,542,360,137,22,7,1,30
12/06/16,1,27,542,360,116,24,5,1,30
12/06/16,2,1,996,305,117,13,1,6,20
12/06/16,2,3,996,300,81,3,36,5,44
12/06/16,2,5,8035,400,156,0,2,2,4
12/06/16,2,8,8032,350,120,16,19,3,38
12/06/16,2,9,542,350,47,0,3,3,6
12/06/16,2,10,774,380,137,37,4,2,43
12/06/16,2,11,7652,355,144,8,10,0,18
12/06/16,2,12,8040,350,131,25,15,1,41
12/06/16,2,14,641,360,143,11,4,1,16
12/06/16,2,15,774,350,137,13,9,1,23
12/06/16,2,17,542,370,132,13,10,2,25
12/06/16,2,18,542,350,75,40,11,1,52
12/06/16,2,19,715,360,148,2,8,0,10
12/06/16,2,21,747,350,146,4,8,0,12
12/06/16,2,23,EXP,350,15,1,5,0,6
12/06/16,2,25,542,375,76,42,5,1,48
12/06/16,2,26,542,360,129,23,3,2,28
12/06/16,2,27,542,360,118,9,7,0,16
12/06/16,3,1,996,305,120,10,4,5,19
12/06/16,3,3,996,300,88,6,39,13,58
12/06/16,3,5,8035,400,159,0,5,1,6
12/06/16,3,6,3062,370,12,25,3,12,40
12/06/16,3,8,8032,350,2,0,0,1,1
12/06/16,3,9,542,350,105,11,3,2,16
12/06/16,3,10,774,380,133,9,13,5,27
12/06/16,3,11,7652,355,131,9,7,2,18
12/06/16,3,12,8040,350,123,15,22,2,39
12/06/16,3,14,641,360,143,4,8,4,16
12/06/16,3,15,774,350,117,18,4,0,22
12/06/16,3,17,542,370,145,321,11,4,336
12/06/16,3,18,542,350,41,98,8,1,107
12/06/16,3,19,715,360,143,1,13,0,14
12/06/16,3,20,92,350,16,3,4,7,14
12/06/16,3,21,747,350,150,5,4,0,9
12/06/16,3,25,542,375,69,49,7,0,56
12/06/16,3,26,542,360,127,17,7,0,24
12/06/16,3,27,542,360,117,16,5,0,21
12/07/16,1,1,996,305,121,6,7,6,19
12/07/16,1,3,996,300,89,15,31,6,52
12/07/16,1,5,8035,400,162,0,5,3,8
12/07/16,1,6,3062,370,150,7,2,3,12
12/07/16,1,7,8040,345,99,4,3,3,10
12/07/16,1,9,542,350,135,7,11,3,21
12/07/16,1,10,774,380,98,14,11,7,32
12/07/16,1,11,7652,355,104,8,5,0,13
12/07/16,1,12,285,350,124,16,18,1,35
12/07/16,1,14,641,360,101,3,8,0,11
12/07/16,1,15,774,350,123,16,8,2,26
12/07/16,1,17,542,370,128,11,7,3,21
12/07/16,1,18,542,350,35,12,7,1,20
12/07/16,1,19,715,360,55,0,6,0,6
12/07/16,1,20,92,350,144,14,1,4,19
12/07/16,1,21,747,350,153,5,6,1,12
12/07/16,1,25,542,375,74,33,9,0,42
12/07/16,1,26,542,360,137,21,2,1,24
12/07/16,1,27,542,360,138,17,3,1,21
12/07/16,1,28,7625,375,16,0,16,0,16
12/07/16,2,1,996,305,123,2,6,6,14
12/07/16,2,3,996,300,108,10,32,10,52
12/07/16,2,5,8035,400,32,0,1,0,1
12/07/16,2,6,3062,370,160,5,9,2,16
12/07/16,2,7,8040,345,143,15,8,2,25
12/07/16,2,10,774,380,65,8,2,0,10
12/07/16,2,12,285,350,137,8,27,4,39
12/07/16,2,15,774,350,141,14,9,1,24
12/07/16,2,17,542,370,150,10,6,2,18
12/07/16,2,20,92,350,139,15,2,3,20
12/07/16,2,21,747,350,138,6,7,1,14
12/07/16,2,23,997,350,16,4,2,0,6
12/07/16,2,24,1001,360,13,0,9,9,18
12/07/16,2,26,542,360,140,17,3,1,21
12/07/16,2,27,542,360,125,12,5,1,18
12/07/16,3,1,996,305,66,1,3,3,7
12/07/16,3,3,996,300,98,15,32,7,54
12/07/16,3,6,3062,370,158,0,1,2,3
12/07/16,3,7,8040,345,137,23,5,4,32
12/07/16,3,10,774,380,163,13,8,3,24
12/07/16,3,12,285,350,139,15,18,2,35
12/07/16,3,15,774,350,138,6,7,0,13
12/07/16,3,17,542,370,138,19,4,3,26
12/07/16,3,20,92,350,127,18,0,2,20
12/07/16,3,21,747,350,144,16,4,0,20
12/07/16,3,25,542,375,77,44,4,0,48
12/07/16,3,26,542,360,68,7,3,0,10
12/07/16,3,27,542,360,119,17,19,0,36
12/08/16,1,3,996,300,92,11,28,7,46
12/08/16,1,6,3062,370,163,2,5,3,10
12/08/16,1,7,8040,345,144,15,7,3,25
12/08/16,1,10,774,380,165,18,0,3,21
12/08/16,1,11,7652,355,83,9,13,11,33
12/08/16,1,12,8040,350,128,17,22,4,43
12/08/16,1,15,774,350,147,7,16,1,24
12/08/16,1,17,542,370,148,22,2,3,27
12/08/16,1,20,92,350,137,23,5,4,32
12/08/16,1,21,747,350,148,3,9,1,13
12/08/16,1,25,775,375,96,61,6,1,68
12/08/16,1,27,542,360,133,26,15,2,43
12/08/16,1,28,exp,375,13,0,0,11,11
12/08/16,2,3,996,300,116,9,22,6,37
12/08/16,2,6,3062,370,162,11,2,2,15
12/08/16,2,7,8040,345,155,13,4,2,19
12/08/16,2,10,774,380,103,14,4,2,20
12/08/16,2,11,7652,355,150,13,6,0,19
12/08/16,2,12,8040,350,131,27,22,3,52
12/08/16,2,15,774,350,119,7,14,0,21
12/08/16,2,17,542,370,8,1,1,1,3
12/08/16,2,20,92,350,101,19,4,2,25
12/08/16,2,24,1001,360,3,0,0,7,7
12/09/16,1,3,996,300,104,5,31,9,45
12/09/16,1,6,3062,370,150,7,8,5,20
12/09/16,1,7,8040,345,143,14,5,7,26
12/09/16,1,9,542,350,27,2,1,3,6
12/09/16,1,11,7652,355,148,15,7,1,23
12/09/16,1,12,8040,350,131,24,24,4,52
12/09/16,1,15,774,350,144,12,14,2,28
12/09/16,1,17,542,370,151,19,5,5,29
12/09/16,1,20,92,350,133,26,5,1,32
12/09/16,1,21,747,350,167,10,1,1,12
12/09/16,1,24,1001,360,135,6,7,6,19
12/09/16,1,25,775,375,107,39,10,1,50
12/09/16,1,27,542,360,130,13,10,1,24
12/09/16,2,1,996,305,39,29,3,8,40
12/09/16,2,3,996,300,106,13,19,11,43
12/09/16,2,5,8035,400,13,1,0,5,6
12/09/16,2,6,3062,370,157,7,3,2,12
12/09/16,2,7,8040,345,148,17,7,2,26
12/09/16,2,9,542,350,148,11,7,1,19
12/09/16,2,11,7652,355,154,4,6,1,11
12/09/16,2,12,8040,350,125,24,20,2,46
12/09/16,2,15,774,350,119,8,15,1,24
12/09/16,2,17,542,370,121,16,7,2,25
12/09/16,2,20,92,350,115,35,1,2,38
12/09/16,2,21,747,350,154,4,4,0,8
12/09/16,2,24,1001,360,128,5,6,5,16
12/09/16,2,25,775,375,87,28,8,1,37
12/09/16,2,27,542,360,120,14,4,1,19
12/09/16,3,1,996,305,82,65,10,3,78
12/09/16,3,3,996,300,31,7,14,4,25
12/09/16,3,5,8035,400,157,21,7,2,30
12/09/16,3,6,3062,370,160,9,0,5,14
12/09/16,3,7,8040,345,136,16,6,5,27
12/09/16,3,9,542,350,133,24,5,5,34
12/09/16,3,11,7652,355,135,15,21,1,37
12/09/16,3,12,8040,350,111,25,14,2,41
12/09/16,3,14,641,360,21,5,7,4,16
12/09/16,3,15,774,140,124,20,9,0,29
12/09/16,3,17,542,370,138,16,0,3,19
12/09/16,3,20,92,350,118,40,0,5,45
12/09/16,3,21,747,350,144,6,7,0,13
12/09/16,3,24,1001,360,127,7,9,5,21
12/09/16,3,25,775,375,94,28,8,0,36
12/09/16,3,27,542,360,117,14,4,0,18
12/12/16,1,1,996,305,86,59,9,11,79
12/12/16,1,3,996,300,20,8,5,5,18
12/12/16,1,5,8035,400,154,1,7,1,9
12/12/16,1,6,3062,370,151,5,10,2,17
12/12/16,1,7,8040,345,140,19,3,4,26
12/12/16,1,9,542,350,140,18,8,3,29
12/12/16,1,11,7652,355,97,3,1,3,7
12/12/16,1,12,8040,350,118,37,23,4,64
12/12/16,1,14,641,360,127,12,8,1,21
12/12/16,1,15,774,350,137,8,5,2,15
12/12/16,1,17,542,370,36,6,1,2,9
12/12/16,1,20,92,350,117,49,0,1,50
12/12/16,1,21,747,350,124,3,12,1,16
12/12/16,1,22,496,350,3,0,3,0,3
12/12/16,1,24,1001,360,109,5,10,4,19
12/12/16,1,25,775,375,113,39,8,1,48
12/12/16,1,27,542,360,130,30,1,2,33
12/12/16,2,1,996,305,103,21,12,4,37
12/12/16,2,3,996,300,98,29,17,5,51
12/12/16,2,5,8035,400,149,2,9,2,13
12/12/16,2,6,3062,370,146,15,7,2,24
12/12/16,2,7,8040,345,135,21,5,3,29
12/12/16,2,9,542,350,144,9,10,4,23
12/12/16,2,11,7652,355,148,10,9,1,20
12/12/16,2,12,8040,350,133,25,9,1,35
12/12/16,2,14,641,360,122,25,4,0,29
12/12/16,2,15,774,350,105,19,5,1,25
12/12/16,2,20,92,350,71,42,1,2,45
12/12/16,2,21,747,350,112,6,7,0,13
12/12/16,2,22,496,350,26,1,2,2,5
12/12/16,2,24,1001,360,23,1,3,2,6
12/12/16,2,25,775,375,89,30,6,1,37
12/12/16,2,26,542,360,109,22,3,1,26
12/12/16,2,27,542,360,70,25,3,1,29
12/12/16,2,28,7625,375,42,3,1,5,9
12/12/16,3,1,996,305,73,21,7,2,30
12/12/16,3,3,996,300,87,59,8,11,78
12/12/16,3,5,8035,400,152,2,6,0,8
12/12/16,3,6,3062,370,147,12,1,3,16
12/12/16,3,7,8040,345,130,34,6,2,42
12/12/16,3,9,542,350,140,14,8,3,25
12/12/16,3,11,7652,355,111,88,2,1,91
12/12/16,3,12,8040,350,112,20,21,3,44
12/12/16,3,14,641,360,132,12,13,3,28
12/12/16,3,15,774,350,31,6,2,0,8
12/12/16,3,16,8032,350,66,47,33,3,83
12/12/16,3,21,747,350,19,1,0,0,1
12/12/16,3,25,775,375,76,40,3,0,43
12/12/16,3,26,542,360,29,10,2,0,12
12/12/16,3,27,542,360,110,19,2,0,21
12/12/16,3,28,7625,375,129,15,9,9,33
12/13/16,1,1,996,305,98,28,8,6,42
12/13/16,1,2,726,315,64,5,14,29,48
12/13/16,1,3,996,300,88,35,13,9,57
12/13/16,1,5,8035,400,152,1,5,3,9
12/13/16,1,6,3062,370,155,9,5,2,16
12/13/16,1,7,8040,345,139,22,8,3,33
12/13/16,1,9,542,350,128,16,9,5,30
12/13/16,1,11,7652,355,107,10,17,0,27
12/13/16,1,12,8040,350,121,24,18,6,48
12/13/16,1,14,641,360,87,29,20,4,53
12/13/16,1,16,8032,350,102,55,12,3,70
12/13/16,1,25,775,375,113,28,10,0,38
12/13/16,1,27,542,360,54,9,6,0,15
12/13/16,1,28,7625,375,139,4,18,4,26
12/13/16,2,1,996,305,91,25,10,5,40
12/13/16,2,2,726,315,109,4,14,0,18
12/13/16,2,3,996,300,87,22,16,5,43
12/13/16,2,5,8035,400,158,0,4,0,4
12/13/16,2,6,3062,370,104,7,7,3,17
12/13/16,2,7,8040,345,139,20,7,2,29
12/13/16,2,9,542,350,128,21,8,3,32
12/13/16,2,11,7652,355,137,17,12,0,29
12/13/16,2,12,8040,350,113,28,15,1,44
12/13/16,2,14,641,360,68,43,6,5,54
12/13/16,2,16,8032,350,114,53,10,2,65
12/13/16,2,17,542,370,111,6,15,5,26
12/13/16,2,18,542,350,71,22,19,4,45
12/13/16,2,25,775,375,94,27,8,0,35
12/13/16,2,28,7625,375,118,13,14,4,31
12/13/16,3,1,996,305,43,16,9,4,29
12/13/16,3,2,726,315,116,14,3,1,18
12/13/16,3,3,996,300,90,19,29,6,54
12/13/16,3,5,8035,400,147,1,7,2,10
12/13/16,3,7,8040,345,137,16,12,2,30
12/13/16,3,9,542,350,140,15,9,1,25
12/13/16,3,11,7652,355,140,4,8,1,13
12/13/16,3,12,8040,350,68,9,12,3,24
12/13/16,3,14,641,360,11,74,3,0,77
12/13/16,3,16,8032,350,126,54,7,2,63
12/13/16,3,17,542,370,152,9,7,2,18
12/13/16,3,18,542,350,127,63,9,1,73
12/13/16,3,28,7625,375,141,3,15,7,25
